query_name,query_string,date_filter,field_of_study,license_type,analysis_type,group,therapy_area,year,total,gold,green,hybrid,bronze,unknown,oa,non-oa
oncology (primary search + oncology tags) - pharma,"(author.affiliation.name:(""pfizer"" OR ""astrazeneca"" OR ""eli lilly"" OR ""merck"" OR ""emd serono"" OR ""msd"" OR ""merck sharp & dohme"" OR ""bristol myers squibb"" OR ""novartis"" OR ""roche"" OR ""hoffmann-la roche"" OR ""genentech"" OR ""johnson & johnson"" OR ""janssen"" OR ""biosense webster"" OR ""glaxosmithkline"" OR ""gsk"" OR ""abbvie"" OR ""sanofi"" OR ""sanofi-aventis"" OR ""gilead sciences"" OR ""takeda"" OR ""boehringer ingelheim"" OR ""myokardia"" OR ""amgen"" OR ""applied molecular genetics"" OR ""bayer"" OR ""vertex pharmaceuticals"" OR ""regeneron"" OR ""novo nordisk"" OR ""biogen"" OR ""biogen idec"" OR ""daiichi sankyo"" OR ""astellas pharma"" OR ""asuterasu seiyaku kabushiki-gaisha"" OR ""otsuka"" OR ""otsuka seiyaku kabushiki-gaisha"" OR ""astex pharmaceuticals"" OR ""ucb"" OR ""union chimique belge"" OR ""moderna"" OR ""eisai"" OR ""ezai kabushiki-gaisha"" OR ""ea pharma"" OR ""csl"" OR ""zlb behring"" OR ""jiangsu hengrui medicine"" OR ""teva pharmaceuticals"" OR ""sumitomo dainippon pharma"" OR ""dainippon sumitomo seiyaku kabushiki-gaisha"" OR ""fresenius"" OR ""fresenius se & co. kgaa"" OR ""viatris"" OR ""kyowa kirin"" OR ""kyowa hakko kirin"" OR ""ipsen"" OR ""jazz pharmaceuticals"" OR ""azur pharma"" OR ""sino biopharm"" OR ""bausch health companies"" OR ""valeant pharmaceuticals"" OR ""cspc pharmaceutical group"" OR ""galapagos"" OR ""galapagos genomics"" NOT ""La Roche College"") OR author.affiliation.ror_id_lineage:(""01xdqrp08"" OR ""00by1q217"" OR ""04b2dty93"" OR ""02891sr49"" OR ""03qd7mz70"" OR ""00gtmwv55"" OR ""02f9zrr09"" OR ""04r9x1a08"" OR ""01qat3289"" OR ""01xsqw823"" OR ""02g5p4n58"" OR ""02n6c9837"" OR ""056546b03"" OR ""04hjbmv12"" OR ""00q32j219"" OR ""03g03ge92"" OR ""04hmn8g73"" OR ""00anb1726"" OR ""02f51rf24"" OR ""0435rc536"" OR ""02jqkb192"" OR ""027y26122"" OR ""01cjash87"" OR ""013k5y296"" OR ""01n029866"" OR ""01xm4wg91"" OR ""04vvh7p27"" OR ""044tc0x05"" OR ""04ayvvz32"" OR ""01wfv3m53"" OR ""04sapgw72"" OR ""01v376g59"" OR ""01g1gvr46"" OR ""000wej815"" OR ""00d801g55"" OR ""055mhsv54"" OR ""0086q4c12"" OR ""01zgpn844"" OR ""016mq8947"" OR ""04e4j5d46"")) AND publication_type:""journal article"" AND date_published>=now-10y AND field_of_study: ((""Medicine"" OR ""Internal medicine"" OR ""Pharmacology"") AND (""Oncology"" OR ""Cancer"" OR ""Cancer research"" OR ""Chemotherapy"" OR ""Breast cancer"" OR ""Lung cancer"" OR ""Prostate cancer"" OR ""Pembrolizumab"" OR ""Multiple myeloma"" OR ""Colorectal cancer"" OR ""Neutropenia"" OR ""Metastatic breast cancer"" OR ""Lymphoma"" OR ""Myeloid leukemia"" OR ""Melanoma"" OR ""Renal cell carcinoma"" OR ""Leukemia"" OR ""Chronic lymphocytic leukemia"" OR ""Hepatocellular carcinoma"" OR ""Febrile neutropenia"" OR ""Carcinoma"" OR ""Ovarian cancer"" OR ""Response Evaluation Criteria in Solid Tumors"" OR ""Adenocarcinoma"" OR ""Follicular lymphoma"" OR ""Diffuse large B-cell lymphoma"" OR ""Cancer cell"" OR ""non-small cell lung cancer (NSCLC)"" OR ""Triple-negative breast cancer"" OR ""Pancreatic cancer"" OR ""Cancer immunotherapy"" OR ""Bladder cancer"" OR ""Cervical cancer"" OR ""Head and neck squamous-cell carcinoma"" OR ""Metastatic Urothelial Carcinoma"" OR ""Surgical oncology"" OR ""Head and neck cancer"" OR ""Carcinogenesis""))",AND date_published>=now-10y,"AND field_of_study: ((""Medicine"" OR ""Internal medicine"" OR ""Pharmacology"") AND (""Oncology"" OR ""Cancer"" OR ""Cancer research"" OR ""Chemotherapy"" OR ""Breast cancer"" OR ""Lung cancer"" OR ""Prostate cancer"" OR ""Pembrolizumab"" OR ""Multiple myeloma"" OR ""Colorectal cancer"" OR ""Neutropenia"" OR ""Metastatic breast cancer"" OR ""Lymphoma"" OR ""Myeloid leukemia"" OR ""Melanoma"" OR ""Renal cell carcinoma"" OR ""Leukemia"" OR ""Chronic lymphocytic leukemia"" OR ""Hepatocellular carcinoma"" OR ""Febrile neutropenia"" OR ""Carcinoma"" OR ""Ovarian cancer"" OR ""Response Evaluation Criteria in Solid Tumors"" OR ""Adenocarcinoma"" OR ""Follicular lymphoma"" OR ""Diffuse large B-cell lymphoma"" OR ""Cancer cell"" OR ""non-small cell lung cancer (NSCLC)"" OR ""Triple-negative breast cancer"" OR ""Pancreatic cancer"" OR ""Cancer immunotherapy"" OR ""Bladder cancer"" OR ""Cervical cancer"" OR ""Head and neck squamous-cell carcinoma"" OR ""Metastatic Urothelial Carcinoma"" OR ""Surgical oncology"" OR ""Head and neck cancer"" OR ""Carcinogenesis""))",NA,oa_therapy_area,Pharma,Oncology,2013,712,92,69,45,33,7,246,466
oncology (primary search + oncology tags) - pharma,"(author.affiliation.name:(""pfizer"" OR ""astrazeneca"" OR ""eli lilly"" OR ""merck"" OR ""emd serono"" OR ""msd"" OR ""merck sharp & dohme"" OR ""bristol myers squibb"" OR ""novartis"" OR ""roche"" OR ""hoffmann-la roche"" OR ""genentech"" OR ""johnson & johnson"" OR ""janssen"" OR ""biosense webster"" OR ""glaxosmithkline"" OR ""gsk"" OR ""abbvie"" OR ""sanofi"" OR ""sanofi-aventis"" OR ""gilead sciences"" OR ""takeda"" OR ""boehringer ingelheim"" OR ""myokardia"" OR ""amgen"" OR ""applied molecular genetics"" OR ""bayer"" OR ""vertex pharmaceuticals"" OR ""regeneron"" OR ""novo nordisk"" OR ""biogen"" OR ""biogen idec"" OR ""daiichi sankyo"" OR ""astellas pharma"" OR ""asuterasu seiyaku kabushiki-gaisha"" OR ""otsuka"" OR ""otsuka seiyaku kabushiki-gaisha"" OR ""astex pharmaceuticals"" OR ""ucb"" OR ""union chimique belge"" OR ""moderna"" OR ""eisai"" OR ""ezai kabushiki-gaisha"" OR ""ea pharma"" OR ""csl"" OR ""zlb behring"" OR ""jiangsu hengrui medicine"" OR ""teva pharmaceuticals"" OR ""sumitomo dainippon pharma"" OR ""dainippon sumitomo seiyaku kabushiki-gaisha"" OR ""fresenius"" OR ""fresenius se & co. kgaa"" OR ""viatris"" OR ""kyowa kirin"" OR ""kyowa hakko kirin"" OR ""ipsen"" OR ""jazz pharmaceuticals"" OR ""azur pharma"" OR ""sino biopharm"" OR ""bausch health companies"" OR ""valeant pharmaceuticals"" OR ""cspc pharmaceutical group"" OR ""galapagos"" OR ""galapagos genomics"" NOT ""La Roche College"") OR author.affiliation.ror_id_lineage:(""01xdqrp08"" OR ""00by1q217"" OR ""04b2dty93"" OR ""02891sr49"" OR ""03qd7mz70"" OR ""00gtmwv55"" OR ""02f9zrr09"" OR ""04r9x1a08"" OR ""01qat3289"" OR ""01xsqw823"" OR ""02g5p4n58"" OR ""02n6c9837"" OR ""056546b03"" OR ""04hjbmv12"" OR ""00q32j219"" OR ""03g03ge92"" OR ""04hmn8g73"" OR ""00anb1726"" OR ""02f51rf24"" OR ""0435rc536"" OR ""02jqkb192"" OR ""027y26122"" OR ""01cjash87"" OR ""013k5y296"" OR ""01n029866"" OR ""01xm4wg91"" OR ""04vvh7p27"" OR ""044tc0x05"" OR ""04ayvvz32"" OR ""01wfv3m53"" OR ""04sapgw72"" OR ""01v376g59"" OR ""01g1gvr46"" OR ""000wej815"" OR ""00d801g55"" OR ""055mhsv54"" OR ""0086q4c12"" OR ""01zgpn844"" OR ""016mq8947"" OR ""04e4j5d46"")) AND publication_type:""journal article"" AND date_published>=now-10y AND field_of_study: ((""Medicine"" OR ""Internal medicine"" OR ""Pharmacology"") AND (""Oncology"" OR ""Cancer"" OR ""Cancer research"" OR ""Chemotherapy"" OR ""Breast cancer"" OR ""Lung cancer"" OR ""Prostate cancer"" OR ""Pembrolizumab"" OR ""Multiple myeloma"" OR ""Colorectal cancer"" OR ""Neutropenia"" OR ""Metastatic breast cancer"" OR ""Lymphoma"" OR ""Myeloid leukemia"" OR ""Melanoma"" OR ""Renal cell carcinoma"" OR ""Leukemia"" OR ""Chronic lymphocytic leukemia"" OR ""Hepatocellular carcinoma"" OR ""Febrile neutropenia"" OR ""Carcinoma"" OR ""Ovarian cancer"" OR ""Response Evaluation Criteria in Solid Tumors"" OR ""Adenocarcinoma"" OR ""Follicular lymphoma"" OR ""Diffuse large B-cell lymphoma"" OR ""Cancer cell"" OR ""non-small cell lung cancer (NSCLC)"" OR ""Triple-negative breast cancer"" OR ""Pancreatic cancer"" OR ""Cancer immunotherapy"" OR ""Bladder cancer"" OR ""Cervical cancer"" OR ""Head and neck squamous-cell carcinoma"" OR ""Metastatic Urothelial Carcinoma"" OR ""Surgical oncology"" OR ""Head and neck cancer"" OR ""Carcinogenesis""))",AND date_published>=now-10y,"AND field_of_study: ((""Medicine"" OR ""Internal medicine"" OR ""Pharmacology"") AND (""Oncology"" OR ""Cancer"" OR ""Cancer research"" OR ""Chemotherapy"" OR ""Breast cancer"" OR ""Lung cancer"" OR ""Prostate cancer"" OR ""Pembrolizumab"" OR ""Multiple myeloma"" OR ""Colorectal cancer"" OR ""Neutropenia"" OR ""Metastatic breast cancer"" OR ""Lymphoma"" OR ""Myeloid leukemia"" OR ""Melanoma"" OR ""Renal cell carcinoma"" OR ""Leukemia"" OR ""Chronic lymphocytic leukemia"" OR ""Hepatocellular carcinoma"" OR ""Febrile neutropenia"" OR ""Carcinoma"" OR ""Ovarian cancer"" OR ""Response Evaluation Criteria in Solid Tumors"" OR ""Adenocarcinoma"" OR ""Follicular lymphoma"" OR ""Diffuse large B-cell lymphoma"" OR ""Cancer cell"" OR ""non-small cell lung cancer (NSCLC)"" OR ""Triple-negative breast cancer"" OR ""Pancreatic cancer"" OR ""Cancer immunotherapy"" OR ""Bladder cancer"" OR ""Cervical cancer"" OR ""Head and neck squamous-cell carcinoma"" OR ""Metastatic Urothelial Carcinoma"" OR ""Surgical oncology"" OR ""Head and neck cancer"" OR ""Carcinogenesis""))",NA,oa_therapy_area,Pharma,Oncology,2014,2244,306,212,143,172,146,979,1265
oncology (primary search + oncology tags) - pharma,"(author.affiliation.name:(""pfizer"" OR ""astrazeneca"" OR ""eli lilly"" OR ""merck"" OR ""emd serono"" OR ""msd"" OR ""merck sharp & dohme"" OR ""bristol myers squibb"" OR ""novartis"" OR ""roche"" OR ""hoffmann-la roche"" OR ""genentech"" OR ""johnson & johnson"" OR ""janssen"" OR ""biosense webster"" OR ""glaxosmithkline"" OR ""gsk"" OR ""abbvie"" OR ""sanofi"" OR ""sanofi-aventis"" OR ""gilead sciences"" OR ""takeda"" OR ""boehringer ingelheim"" OR ""myokardia"" OR ""amgen"" OR ""applied molecular genetics"" OR ""bayer"" OR ""vertex pharmaceuticals"" OR ""regeneron"" OR ""novo nordisk"" OR ""biogen"" OR ""biogen idec"" OR ""daiichi sankyo"" OR ""astellas pharma"" OR ""asuterasu seiyaku kabushiki-gaisha"" OR ""otsuka"" OR ""otsuka seiyaku kabushiki-gaisha"" OR ""astex pharmaceuticals"" OR ""ucb"" OR ""union chimique belge"" OR ""moderna"" OR ""eisai"" OR ""ezai kabushiki-gaisha"" OR ""ea pharma"" OR ""csl"" OR ""zlb behring"" OR ""jiangsu hengrui medicine"" OR ""teva pharmaceuticals"" OR ""sumitomo dainippon pharma"" OR ""dainippon sumitomo seiyaku kabushiki-gaisha"" OR ""fresenius"" OR ""fresenius se & co. kgaa"" OR ""viatris"" OR ""kyowa kirin"" OR ""kyowa hakko kirin"" OR ""ipsen"" OR ""jazz pharmaceuticals"" OR ""azur pharma"" OR ""sino biopharm"" OR ""bausch health companies"" OR ""valeant pharmaceuticals"" OR ""cspc pharmaceutical group"" OR ""galapagos"" OR ""galapagos genomics"" NOT ""La Roche College"") OR author.affiliation.ror_id_lineage:(""01xdqrp08"" OR ""00by1q217"" OR ""04b2dty93"" OR ""02891sr49"" OR ""03qd7mz70"" OR ""00gtmwv55"" OR ""02f9zrr09"" OR ""04r9x1a08"" OR ""01qat3289"" OR ""01xsqw823"" OR ""02g5p4n58"" OR ""02n6c9837"" OR ""056546b03"" OR ""04hjbmv12"" OR ""00q32j219"" OR ""03g03ge92"" OR ""04hmn8g73"" OR ""00anb1726"" OR ""02f51rf24"" OR ""0435rc536"" OR ""02jqkb192"" OR ""027y26122"" OR ""01cjash87"" OR ""013k5y296"" OR ""01n029866"" OR ""01xm4wg91"" OR ""04vvh7p27"" OR ""044tc0x05"" OR ""04ayvvz32"" OR ""01wfv3m53"" OR ""04sapgw72"" OR ""01v376g59"" OR ""01g1gvr46"" OR ""000wej815"" OR ""00d801g55"" OR ""055mhsv54"" OR ""0086q4c12"" OR ""01zgpn844"" OR ""016mq8947"" OR ""04e4j5d46"")) AND publication_type:""journal article"" AND date_published>=now-10y AND field_of_study: ((""Medicine"" OR ""Internal medicine"" OR ""Pharmacology"") AND (""Oncology"" OR ""Cancer"" OR ""Cancer research"" OR ""Chemotherapy"" OR ""Breast cancer"" OR ""Lung cancer"" OR ""Prostate cancer"" OR ""Pembrolizumab"" OR ""Multiple myeloma"" OR ""Colorectal cancer"" OR ""Neutropenia"" OR ""Metastatic breast cancer"" OR ""Lymphoma"" OR ""Myeloid leukemia"" OR ""Melanoma"" OR ""Renal cell carcinoma"" OR ""Leukemia"" OR ""Chronic lymphocytic leukemia"" OR ""Hepatocellular carcinoma"" OR ""Febrile neutropenia"" OR ""Carcinoma"" OR ""Ovarian cancer"" OR ""Response Evaluation Criteria in Solid Tumors"" OR ""Adenocarcinoma"" OR ""Follicular lymphoma"" OR ""Diffuse large B-cell lymphoma"" OR ""Cancer cell"" OR ""non-small cell lung cancer (NSCLC)"" OR ""Triple-negative breast cancer"" OR ""Pancreatic cancer"" OR ""Cancer immunotherapy"" OR ""Bladder cancer"" OR ""Cervical cancer"" OR ""Head and neck squamous-cell carcinoma"" OR ""Metastatic Urothelial Carcinoma"" OR ""Surgical oncology"" OR ""Head and neck cancer"" OR ""Carcinogenesis""))",AND date_published>=now-10y,"AND field_of_study: ((""Medicine"" OR ""Internal medicine"" OR ""Pharmacology"") AND (""Oncology"" OR ""Cancer"" OR ""Cancer research"" OR ""Chemotherapy"" OR ""Breast cancer"" OR ""Lung cancer"" OR ""Prostate cancer"" OR ""Pembrolizumab"" OR ""Multiple myeloma"" OR ""Colorectal cancer"" OR ""Neutropenia"" OR ""Metastatic breast cancer"" OR ""Lymphoma"" OR ""Myeloid leukemia"" OR ""Melanoma"" OR ""Renal cell carcinoma"" OR ""Leukemia"" OR ""Chronic lymphocytic leukemia"" OR ""Hepatocellular carcinoma"" OR ""Febrile neutropenia"" OR ""Carcinoma"" OR ""Ovarian cancer"" OR ""Response Evaluation Criteria in Solid Tumors"" OR ""Adenocarcinoma"" OR ""Follicular lymphoma"" OR ""Diffuse large B-cell lymphoma"" OR ""Cancer cell"" OR ""non-small cell lung cancer (NSCLC)"" OR ""Triple-negative breast cancer"" OR ""Pancreatic cancer"" OR ""Cancer immunotherapy"" OR ""Bladder cancer"" OR ""Cervical cancer"" OR ""Head and neck squamous-cell carcinoma"" OR ""Metastatic Urothelial Carcinoma"" OR ""Surgical oncology"" OR ""Head and neck cancer"" OR ""Carcinogenesis""))",NA,oa_therapy_area,Pharma,Oncology,2015,2309,300,264,162,146,20,892,1417
oncology (primary search + oncology tags) - pharma,"(author.affiliation.name:(""pfizer"" OR ""astrazeneca"" OR ""eli lilly"" OR ""merck"" OR ""emd serono"" OR ""msd"" OR ""merck sharp & dohme"" OR ""bristol myers squibb"" OR ""novartis"" OR ""roche"" OR ""hoffmann-la roche"" OR ""genentech"" OR ""johnson & johnson"" OR ""janssen"" OR ""biosense webster"" OR ""glaxosmithkline"" OR ""gsk"" OR ""abbvie"" OR ""sanofi"" OR ""sanofi-aventis"" OR ""gilead sciences"" OR ""takeda"" OR ""boehringer ingelheim"" OR ""myokardia"" OR ""amgen"" OR ""applied molecular genetics"" OR ""bayer"" OR ""vertex pharmaceuticals"" OR ""regeneron"" OR ""novo nordisk"" OR ""biogen"" OR ""biogen idec"" OR ""daiichi sankyo"" OR ""astellas pharma"" OR ""asuterasu seiyaku kabushiki-gaisha"" OR ""otsuka"" OR ""otsuka seiyaku kabushiki-gaisha"" OR ""astex pharmaceuticals"" OR ""ucb"" OR ""union chimique belge"" OR ""moderna"" OR ""eisai"" OR ""ezai kabushiki-gaisha"" OR ""ea pharma"" OR ""csl"" OR ""zlb behring"" OR ""jiangsu hengrui medicine"" OR ""teva pharmaceuticals"" OR ""sumitomo dainippon pharma"" OR ""dainippon sumitomo seiyaku kabushiki-gaisha"" OR ""fresenius"" OR ""fresenius se & co. kgaa"" OR ""viatris"" OR ""kyowa kirin"" OR ""kyowa hakko kirin"" OR ""ipsen"" OR ""jazz pharmaceuticals"" OR ""azur pharma"" OR ""sino biopharm"" OR ""bausch health companies"" OR ""valeant pharmaceuticals"" OR ""cspc pharmaceutical group"" OR ""galapagos"" OR ""galapagos genomics"" NOT ""La Roche College"") OR author.affiliation.ror_id_lineage:(""01xdqrp08"" OR ""00by1q217"" OR ""04b2dty93"" OR ""02891sr49"" OR ""03qd7mz70"" OR ""00gtmwv55"" OR ""02f9zrr09"" OR ""04r9x1a08"" OR ""01qat3289"" OR ""01xsqw823"" OR ""02g5p4n58"" OR ""02n6c9837"" OR ""056546b03"" OR ""04hjbmv12"" OR ""00q32j219"" OR ""03g03ge92"" OR ""04hmn8g73"" OR ""00anb1726"" OR ""02f51rf24"" OR ""0435rc536"" OR ""02jqkb192"" OR ""027y26122"" OR ""01cjash87"" OR ""013k5y296"" OR ""01n029866"" OR ""01xm4wg91"" OR ""04vvh7p27"" OR ""044tc0x05"" OR ""04ayvvz32"" OR ""01wfv3m53"" OR ""04sapgw72"" OR ""01v376g59"" OR ""01g1gvr46"" OR ""000wej815"" OR ""00d801g55"" OR ""055mhsv54"" OR ""0086q4c12"" OR ""01zgpn844"" OR ""016mq8947"" OR ""04e4j5d46"")) AND publication_type:""journal article"" AND date_published>=now-10y AND field_of_study: ((""Medicine"" OR ""Internal medicine"" OR ""Pharmacology"") AND (""Oncology"" OR ""Cancer"" OR ""Cancer research"" OR ""Chemotherapy"" OR ""Breast cancer"" OR ""Lung cancer"" OR ""Prostate cancer"" OR ""Pembrolizumab"" OR ""Multiple myeloma"" OR ""Colorectal cancer"" OR ""Neutropenia"" OR ""Metastatic breast cancer"" OR ""Lymphoma"" OR ""Myeloid leukemia"" OR ""Melanoma"" OR ""Renal cell carcinoma"" OR ""Leukemia"" OR ""Chronic lymphocytic leukemia"" OR ""Hepatocellular carcinoma"" OR ""Febrile neutropenia"" OR ""Carcinoma"" OR ""Ovarian cancer"" OR ""Response Evaluation Criteria in Solid Tumors"" OR ""Adenocarcinoma"" OR ""Follicular lymphoma"" OR ""Diffuse large B-cell lymphoma"" OR ""Cancer cell"" OR ""non-small cell lung cancer (NSCLC)"" OR ""Triple-negative breast cancer"" OR ""Pancreatic cancer"" OR ""Cancer immunotherapy"" OR ""Bladder cancer"" OR ""Cervical cancer"" OR ""Head and neck squamous-cell carcinoma"" OR ""Metastatic Urothelial Carcinoma"" OR ""Surgical oncology"" OR ""Head and neck cancer"" OR ""Carcinogenesis""))",AND date_published>=now-10y,"AND field_of_study: ((""Medicine"" OR ""Internal medicine"" OR ""Pharmacology"") AND (""Oncology"" OR ""Cancer"" OR ""Cancer research"" OR ""Chemotherapy"" OR ""Breast cancer"" OR ""Lung cancer"" OR ""Prostate cancer"" OR ""Pembrolizumab"" OR ""Multiple myeloma"" OR ""Colorectal cancer"" OR ""Neutropenia"" OR ""Metastatic breast cancer"" OR ""Lymphoma"" OR ""Myeloid leukemia"" OR ""Melanoma"" OR ""Renal cell carcinoma"" OR ""Leukemia"" OR ""Chronic lymphocytic leukemia"" OR ""Hepatocellular carcinoma"" OR ""Febrile neutropenia"" OR ""Carcinoma"" OR ""Ovarian cancer"" OR ""Response Evaluation Criteria in Solid Tumors"" OR ""Adenocarcinoma"" OR ""Follicular lymphoma"" OR ""Diffuse large B-cell lymphoma"" OR ""Cancer cell"" OR ""non-small cell lung cancer (NSCLC)"" OR ""Triple-negative breast cancer"" OR ""Pancreatic cancer"" OR ""Cancer immunotherapy"" OR ""Bladder cancer"" OR ""Cervical cancer"" OR ""Head and neck squamous-cell carcinoma"" OR ""Metastatic Urothelial Carcinoma"" OR ""Surgical oncology"" OR ""Head and neck cancer"" OR ""Carcinogenesis""))",NA,oa_therapy_area,Pharma,Oncology,2016,2594,393,279,215,225,24,1136,1458
oncology (primary search + oncology tags) - pharma,"(author.affiliation.name:(""pfizer"" OR ""astrazeneca"" OR ""eli lilly"" OR ""merck"" OR ""emd serono"" OR ""msd"" OR ""merck sharp & dohme"" OR ""bristol myers squibb"" OR ""novartis"" OR ""roche"" OR ""hoffmann-la roche"" OR ""genentech"" OR ""johnson & johnson"" OR ""janssen"" OR ""biosense webster"" OR ""glaxosmithkline"" OR ""gsk"" OR ""abbvie"" OR ""sanofi"" OR ""sanofi-aventis"" OR ""gilead sciences"" OR ""takeda"" OR ""boehringer ingelheim"" OR ""myokardia"" OR ""amgen"" OR ""applied molecular genetics"" OR ""bayer"" OR ""vertex pharmaceuticals"" OR ""regeneron"" OR ""novo nordisk"" OR ""biogen"" OR ""biogen idec"" OR ""daiichi sankyo"" OR ""astellas pharma"" OR ""asuterasu seiyaku kabushiki-gaisha"" OR ""otsuka"" OR ""otsuka seiyaku kabushiki-gaisha"" OR ""astex pharmaceuticals"" OR ""ucb"" OR ""union chimique belge"" OR ""moderna"" OR ""eisai"" OR ""ezai kabushiki-gaisha"" OR ""ea pharma"" OR ""csl"" OR ""zlb behring"" OR ""jiangsu hengrui medicine"" OR ""teva pharmaceuticals"" OR ""sumitomo dainippon pharma"" OR ""dainippon sumitomo seiyaku kabushiki-gaisha"" OR ""fresenius"" OR ""fresenius se & co. kgaa"" OR ""viatris"" OR ""kyowa kirin"" OR ""kyowa hakko kirin"" OR ""ipsen"" OR ""jazz pharmaceuticals"" OR ""azur pharma"" OR ""sino biopharm"" OR ""bausch health companies"" OR ""valeant pharmaceuticals"" OR ""cspc pharmaceutical group"" OR ""galapagos"" OR ""galapagos genomics"" NOT ""La Roche College"") OR author.affiliation.ror_id_lineage:(""01xdqrp08"" OR ""00by1q217"" OR ""04b2dty93"" OR ""02891sr49"" OR ""03qd7mz70"" OR ""00gtmwv55"" OR ""02f9zrr09"" OR ""04r9x1a08"" OR ""01qat3289"" OR ""01xsqw823"" OR ""02g5p4n58"" OR ""02n6c9837"" OR ""056546b03"" OR ""04hjbmv12"" OR ""00q32j219"" OR ""03g03ge92"" OR ""04hmn8g73"" OR ""00anb1726"" OR ""02f51rf24"" OR ""0435rc536"" OR ""02jqkb192"" OR ""027y26122"" OR ""01cjash87"" OR ""013k5y296"" OR ""01n029866"" OR ""01xm4wg91"" OR ""04vvh7p27"" OR ""044tc0x05"" OR ""04ayvvz32"" OR ""01wfv3m53"" OR ""04sapgw72"" OR ""01v376g59"" OR ""01g1gvr46"" OR ""000wej815"" OR ""00d801g55"" OR ""055mhsv54"" OR ""0086q4c12"" OR ""01zgpn844"" OR ""016mq8947"" OR ""04e4j5d46"")) AND publication_type:""journal article"" AND date_published>=now-10y AND field_of_study: ((""Medicine"" OR ""Internal medicine"" OR ""Pharmacology"") AND (""Oncology"" OR ""Cancer"" OR ""Cancer research"" OR ""Chemotherapy"" OR ""Breast cancer"" OR ""Lung cancer"" OR ""Prostate cancer"" OR ""Pembrolizumab"" OR ""Multiple myeloma"" OR ""Colorectal cancer"" OR ""Neutropenia"" OR ""Metastatic breast cancer"" OR ""Lymphoma"" OR ""Myeloid leukemia"" OR ""Melanoma"" OR ""Renal cell carcinoma"" OR ""Leukemia"" OR ""Chronic lymphocytic leukemia"" OR ""Hepatocellular carcinoma"" OR ""Febrile neutropenia"" OR ""Carcinoma"" OR ""Ovarian cancer"" OR ""Response Evaluation Criteria in Solid Tumors"" OR ""Adenocarcinoma"" OR ""Follicular lymphoma"" OR ""Diffuse large B-cell lymphoma"" OR ""Cancer cell"" OR ""non-small cell lung cancer (NSCLC)"" OR ""Triple-negative breast cancer"" OR ""Pancreatic cancer"" OR ""Cancer immunotherapy"" OR ""Bladder cancer"" OR ""Cervical cancer"" OR ""Head and neck squamous-cell carcinoma"" OR ""Metastatic Urothelial Carcinoma"" OR ""Surgical oncology"" OR ""Head and neck cancer"" OR ""Carcinogenesis""))",AND date_published>=now-10y,"AND field_of_study: ((""Medicine"" OR ""Internal medicine"" OR ""Pharmacology"") AND (""Oncology"" OR ""Cancer"" OR ""Cancer research"" OR ""Chemotherapy"" OR ""Breast cancer"" OR ""Lung cancer"" OR ""Prostate cancer"" OR ""Pembrolizumab"" OR ""Multiple myeloma"" OR ""Colorectal cancer"" OR ""Neutropenia"" OR ""Metastatic breast cancer"" OR ""Lymphoma"" OR ""Myeloid leukemia"" OR ""Melanoma"" OR ""Renal cell carcinoma"" OR ""Leukemia"" OR ""Chronic lymphocytic leukemia"" OR ""Hepatocellular carcinoma"" OR ""Febrile neutropenia"" OR ""Carcinoma"" OR ""Ovarian cancer"" OR ""Response Evaluation Criteria in Solid Tumors"" OR ""Adenocarcinoma"" OR ""Follicular lymphoma"" OR ""Diffuse large B-cell lymphoma"" OR ""Cancer cell"" OR ""non-small cell lung cancer (NSCLC)"" OR ""Triple-negative breast cancer"" OR ""Pancreatic cancer"" OR ""Cancer immunotherapy"" OR ""Bladder cancer"" OR ""Cervical cancer"" OR ""Head and neck squamous-cell carcinoma"" OR ""Metastatic Urothelial Carcinoma"" OR ""Surgical oncology"" OR ""Head and neck cancer"" OR ""Carcinogenesis""))",NA,oa_therapy_area,Pharma,Oncology,2017,2716,424,334,250,187,29,1224,1492
oncology (primary search + oncology tags) - pharma,"(author.affiliation.name:(""pfizer"" OR ""astrazeneca"" OR ""eli lilly"" OR ""merck"" OR ""emd serono"" OR ""msd"" OR ""merck sharp & dohme"" OR ""bristol myers squibb"" OR ""novartis"" OR ""roche"" OR ""hoffmann-la roche"" OR ""genentech"" OR ""johnson & johnson"" OR ""janssen"" OR ""biosense webster"" OR ""glaxosmithkline"" OR ""gsk"" OR ""abbvie"" OR ""sanofi"" OR ""sanofi-aventis"" OR ""gilead sciences"" OR ""takeda"" OR ""boehringer ingelheim"" OR ""myokardia"" OR ""amgen"" OR ""applied molecular genetics"" OR ""bayer"" OR ""vertex pharmaceuticals"" OR ""regeneron"" OR ""novo nordisk"" OR ""biogen"" OR ""biogen idec"" OR ""daiichi sankyo"" OR ""astellas pharma"" OR ""asuterasu seiyaku kabushiki-gaisha"" OR ""otsuka"" OR ""otsuka seiyaku kabushiki-gaisha"" OR ""astex pharmaceuticals"" OR ""ucb"" OR ""union chimique belge"" OR ""moderna"" OR ""eisai"" OR ""ezai kabushiki-gaisha"" OR ""ea pharma"" OR ""csl"" OR ""zlb behring"" OR ""jiangsu hengrui medicine"" OR ""teva pharmaceuticals"" OR ""sumitomo dainippon pharma"" OR ""dainippon sumitomo seiyaku kabushiki-gaisha"" OR ""fresenius"" OR ""fresenius se & co. kgaa"" OR ""viatris"" OR ""kyowa kirin"" OR ""kyowa hakko kirin"" OR ""ipsen"" OR ""jazz pharmaceuticals"" OR ""azur pharma"" OR ""sino biopharm"" OR ""bausch health companies"" OR ""valeant pharmaceuticals"" OR ""cspc pharmaceutical group"" OR ""galapagos"" OR ""galapagos genomics"" NOT ""La Roche College"") OR author.affiliation.ror_id_lineage:(""01xdqrp08"" OR ""00by1q217"" OR ""04b2dty93"" OR ""02891sr49"" OR ""03qd7mz70"" OR ""00gtmwv55"" OR ""02f9zrr09"" OR ""04r9x1a08"" OR ""01qat3289"" OR ""01xsqw823"" OR ""02g5p4n58"" OR ""02n6c9837"" OR ""056546b03"" OR ""04hjbmv12"" OR ""00q32j219"" OR ""03g03ge92"" OR ""04hmn8g73"" OR ""00anb1726"" OR ""02f51rf24"" OR ""0435rc536"" OR ""02jqkb192"" OR ""027y26122"" OR ""01cjash87"" OR ""013k5y296"" OR ""01n029866"" OR ""01xm4wg91"" OR ""04vvh7p27"" OR ""044tc0x05"" OR ""04ayvvz32"" OR ""01wfv3m53"" OR ""04sapgw72"" OR ""01v376g59"" OR ""01g1gvr46"" OR ""000wej815"" OR ""00d801g55"" OR ""055mhsv54"" OR ""0086q4c12"" OR ""01zgpn844"" OR ""016mq8947"" OR ""04e4j5d46"")) AND publication_type:""journal article"" AND date_published>=now-10y AND field_of_study: ((""Medicine"" OR ""Internal medicine"" OR ""Pharmacology"") AND (""Oncology"" OR ""Cancer"" OR ""Cancer research"" OR ""Chemotherapy"" OR ""Breast cancer"" OR ""Lung cancer"" OR ""Prostate cancer"" OR ""Pembrolizumab"" OR ""Multiple myeloma"" OR ""Colorectal cancer"" OR ""Neutropenia"" OR ""Metastatic breast cancer"" OR ""Lymphoma"" OR ""Myeloid leukemia"" OR ""Melanoma"" OR ""Renal cell carcinoma"" OR ""Leukemia"" OR ""Chronic lymphocytic leukemia"" OR ""Hepatocellular carcinoma"" OR ""Febrile neutropenia"" OR ""Carcinoma"" OR ""Ovarian cancer"" OR ""Response Evaluation Criteria in Solid Tumors"" OR ""Adenocarcinoma"" OR ""Follicular lymphoma"" OR ""Diffuse large B-cell lymphoma"" OR ""Cancer cell"" OR ""non-small cell lung cancer (NSCLC)"" OR ""Triple-negative breast cancer"" OR ""Pancreatic cancer"" OR ""Cancer immunotherapy"" OR ""Bladder cancer"" OR ""Cervical cancer"" OR ""Head and neck squamous-cell carcinoma"" OR ""Metastatic Urothelial Carcinoma"" OR ""Surgical oncology"" OR ""Head and neck cancer"" OR ""Carcinogenesis""))",AND date_published>=now-10y,"AND field_of_study: ((""Medicine"" OR ""Internal medicine"" OR ""Pharmacology"") AND (""Oncology"" OR ""Cancer"" OR ""Cancer research"" OR ""Chemotherapy"" OR ""Breast cancer"" OR ""Lung cancer"" OR ""Prostate cancer"" OR ""Pembrolizumab"" OR ""Multiple myeloma"" OR ""Colorectal cancer"" OR ""Neutropenia"" OR ""Metastatic breast cancer"" OR ""Lymphoma"" OR ""Myeloid leukemia"" OR ""Melanoma"" OR ""Renal cell carcinoma"" OR ""Leukemia"" OR ""Chronic lymphocytic leukemia"" OR ""Hepatocellular carcinoma"" OR ""Febrile neutropenia"" OR ""Carcinoma"" OR ""Ovarian cancer"" OR ""Response Evaluation Criteria in Solid Tumors"" OR ""Adenocarcinoma"" OR ""Follicular lymphoma"" OR ""Diffuse large B-cell lymphoma"" OR ""Cancer cell"" OR ""non-small cell lung cancer (NSCLC)"" OR ""Triple-negative breast cancer"" OR ""Pancreatic cancer"" OR ""Cancer immunotherapy"" OR ""Bladder cancer"" OR ""Cervical cancer"" OR ""Head and neck squamous-cell carcinoma"" OR ""Metastatic Urothelial Carcinoma"" OR ""Surgical oncology"" OR ""Head and neck cancer"" OR ""Carcinogenesis""))",NA,oa_therapy_area,Pharma,Oncology,2018,2941,475,334,321,359,25,1514,1427
oncology (primary search + oncology tags) - pharma,"(author.affiliation.name:(""pfizer"" OR ""astrazeneca"" OR ""eli lilly"" OR ""merck"" OR ""emd serono"" OR ""msd"" OR ""merck sharp & dohme"" OR ""bristol myers squibb"" OR ""novartis"" OR ""roche"" OR ""hoffmann-la roche"" OR ""genentech"" OR ""johnson & johnson"" OR ""janssen"" OR ""biosense webster"" OR ""glaxosmithkline"" OR ""gsk"" OR ""abbvie"" OR ""sanofi"" OR ""sanofi-aventis"" OR ""gilead sciences"" OR ""takeda"" OR ""boehringer ingelheim"" OR ""myokardia"" OR ""amgen"" OR ""applied molecular genetics"" OR ""bayer"" OR ""vertex pharmaceuticals"" OR ""regeneron"" OR ""novo nordisk"" OR ""biogen"" OR ""biogen idec"" OR ""daiichi sankyo"" OR ""astellas pharma"" OR ""asuterasu seiyaku kabushiki-gaisha"" OR ""otsuka"" OR ""otsuka seiyaku kabushiki-gaisha"" OR ""astex pharmaceuticals"" OR ""ucb"" OR ""union chimique belge"" OR ""moderna"" OR ""eisai"" OR ""ezai kabushiki-gaisha"" OR ""ea pharma"" OR ""csl"" OR ""zlb behring"" OR ""jiangsu hengrui medicine"" OR ""teva pharmaceuticals"" OR ""sumitomo dainippon pharma"" OR ""dainippon sumitomo seiyaku kabushiki-gaisha"" OR ""fresenius"" OR ""fresenius se & co. kgaa"" OR ""viatris"" OR ""kyowa kirin"" OR ""kyowa hakko kirin"" OR ""ipsen"" OR ""jazz pharmaceuticals"" OR ""azur pharma"" OR ""sino biopharm"" OR ""bausch health companies"" OR ""valeant pharmaceuticals"" OR ""cspc pharmaceutical group"" OR ""galapagos"" OR ""galapagos genomics"" NOT ""La Roche College"") OR author.affiliation.ror_id_lineage:(""01xdqrp08"" OR ""00by1q217"" OR ""04b2dty93"" OR ""02891sr49"" OR ""03qd7mz70"" OR ""00gtmwv55"" OR ""02f9zrr09"" OR ""04r9x1a08"" OR ""01qat3289"" OR ""01xsqw823"" OR ""02g5p4n58"" OR ""02n6c9837"" OR ""056546b03"" OR ""04hjbmv12"" OR ""00q32j219"" OR ""03g03ge92"" OR ""04hmn8g73"" OR ""00anb1726"" OR ""02f51rf24"" OR ""0435rc536"" OR ""02jqkb192"" OR ""027y26122"" OR ""01cjash87"" OR ""013k5y296"" OR ""01n029866"" OR ""01xm4wg91"" OR ""04vvh7p27"" OR ""044tc0x05"" OR ""04ayvvz32"" OR ""01wfv3m53"" OR ""04sapgw72"" OR ""01v376g59"" OR ""01g1gvr46"" OR ""000wej815"" OR ""00d801g55"" OR ""055mhsv54"" OR ""0086q4c12"" OR ""01zgpn844"" OR ""016mq8947"" OR ""04e4j5d46"")) AND publication_type:""journal article"" AND date_published>=now-10y AND field_of_study: ((""Medicine"" OR ""Internal medicine"" OR ""Pharmacology"") AND (""Oncology"" OR ""Cancer"" OR ""Cancer research"" OR ""Chemotherapy"" OR ""Breast cancer"" OR ""Lung cancer"" OR ""Prostate cancer"" OR ""Pembrolizumab"" OR ""Multiple myeloma"" OR ""Colorectal cancer"" OR ""Neutropenia"" OR ""Metastatic breast cancer"" OR ""Lymphoma"" OR ""Myeloid leukemia"" OR ""Melanoma"" OR ""Renal cell carcinoma"" OR ""Leukemia"" OR ""Chronic lymphocytic leukemia"" OR ""Hepatocellular carcinoma"" OR ""Febrile neutropenia"" OR ""Carcinoma"" OR ""Ovarian cancer"" OR ""Response Evaluation Criteria in Solid Tumors"" OR ""Adenocarcinoma"" OR ""Follicular lymphoma"" OR ""Diffuse large B-cell lymphoma"" OR ""Cancer cell"" OR ""non-small cell lung cancer (NSCLC)"" OR ""Triple-negative breast cancer"" OR ""Pancreatic cancer"" OR ""Cancer immunotherapy"" OR ""Bladder cancer"" OR ""Cervical cancer"" OR ""Head and neck squamous-cell carcinoma"" OR ""Metastatic Urothelial Carcinoma"" OR ""Surgical oncology"" OR ""Head and neck cancer"" OR ""Carcinogenesis""))",AND date_published>=now-10y,"AND field_of_study: ((""Medicine"" OR ""Internal medicine"" OR ""Pharmacology"") AND (""Oncology"" OR ""Cancer"" OR ""Cancer research"" OR ""Chemotherapy"" OR ""Breast cancer"" OR ""Lung cancer"" OR ""Prostate cancer"" OR ""Pembrolizumab"" OR ""Multiple myeloma"" OR ""Colorectal cancer"" OR ""Neutropenia"" OR ""Metastatic breast cancer"" OR ""Lymphoma"" OR ""Myeloid leukemia"" OR ""Melanoma"" OR ""Renal cell carcinoma"" OR ""Leukemia"" OR ""Chronic lymphocytic leukemia"" OR ""Hepatocellular carcinoma"" OR ""Febrile neutropenia"" OR ""Carcinoma"" OR ""Ovarian cancer"" OR ""Response Evaluation Criteria in Solid Tumors"" OR ""Adenocarcinoma"" OR ""Follicular lymphoma"" OR ""Diffuse large B-cell lymphoma"" OR ""Cancer cell"" OR ""non-small cell lung cancer (NSCLC)"" OR ""Triple-negative breast cancer"" OR ""Pancreatic cancer"" OR ""Cancer immunotherapy"" OR ""Bladder cancer"" OR ""Cervical cancer"" OR ""Head and neck squamous-cell carcinoma"" OR ""Metastatic Urothelial Carcinoma"" OR ""Surgical oncology"" OR ""Head and neck cancer"" OR ""Carcinogenesis""))",NA,oa_therapy_area,Pharma,Oncology,2019,3094,513,289,465,373,19,1659,1435
oncology (primary search + oncology tags) - pharma,"(author.affiliation.name:(""pfizer"" OR ""astrazeneca"" OR ""eli lilly"" OR ""merck"" OR ""emd serono"" OR ""msd"" OR ""merck sharp & dohme"" OR ""bristol myers squibb"" OR ""novartis"" OR ""roche"" OR ""hoffmann-la roche"" OR ""genentech"" OR ""johnson & johnson"" OR ""janssen"" OR ""biosense webster"" OR ""glaxosmithkline"" OR ""gsk"" OR ""abbvie"" OR ""sanofi"" OR ""sanofi-aventis"" OR ""gilead sciences"" OR ""takeda"" OR ""boehringer ingelheim"" OR ""myokardia"" OR ""amgen"" OR ""applied molecular genetics"" OR ""bayer"" OR ""vertex pharmaceuticals"" OR ""regeneron"" OR ""novo nordisk"" OR ""biogen"" OR ""biogen idec"" OR ""daiichi sankyo"" OR ""astellas pharma"" OR ""asuterasu seiyaku kabushiki-gaisha"" OR ""otsuka"" OR ""otsuka seiyaku kabushiki-gaisha"" OR ""astex pharmaceuticals"" OR ""ucb"" OR ""union chimique belge"" OR ""moderna"" OR ""eisai"" OR ""ezai kabushiki-gaisha"" OR ""ea pharma"" OR ""csl"" OR ""zlb behring"" OR ""jiangsu hengrui medicine"" OR ""teva pharmaceuticals"" OR ""sumitomo dainippon pharma"" OR ""dainippon sumitomo seiyaku kabushiki-gaisha"" OR ""fresenius"" OR ""fresenius se & co. kgaa"" OR ""viatris"" OR ""kyowa kirin"" OR ""kyowa hakko kirin"" OR ""ipsen"" OR ""jazz pharmaceuticals"" OR ""azur pharma"" OR ""sino biopharm"" OR ""bausch health companies"" OR ""valeant pharmaceuticals"" OR ""cspc pharmaceutical group"" OR ""galapagos"" OR ""galapagos genomics"" NOT ""La Roche College"") OR author.affiliation.ror_id_lineage:(""01xdqrp08"" OR ""00by1q217"" OR ""04b2dty93"" OR ""02891sr49"" OR ""03qd7mz70"" OR ""00gtmwv55"" OR ""02f9zrr09"" OR ""04r9x1a08"" OR ""01qat3289"" OR ""01xsqw823"" OR ""02g5p4n58"" OR ""02n6c9837"" OR ""056546b03"" OR ""04hjbmv12"" OR ""00q32j219"" OR ""03g03ge92"" OR ""04hmn8g73"" OR ""00anb1726"" OR ""02f51rf24"" OR ""0435rc536"" OR ""02jqkb192"" OR ""027y26122"" OR ""01cjash87"" OR ""013k5y296"" OR ""01n029866"" OR ""01xm4wg91"" OR ""04vvh7p27"" OR ""044tc0x05"" OR ""04ayvvz32"" OR ""01wfv3m53"" OR ""04sapgw72"" OR ""01v376g59"" OR ""01g1gvr46"" OR ""000wej815"" OR ""00d801g55"" OR ""055mhsv54"" OR ""0086q4c12"" OR ""01zgpn844"" OR ""016mq8947"" OR ""04e4j5d46"")) AND publication_type:""journal article"" AND date_published>=now-10y AND field_of_study: ((""Medicine"" OR ""Internal medicine"" OR ""Pharmacology"") AND (""Oncology"" OR ""Cancer"" OR ""Cancer research"" OR ""Chemotherapy"" OR ""Breast cancer"" OR ""Lung cancer"" OR ""Prostate cancer"" OR ""Pembrolizumab"" OR ""Multiple myeloma"" OR ""Colorectal cancer"" OR ""Neutropenia"" OR ""Metastatic breast cancer"" OR ""Lymphoma"" OR ""Myeloid leukemia"" OR ""Melanoma"" OR ""Renal cell carcinoma"" OR ""Leukemia"" OR ""Chronic lymphocytic leukemia"" OR ""Hepatocellular carcinoma"" OR ""Febrile neutropenia"" OR ""Carcinoma"" OR ""Ovarian cancer"" OR ""Response Evaluation Criteria in Solid Tumors"" OR ""Adenocarcinoma"" OR ""Follicular lymphoma"" OR ""Diffuse large B-cell lymphoma"" OR ""Cancer cell"" OR ""non-small cell lung cancer (NSCLC)"" OR ""Triple-negative breast cancer"" OR ""Pancreatic cancer"" OR ""Cancer immunotherapy"" OR ""Bladder cancer"" OR ""Cervical cancer"" OR ""Head and neck squamous-cell carcinoma"" OR ""Metastatic Urothelial Carcinoma"" OR ""Surgical oncology"" OR ""Head and neck cancer"" OR ""Carcinogenesis""))",AND date_published>=now-10y,"AND field_of_study: ((""Medicine"" OR ""Internal medicine"" OR ""Pharmacology"") AND (""Oncology"" OR ""Cancer"" OR ""Cancer research"" OR ""Chemotherapy"" OR ""Breast cancer"" OR ""Lung cancer"" OR ""Prostate cancer"" OR ""Pembrolizumab"" OR ""Multiple myeloma"" OR ""Colorectal cancer"" OR ""Neutropenia"" OR ""Metastatic breast cancer"" OR ""Lymphoma"" OR ""Myeloid leukemia"" OR ""Melanoma"" OR ""Renal cell carcinoma"" OR ""Leukemia"" OR ""Chronic lymphocytic leukemia"" OR ""Hepatocellular carcinoma"" OR ""Febrile neutropenia"" OR ""Carcinoma"" OR ""Ovarian cancer"" OR ""Response Evaluation Criteria in Solid Tumors"" OR ""Adenocarcinoma"" OR ""Follicular lymphoma"" OR ""Diffuse large B-cell lymphoma"" OR ""Cancer cell"" OR ""non-small cell lung cancer (NSCLC)"" OR ""Triple-negative breast cancer"" OR ""Pancreatic cancer"" OR ""Cancer immunotherapy"" OR ""Bladder cancer"" OR ""Cervical cancer"" OR ""Head and neck squamous-cell carcinoma"" OR ""Metastatic Urothelial Carcinoma"" OR ""Surgical oncology"" OR ""Head and neck cancer"" OR ""Carcinogenesis""))",NA,oa_therapy_area,Pharma,Oncology,2020,3445,716,252,550,389,35,1942,1503
oncology (primary search + oncology tags) - pharma,"(author.affiliation.name:(""pfizer"" OR ""astrazeneca"" OR ""eli lilly"" OR ""merck"" OR ""emd serono"" OR ""msd"" OR ""merck sharp & dohme"" OR ""bristol myers squibb"" OR ""novartis"" OR ""roche"" OR ""hoffmann-la roche"" OR ""genentech"" OR ""johnson & johnson"" OR ""janssen"" OR ""biosense webster"" OR ""glaxosmithkline"" OR ""gsk"" OR ""abbvie"" OR ""sanofi"" OR ""sanofi-aventis"" OR ""gilead sciences"" OR ""takeda"" OR ""boehringer ingelheim"" OR ""myokardia"" OR ""amgen"" OR ""applied molecular genetics"" OR ""bayer"" OR ""vertex pharmaceuticals"" OR ""regeneron"" OR ""novo nordisk"" OR ""biogen"" OR ""biogen idec"" OR ""daiichi sankyo"" OR ""astellas pharma"" OR ""asuterasu seiyaku kabushiki-gaisha"" OR ""otsuka"" OR ""otsuka seiyaku kabushiki-gaisha"" OR ""astex pharmaceuticals"" OR ""ucb"" OR ""union chimique belge"" OR ""moderna"" OR ""eisai"" OR ""ezai kabushiki-gaisha"" OR ""ea pharma"" OR ""csl"" OR ""zlb behring"" OR ""jiangsu hengrui medicine"" OR ""teva pharmaceuticals"" OR ""sumitomo dainippon pharma"" OR ""dainippon sumitomo seiyaku kabushiki-gaisha"" OR ""fresenius"" OR ""fresenius se & co. kgaa"" OR ""viatris"" OR ""kyowa kirin"" OR ""kyowa hakko kirin"" OR ""ipsen"" OR ""jazz pharmaceuticals"" OR ""azur pharma"" OR ""sino biopharm"" OR ""bausch health companies"" OR ""valeant pharmaceuticals"" OR ""cspc pharmaceutical group"" OR ""galapagos"" OR ""galapagos genomics"" NOT ""La Roche College"") OR author.affiliation.ror_id_lineage:(""01xdqrp08"" OR ""00by1q217"" OR ""04b2dty93"" OR ""02891sr49"" OR ""03qd7mz70"" OR ""00gtmwv55"" OR ""02f9zrr09"" OR ""04r9x1a08"" OR ""01qat3289"" OR ""01xsqw823"" OR ""02g5p4n58"" OR ""02n6c9837"" OR ""056546b03"" OR ""04hjbmv12"" OR ""00q32j219"" OR ""03g03ge92"" OR ""04hmn8g73"" OR ""00anb1726"" OR ""02f51rf24"" OR ""0435rc536"" OR ""02jqkb192"" OR ""027y26122"" OR ""01cjash87"" OR ""013k5y296"" OR ""01n029866"" OR ""01xm4wg91"" OR ""04vvh7p27"" OR ""044tc0x05"" OR ""04ayvvz32"" OR ""01wfv3m53"" OR ""04sapgw72"" OR ""01v376g59"" OR ""01g1gvr46"" OR ""000wej815"" OR ""00d801g55"" OR ""055mhsv54"" OR ""0086q4c12"" OR ""01zgpn844"" OR ""016mq8947"" OR ""04e4j5d46"")) AND publication_type:""journal article"" AND date_published>=now-10y AND field_of_study: ((""Medicine"" OR ""Internal medicine"" OR ""Pharmacology"") AND (""Oncology"" OR ""Cancer"" OR ""Cancer research"" OR ""Chemotherapy"" OR ""Breast cancer"" OR ""Lung cancer"" OR ""Prostate cancer"" OR ""Pembrolizumab"" OR ""Multiple myeloma"" OR ""Colorectal cancer"" OR ""Neutropenia"" OR ""Metastatic breast cancer"" OR ""Lymphoma"" OR ""Myeloid leukemia"" OR ""Melanoma"" OR ""Renal cell carcinoma"" OR ""Leukemia"" OR ""Chronic lymphocytic leukemia"" OR ""Hepatocellular carcinoma"" OR ""Febrile neutropenia"" OR ""Carcinoma"" OR ""Ovarian cancer"" OR ""Response Evaluation Criteria in Solid Tumors"" OR ""Adenocarcinoma"" OR ""Follicular lymphoma"" OR ""Diffuse large B-cell lymphoma"" OR ""Cancer cell"" OR ""non-small cell lung cancer (NSCLC)"" OR ""Triple-negative breast cancer"" OR ""Pancreatic cancer"" OR ""Cancer immunotherapy"" OR ""Bladder cancer"" OR ""Cervical cancer"" OR ""Head and neck squamous-cell carcinoma"" OR ""Metastatic Urothelial Carcinoma"" OR ""Surgical oncology"" OR ""Head and neck cancer"" OR ""Carcinogenesis""))",AND date_published>=now-10y,"AND field_of_study: ((""Medicine"" OR ""Internal medicine"" OR ""Pharmacology"") AND (""Oncology"" OR ""Cancer"" OR ""Cancer research"" OR ""Chemotherapy"" OR ""Breast cancer"" OR ""Lung cancer"" OR ""Prostate cancer"" OR ""Pembrolizumab"" OR ""Multiple myeloma"" OR ""Colorectal cancer"" OR ""Neutropenia"" OR ""Metastatic breast cancer"" OR ""Lymphoma"" OR ""Myeloid leukemia"" OR ""Melanoma"" OR ""Renal cell carcinoma"" OR ""Leukemia"" OR ""Chronic lymphocytic leukemia"" OR ""Hepatocellular carcinoma"" OR ""Febrile neutropenia"" OR ""Carcinoma"" OR ""Ovarian cancer"" OR ""Response Evaluation Criteria in Solid Tumors"" OR ""Adenocarcinoma"" OR ""Follicular lymphoma"" OR ""Diffuse large B-cell lymphoma"" OR ""Cancer cell"" OR ""non-small cell lung cancer (NSCLC)"" OR ""Triple-negative breast cancer"" OR ""Pancreatic cancer"" OR ""Cancer immunotherapy"" OR ""Bladder cancer"" OR ""Cervical cancer"" OR ""Head and neck squamous-cell carcinoma"" OR ""Metastatic Urothelial Carcinoma"" OR ""Surgical oncology"" OR ""Head and neck cancer"" OR ""Carcinogenesis""))",NA,oa_therapy_area,Pharma,Oncology,2021,3720,906,153,685,487,93,2324,1396
oncology (primary search + oncology tags) - pharma,"(author.affiliation.name:(""pfizer"" OR ""astrazeneca"" OR ""eli lilly"" OR ""merck"" OR ""emd serono"" OR ""msd"" OR ""merck sharp & dohme"" OR ""bristol myers squibb"" OR ""novartis"" OR ""roche"" OR ""hoffmann-la roche"" OR ""genentech"" OR ""johnson & johnson"" OR ""janssen"" OR ""biosense webster"" OR ""glaxosmithkline"" OR ""gsk"" OR ""abbvie"" OR ""sanofi"" OR ""sanofi-aventis"" OR ""gilead sciences"" OR ""takeda"" OR ""boehringer ingelheim"" OR ""myokardia"" OR ""amgen"" OR ""applied molecular genetics"" OR ""bayer"" OR ""vertex pharmaceuticals"" OR ""regeneron"" OR ""novo nordisk"" OR ""biogen"" OR ""biogen idec"" OR ""daiichi sankyo"" OR ""astellas pharma"" OR ""asuterasu seiyaku kabushiki-gaisha"" OR ""otsuka"" OR ""otsuka seiyaku kabushiki-gaisha"" OR ""astex pharmaceuticals"" OR ""ucb"" OR ""union chimique belge"" OR ""moderna"" OR ""eisai"" OR ""ezai kabushiki-gaisha"" OR ""ea pharma"" OR ""csl"" OR ""zlb behring"" OR ""jiangsu hengrui medicine"" OR ""teva pharmaceuticals"" OR ""sumitomo dainippon pharma"" OR ""dainippon sumitomo seiyaku kabushiki-gaisha"" OR ""fresenius"" OR ""fresenius se & co. kgaa"" OR ""viatris"" OR ""kyowa kirin"" OR ""kyowa hakko kirin"" OR ""ipsen"" OR ""jazz pharmaceuticals"" OR ""azur pharma"" OR ""sino biopharm"" OR ""bausch health companies"" OR ""valeant pharmaceuticals"" OR ""cspc pharmaceutical group"" OR ""galapagos"" OR ""galapagos genomics"" NOT ""La Roche College"") OR author.affiliation.ror_id_lineage:(""01xdqrp08"" OR ""00by1q217"" OR ""04b2dty93"" OR ""02891sr49"" OR ""03qd7mz70"" OR ""00gtmwv55"" OR ""02f9zrr09"" OR ""04r9x1a08"" OR ""01qat3289"" OR ""01xsqw823"" OR ""02g5p4n58"" OR ""02n6c9837"" OR ""056546b03"" OR ""04hjbmv12"" OR ""00q32j219"" OR ""03g03ge92"" OR ""04hmn8g73"" OR ""00anb1726"" OR ""02f51rf24"" OR ""0435rc536"" OR ""02jqkb192"" OR ""027y26122"" OR ""01cjash87"" OR ""013k5y296"" OR ""01n029866"" OR ""01xm4wg91"" OR ""04vvh7p27"" OR ""044tc0x05"" OR ""04ayvvz32"" OR ""01wfv3m53"" OR ""04sapgw72"" OR ""01v376g59"" OR ""01g1gvr46"" OR ""000wej815"" OR ""00d801g55"" OR ""055mhsv54"" OR ""0086q4c12"" OR ""01zgpn844"" OR ""016mq8947"" OR ""04e4j5d46"")) AND publication_type:""journal article"" AND date_published>=now-10y AND field_of_study: ((""Medicine"" OR ""Internal medicine"" OR ""Pharmacology"") AND (""Oncology"" OR ""Cancer"" OR ""Cancer research"" OR ""Chemotherapy"" OR ""Breast cancer"" OR ""Lung cancer"" OR ""Prostate cancer"" OR ""Pembrolizumab"" OR ""Multiple myeloma"" OR ""Colorectal cancer"" OR ""Neutropenia"" OR ""Metastatic breast cancer"" OR ""Lymphoma"" OR ""Myeloid leukemia"" OR ""Melanoma"" OR ""Renal cell carcinoma"" OR ""Leukemia"" OR ""Chronic lymphocytic leukemia"" OR ""Hepatocellular carcinoma"" OR ""Febrile neutropenia"" OR ""Carcinoma"" OR ""Ovarian cancer"" OR ""Response Evaluation Criteria in Solid Tumors"" OR ""Adenocarcinoma"" OR ""Follicular lymphoma"" OR ""Diffuse large B-cell lymphoma"" OR ""Cancer cell"" OR ""non-small cell lung cancer (NSCLC)"" OR ""Triple-negative breast cancer"" OR ""Pancreatic cancer"" OR ""Cancer immunotherapy"" OR ""Bladder cancer"" OR ""Cervical cancer"" OR ""Head and neck squamous-cell carcinoma"" OR ""Metastatic Urothelial Carcinoma"" OR ""Surgical oncology"" OR ""Head and neck cancer"" OR ""Carcinogenesis""))",AND date_published>=now-10y,"AND field_of_study: ((""Medicine"" OR ""Internal medicine"" OR ""Pharmacology"") AND (""Oncology"" OR ""Cancer"" OR ""Cancer research"" OR ""Chemotherapy"" OR ""Breast cancer"" OR ""Lung cancer"" OR ""Prostate cancer"" OR ""Pembrolizumab"" OR ""Multiple myeloma"" OR ""Colorectal cancer"" OR ""Neutropenia"" OR ""Metastatic breast cancer"" OR ""Lymphoma"" OR ""Myeloid leukemia"" OR ""Melanoma"" OR ""Renal cell carcinoma"" OR ""Leukemia"" OR ""Chronic lymphocytic leukemia"" OR ""Hepatocellular carcinoma"" OR ""Febrile neutropenia"" OR ""Carcinoma"" OR ""Ovarian cancer"" OR ""Response Evaluation Criteria in Solid Tumors"" OR ""Adenocarcinoma"" OR ""Follicular lymphoma"" OR ""Diffuse large B-cell lymphoma"" OR ""Cancer cell"" OR ""non-small cell lung cancer (NSCLC)"" OR ""Triple-negative breast cancer"" OR ""Pancreatic cancer"" OR ""Cancer immunotherapy"" OR ""Bladder cancer"" OR ""Cervical cancer"" OR ""Head and neck squamous-cell carcinoma"" OR ""Metastatic Urothelial Carcinoma"" OR ""Surgical oncology"" OR ""Head and neck cancer"" OR ""Carcinogenesis""))",NA,oa_therapy_area,Pharma,Oncology,2022,3960,1282,175,715,139,82,2393,1567
oncology (primary search + oncology tags) - pharma,"(author.affiliation.name:(""pfizer"" OR ""astrazeneca"" OR ""eli lilly"" OR ""merck"" OR ""emd serono"" OR ""msd"" OR ""merck sharp & dohme"" OR ""bristol myers squibb"" OR ""novartis"" OR ""roche"" OR ""hoffmann-la roche"" OR ""genentech"" OR ""johnson & johnson"" OR ""janssen"" OR ""biosense webster"" OR ""glaxosmithkline"" OR ""gsk"" OR ""abbvie"" OR ""sanofi"" OR ""sanofi-aventis"" OR ""gilead sciences"" OR ""takeda"" OR ""boehringer ingelheim"" OR ""myokardia"" OR ""amgen"" OR ""applied molecular genetics"" OR ""bayer"" OR ""vertex pharmaceuticals"" OR ""regeneron"" OR ""novo nordisk"" OR ""biogen"" OR ""biogen idec"" OR ""daiichi sankyo"" OR ""astellas pharma"" OR ""asuterasu seiyaku kabushiki-gaisha"" OR ""otsuka"" OR ""otsuka seiyaku kabushiki-gaisha"" OR ""astex pharmaceuticals"" OR ""ucb"" OR ""union chimique belge"" OR ""moderna"" OR ""eisai"" OR ""ezai kabushiki-gaisha"" OR ""ea pharma"" OR ""csl"" OR ""zlb behring"" OR ""jiangsu hengrui medicine"" OR ""teva pharmaceuticals"" OR ""sumitomo dainippon pharma"" OR ""dainippon sumitomo seiyaku kabushiki-gaisha"" OR ""fresenius"" OR ""fresenius se & co. kgaa"" OR ""viatris"" OR ""kyowa kirin"" OR ""kyowa hakko kirin"" OR ""ipsen"" OR ""jazz pharmaceuticals"" OR ""azur pharma"" OR ""sino biopharm"" OR ""bausch health companies"" OR ""valeant pharmaceuticals"" OR ""cspc pharmaceutical group"" OR ""galapagos"" OR ""galapagos genomics"" NOT ""La Roche College"") OR author.affiliation.ror_id_lineage:(""01xdqrp08"" OR ""00by1q217"" OR ""04b2dty93"" OR ""02891sr49"" OR ""03qd7mz70"" OR ""00gtmwv55"" OR ""02f9zrr09"" OR ""04r9x1a08"" OR ""01qat3289"" OR ""01xsqw823"" OR ""02g5p4n58"" OR ""02n6c9837"" OR ""056546b03"" OR ""04hjbmv12"" OR ""00q32j219"" OR ""03g03ge92"" OR ""04hmn8g73"" OR ""00anb1726"" OR ""02f51rf24"" OR ""0435rc536"" OR ""02jqkb192"" OR ""027y26122"" OR ""01cjash87"" OR ""013k5y296"" OR ""01n029866"" OR ""01xm4wg91"" OR ""04vvh7p27"" OR ""044tc0x05"" OR ""04ayvvz32"" OR ""01wfv3m53"" OR ""04sapgw72"" OR ""01v376g59"" OR ""01g1gvr46"" OR ""000wej815"" OR ""00d801g55"" OR ""055mhsv54"" OR ""0086q4c12"" OR ""01zgpn844"" OR ""016mq8947"" OR ""04e4j5d46"")) AND publication_type:""journal article"" AND date_published>=now-10y AND field_of_study: ((""Medicine"" OR ""Internal medicine"" OR ""Pharmacology"") AND (""Oncology"" OR ""Cancer"" OR ""Cancer research"" OR ""Chemotherapy"" OR ""Breast cancer"" OR ""Lung cancer"" OR ""Prostate cancer"" OR ""Pembrolizumab"" OR ""Multiple myeloma"" OR ""Colorectal cancer"" OR ""Neutropenia"" OR ""Metastatic breast cancer"" OR ""Lymphoma"" OR ""Myeloid leukemia"" OR ""Melanoma"" OR ""Renal cell carcinoma"" OR ""Leukemia"" OR ""Chronic lymphocytic leukemia"" OR ""Hepatocellular carcinoma"" OR ""Febrile neutropenia"" OR ""Carcinoma"" OR ""Ovarian cancer"" OR ""Response Evaluation Criteria in Solid Tumors"" OR ""Adenocarcinoma"" OR ""Follicular lymphoma"" OR ""Diffuse large B-cell lymphoma"" OR ""Cancer cell"" OR ""non-small cell lung cancer (NSCLC)"" OR ""Triple-negative breast cancer"" OR ""Pancreatic cancer"" OR ""Cancer immunotherapy"" OR ""Bladder cancer"" OR ""Cervical cancer"" OR ""Head and neck squamous-cell carcinoma"" OR ""Metastatic Urothelial Carcinoma"" OR ""Surgical oncology"" OR ""Head and neck cancer"" OR ""Carcinogenesis""))",AND date_published>=now-10y,"AND field_of_study: ((""Medicine"" OR ""Internal medicine"" OR ""Pharmacology"") AND (""Oncology"" OR ""Cancer"" OR ""Cancer research"" OR ""Chemotherapy"" OR ""Breast cancer"" OR ""Lung cancer"" OR ""Prostate cancer"" OR ""Pembrolizumab"" OR ""Multiple myeloma"" OR ""Colorectal cancer"" OR ""Neutropenia"" OR ""Metastatic breast cancer"" OR ""Lymphoma"" OR ""Myeloid leukemia"" OR ""Melanoma"" OR ""Renal cell carcinoma"" OR ""Leukemia"" OR ""Chronic lymphocytic leukemia"" OR ""Hepatocellular carcinoma"" OR ""Febrile neutropenia"" OR ""Carcinoma"" OR ""Ovarian cancer"" OR ""Response Evaluation Criteria in Solid Tumors"" OR ""Adenocarcinoma"" OR ""Follicular lymphoma"" OR ""Diffuse large B-cell lymphoma"" OR ""Cancer cell"" OR ""non-small cell lung cancer (NSCLC)"" OR ""Triple-negative breast cancer"" OR ""Pancreatic cancer"" OR ""Cancer immunotherapy"" OR ""Bladder cancer"" OR ""Cervical cancer"" OR ""Head and neck squamous-cell carcinoma"" OR ""Metastatic Urothelial Carcinoma"" OR ""Surgical oncology"" OR ""Head and neck cancer"" OR ""Carcinogenesis""))",NA,oa_therapy_area,Pharma,Oncology,2023,1393,453,13,239,37,126,868,525
pharmacology (primary search + pharmacology tags) - pharma,"(author.affiliation.name:(""pfizer"" OR ""astrazeneca"" OR ""eli lilly"" OR ""merck"" OR ""emd serono"" OR ""msd"" OR ""merck sharp & dohme"" OR ""bristol myers squibb"" OR ""novartis"" OR ""roche"" OR ""hoffmann-la roche"" OR ""genentech"" OR ""johnson & johnson"" OR ""janssen"" OR ""biosense webster"" OR ""glaxosmithkline"" OR ""gsk"" OR ""abbvie"" OR ""sanofi"" OR ""sanofi-aventis"" OR ""gilead sciences"" OR ""takeda"" OR ""boehringer ingelheim"" OR ""myokardia"" OR ""amgen"" OR ""applied molecular genetics"" OR ""bayer"" OR ""vertex pharmaceuticals"" OR ""regeneron"" OR ""novo nordisk"" OR ""biogen"" OR ""biogen idec"" OR ""daiichi sankyo"" OR ""astellas pharma"" OR ""asuterasu seiyaku kabushiki-gaisha"" OR ""otsuka"" OR ""otsuka seiyaku kabushiki-gaisha"" OR ""astex pharmaceuticals"" OR ""ucb"" OR ""union chimique belge"" OR ""moderna"" OR ""eisai"" OR ""ezai kabushiki-gaisha"" OR ""ea pharma"" OR ""csl"" OR ""zlb behring"" OR ""jiangsu hengrui medicine"" OR ""teva pharmaceuticals"" OR ""sumitomo dainippon pharma"" OR ""dainippon sumitomo seiyaku kabushiki-gaisha"" OR ""fresenius"" OR ""fresenius se & co. kgaa"" OR ""viatris"" OR ""kyowa kirin"" OR ""kyowa hakko kirin"" OR ""ipsen"" OR ""jazz pharmaceuticals"" OR ""azur pharma"" OR ""sino biopharm"" OR ""bausch health companies"" OR ""valeant pharmaceuticals"" OR ""cspc pharmaceutical group"" OR ""galapagos"" OR ""galapagos genomics"" NOT ""La Roche College"") OR author.affiliation.ror_id_lineage:(""01xdqrp08"" OR ""00by1q217"" OR ""04b2dty93"" OR ""02891sr49"" OR ""03qd7mz70"" OR ""00gtmwv55"" OR ""02f9zrr09"" OR ""04r9x1a08"" OR ""01qat3289"" OR ""01xsqw823"" OR ""02g5p4n58"" OR ""02n6c9837"" OR ""056546b03"" OR ""04hjbmv12"" OR ""00q32j219"" OR ""03g03ge92"" OR ""04hmn8g73"" OR ""00anb1726"" OR ""02f51rf24"" OR ""0435rc536"" OR ""02jqkb192"" OR ""027y26122"" OR ""01cjash87"" OR ""013k5y296"" OR ""01n029866"" OR ""01xm4wg91"" OR ""04vvh7p27"" OR ""044tc0x05"" OR ""04ayvvz32"" OR ""01wfv3m53"" OR ""04sapgw72"" OR ""01v376g59"" OR ""01g1gvr46"" OR ""000wej815"" OR ""00d801g55"" OR ""055mhsv54"" OR ""0086q4c12"" OR ""01zgpn844"" OR ""016mq8947"" OR ""04e4j5d46"")) AND publication_type:""journal article"" AND date_published>=now-10y AND field_of_study: ((""Medicine"" OR ""Internal medicine"" OR ""Pharmacology"") AND (""Pharmacology"" OR ""Pharmacokinetics"" OR ""Chemistry"" OR ""Biochemistry"" OR ""Pharmacodynamics"" OR ""In vitro"" OR ""Pharmacotherapy"" OR ""Clinical pharmacology""))",AND date_published>=now-10y,"AND field_of_study: ((""Medicine"" OR ""Internal medicine"" OR ""Pharmacology"") AND (""Pharmacology"" OR ""Pharmacokinetics"" OR ""Chemistry"" OR ""Biochemistry"" OR ""Pharmacodynamics"" OR ""In vitro"" OR ""Pharmacotherapy"" OR ""Clinical pharmacology""))",NA,oa_therapy_area,Pharma,Pharmacology,2013,889,115,112,54,53,5,339,550
pharmacology (primary search + pharmacology tags) - pharma,"(author.affiliation.name:(""pfizer"" OR ""astrazeneca"" OR ""eli lilly"" OR ""merck"" OR ""emd serono"" OR ""msd"" OR ""merck sharp & dohme"" OR ""bristol myers squibb"" OR ""novartis"" OR ""roche"" OR ""hoffmann-la roche"" OR ""genentech"" OR ""johnson & johnson"" OR ""janssen"" OR ""biosense webster"" OR ""glaxosmithkline"" OR ""gsk"" OR ""abbvie"" OR ""sanofi"" OR ""sanofi-aventis"" OR ""gilead sciences"" OR ""takeda"" OR ""boehringer ingelheim"" OR ""myokardia"" OR ""amgen"" OR ""applied molecular genetics"" OR ""bayer"" OR ""vertex pharmaceuticals"" OR ""regeneron"" OR ""novo nordisk"" OR ""biogen"" OR ""biogen idec"" OR ""daiichi sankyo"" OR ""astellas pharma"" OR ""asuterasu seiyaku kabushiki-gaisha"" OR ""otsuka"" OR ""otsuka seiyaku kabushiki-gaisha"" OR ""astex pharmaceuticals"" OR ""ucb"" OR ""union chimique belge"" OR ""moderna"" OR ""eisai"" OR ""ezai kabushiki-gaisha"" OR ""ea pharma"" OR ""csl"" OR ""zlb behring"" OR ""jiangsu hengrui medicine"" OR ""teva pharmaceuticals"" OR ""sumitomo dainippon pharma"" OR ""dainippon sumitomo seiyaku kabushiki-gaisha"" OR ""fresenius"" OR ""fresenius se & co. kgaa"" OR ""viatris"" OR ""kyowa kirin"" OR ""kyowa hakko kirin"" OR ""ipsen"" OR ""jazz pharmaceuticals"" OR ""azur pharma"" OR ""sino biopharm"" OR ""bausch health companies"" OR ""valeant pharmaceuticals"" OR ""cspc pharmaceutical group"" OR ""galapagos"" OR ""galapagos genomics"" NOT ""La Roche College"") OR author.affiliation.ror_id_lineage:(""01xdqrp08"" OR ""00by1q217"" OR ""04b2dty93"" OR ""02891sr49"" OR ""03qd7mz70"" OR ""00gtmwv55"" OR ""02f9zrr09"" OR ""04r9x1a08"" OR ""01qat3289"" OR ""01xsqw823"" OR ""02g5p4n58"" OR ""02n6c9837"" OR ""056546b03"" OR ""04hjbmv12"" OR ""00q32j219"" OR ""03g03ge92"" OR ""04hmn8g73"" OR ""00anb1726"" OR ""02f51rf24"" OR ""0435rc536"" OR ""02jqkb192"" OR ""027y26122"" OR ""01cjash87"" OR ""013k5y296"" OR ""01n029866"" OR ""01xm4wg91"" OR ""04vvh7p27"" OR ""044tc0x05"" OR ""04ayvvz32"" OR ""01wfv3m53"" OR ""04sapgw72"" OR ""01v376g59"" OR ""01g1gvr46"" OR ""000wej815"" OR ""00d801g55"" OR ""055mhsv54"" OR ""0086q4c12"" OR ""01zgpn844"" OR ""016mq8947"" OR ""04e4j5d46"")) AND publication_type:""journal article"" AND date_published>=now-10y AND field_of_study: ((""Medicine"" OR ""Internal medicine"" OR ""Pharmacology"") AND (""Pharmacology"" OR ""Pharmacokinetics"" OR ""Chemistry"" OR ""Biochemistry"" OR ""Pharmacodynamics"" OR ""In vitro"" OR ""Pharmacotherapy"" OR ""Clinical pharmacology""))",AND date_published>=now-10y,"AND field_of_study: ((""Medicine"" OR ""Internal medicine"" OR ""Pharmacology"") AND (""Pharmacology"" OR ""Pharmacokinetics"" OR ""Chemistry"" OR ""Biochemistry"" OR ""Pharmacodynamics"" OR ""In vitro"" OR ""Pharmacotherapy"" OR ""Clinical pharmacology""))",NA,oa_therapy_area,Pharma,Pharmacology,2014,2287,325,295,201,121,27,969,1318
pharmacology (primary search + pharmacology tags) - pharma,"(author.affiliation.name:(""pfizer"" OR ""astrazeneca"" OR ""eli lilly"" OR ""merck"" OR ""emd serono"" OR ""msd"" OR ""merck sharp & dohme"" OR ""bristol myers squibb"" OR ""novartis"" OR ""roche"" OR ""hoffmann-la roche"" OR ""genentech"" OR ""johnson & johnson"" OR ""janssen"" OR ""biosense webster"" OR ""glaxosmithkline"" OR ""gsk"" OR ""abbvie"" OR ""sanofi"" OR ""sanofi-aventis"" OR ""gilead sciences"" OR ""takeda"" OR ""boehringer ingelheim"" OR ""myokardia"" OR ""amgen"" OR ""applied molecular genetics"" OR ""bayer"" OR ""vertex pharmaceuticals"" OR ""regeneron"" OR ""novo nordisk"" OR ""biogen"" OR ""biogen idec"" OR ""daiichi sankyo"" OR ""astellas pharma"" OR ""asuterasu seiyaku kabushiki-gaisha"" OR ""otsuka"" OR ""otsuka seiyaku kabushiki-gaisha"" OR ""astex pharmaceuticals"" OR ""ucb"" OR ""union chimique belge"" OR ""moderna"" OR ""eisai"" OR ""ezai kabushiki-gaisha"" OR ""ea pharma"" OR ""csl"" OR ""zlb behring"" OR ""jiangsu hengrui medicine"" OR ""teva pharmaceuticals"" OR ""sumitomo dainippon pharma"" OR ""dainippon sumitomo seiyaku kabushiki-gaisha"" OR ""fresenius"" OR ""fresenius se & co. kgaa"" OR ""viatris"" OR ""kyowa kirin"" OR ""kyowa hakko kirin"" OR ""ipsen"" OR ""jazz pharmaceuticals"" OR ""azur pharma"" OR ""sino biopharm"" OR ""bausch health companies"" OR ""valeant pharmaceuticals"" OR ""cspc pharmaceutical group"" OR ""galapagos"" OR ""galapagos genomics"" NOT ""La Roche College"") OR author.affiliation.ror_id_lineage:(""01xdqrp08"" OR ""00by1q217"" OR ""04b2dty93"" OR ""02891sr49"" OR ""03qd7mz70"" OR ""00gtmwv55"" OR ""02f9zrr09"" OR ""04r9x1a08"" OR ""01qat3289"" OR ""01xsqw823"" OR ""02g5p4n58"" OR ""02n6c9837"" OR ""056546b03"" OR ""04hjbmv12"" OR ""00q32j219"" OR ""03g03ge92"" OR ""04hmn8g73"" OR ""00anb1726"" OR ""02f51rf24"" OR ""0435rc536"" OR ""02jqkb192"" OR ""027y26122"" OR ""01cjash87"" OR ""013k5y296"" OR ""01n029866"" OR ""01xm4wg91"" OR ""04vvh7p27"" OR ""044tc0x05"" OR ""04ayvvz32"" OR ""01wfv3m53"" OR ""04sapgw72"" OR ""01v376g59"" OR ""01g1gvr46"" OR ""000wej815"" OR ""00d801g55"" OR ""055mhsv54"" OR ""0086q4c12"" OR ""01zgpn844"" OR ""016mq8947"" OR ""04e4j5d46"")) AND publication_type:""journal article"" AND date_published>=now-10y AND field_of_study: ((""Medicine"" OR ""Internal medicine"" OR ""Pharmacology"") AND (""Pharmacology"" OR ""Pharmacokinetics"" OR ""Chemistry"" OR ""Biochemistry"" OR ""Pharmacodynamics"" OR ""In vitro"" OR ""Pharmacotherapy"" OR ""Clinical pharmacology""))",AND date_published>=now-10y,"AND field_of_study: ((""Medicine"" OR ""Internal medicine"" OR ""Pharmacology"") AND (""Pharmacology"" OR ""Pharmacokinetics"" OR ""Chemistry"" OR ""Biochemistry"" OR ""Pharmacodynamics"" OR ""In vitro"" OR ""Pharmacotherapy"" OR ""Clinical pharmacology""))",NA,oa_therapy_area,Pharma,Pharmacology,2015,2255,313,324,231,166,7,1041,1214
pharmacology (primary search + pharmacology tags) - pharma,"(author.affiliation.name:(""pfizer"" OR ""astrazeneca"" OR ""eli lilly"" OR ""merck"" OR ""emd serono"" OR ""msd"" OR ""merck sharp & dohme"" OR ""bristol myers squibb"" OR ""novartis"" OR ""roche"" OR ""hoffmann-la roche"" OR ""genentech"" OR ""johnson & johnson"" OR ""janssen"" OR ""biosense webster"" OR ""glaxosmithkline"" OR ""gsk"" OR ""abbvie"" OR ""sanofi"" OR ""sanofi-aventis"" OR ""gilead sciences"" OR ""takeda"" OR ""boehringer ingelheim"" OR ""myokardia"" OR ""amgen"" OR ""applied molecular genetics"" OR ""bayer"" OR ""vertex pharmaceuticals"" OR ""regeneron"" OR ""novo nordisk"" OR ""biogen"" OR ""biogen idec"" OR ""daiichi sankyo"" OR ""astellas pharma"" OR ""asuterasu seiyaku kabushiki-gaisha"" OR ""otsuka"" OR ""otsuka seiyaku kabushiki-gaisha"" OR ""astex pharmaceuticals"" OR ""ucb"" OR ""union chimique belge"" OR ""moderna"" OR ""eisai"" OR ""ezai kabushiki-gaisha"" OR ""ea pharma"" OR ""csl"" OR ""zlb behring"" OR ""jiangsu hengrui medicine"" OR ""teva pharmaceuticals"" OR ""sumitomo dainippon pharma"" OR ""dainippon sumitomo seiyaku kabushiki-gaisha"" OR ""fresenius"" OR ""fresenius se & co. kgaa"" OR ""viatris"" OR ""kyowa kirin"" OR ""kyowa hakko kirin"" OR ""ipsen"" OR ""jazz pharmaceuticals"" OR ""azur pharma"" OR ""sino biopharm"" OR ""bausch health companies"" OR ""valeant pharmaceuticals"" OR ""cspc pharmaceutical group"" OR ""galapagos"" OR ""galapagos genomics"" NOT ""La Roche College"") OR author.affiliation.ror_id_lineage:(""01xdqrp08"" OR ""00by1q217"" OR ""04b2dty93"" OR ""02891sr49"" OR ""03qd7mz70"" OR ""00gtmwv55"" OR ""02f9zrr09"" OR ""04r9x1a08"" OR ""01qat3289"" OR ""01xsqw823"" OR ""02g5p4n58"" OR ""02n6c9837"" OR ""056546b03"" OR ""04hjbmv12"" OR ""00q32j219"" OR ""03g03ge92"" OR ""04hmn8g73"" OR ""00anb1726"" OR ""02f51rf24"" OR ""0435rc536"" OR ""02jqkb192"" OR ""027y26122"" OR ""01cjash87"" OR ""013k5y296"" OR ""01n029866"" OR ""01xm4wg91"" OR ""04vvh7p27"" OR ""044tc0x05"" OR ""04ayvvz32"" OR ""01wfv3m53"" OR ""04sapgw72"" OR ""01v376g59"" OR ""01g1gvr46"" OR ""000wej815"" OR ""00d801g55"" OR ""055mhsv54"" OR ""0086q4c12"" OR ""01zgpn844"" OR ""016mq8947"" OR ""04e4j5d46"")) AND publication_type:""journal article"" AND date_published>=now-10y AND field_of_study: ((""Medicine"" OR ""Internal medicine"" OR ""Pharmacology"") AND (""Pharmacology"" OR ""Pharmacokinetics"" OR ""Chemistry"" OR ""Biochemistry"" OR ""Pharmacodynamics"" OR ""In vitro"" OR ""Pharmacotherapy"" OR ""Clinical pharmacology""))",AND date_published>=now-10y,"AND field_of_study: ((""Medicine"" OR ""Internal medicine"" OR ""Pharmacology"") AND (""Pharmacology"" OR ""Pharmacokinetics"" OR ""Chemistry"" OR ""Biochemistry"" OR ""Pharmacodynamics"" OR ""In vitro"" OR ""Pharmacotherapy"" OR ""Clinical pharmacology""))",NA,oa_therapy_area,Pharma,Pharmacology,2016,2306,385,325,316,216,14,1256,1050
pharmacology (primary search + pharmacology tags) - pharma,"(author.affiliation.name:(""pfizer"" OR ""astrazeneca"" OR ""eli lilly"" OR ""merck"" OR ""emd serono"" OR ""msd"" OR ""merck sharp & dohme"" OR ""bristol myers squibb"" OR ""novartis"" OR ""roche"" OR ""hoffmann-la roche"" OR ""genentech"" OR ""johnson & johnson"" OR ""janssen"" OR ""biosense webster"" OR ""glaxosmithkline"" OR ""gsk"" OR ""abbvie"" OR ""sanofi"" OR ""sanofi-aventis"" OR ""gilead sciences"" OR ""takeda"" OR ""boehringer ingelheim"" OR ""myokardia"" OR ""amgen"" OR ""applied molecular genetics"" OR ""bayer"" OR ""vertex pharmaceuticals"" OR ""regeneron"" OR ""novo nordisk"" OR ""biogen"" OR ""biogen idec"" OR ""daiichi sankyo"" OR ""astellas pharma"" OR ""asuterasu seiyaku kabushiki-gaisha"" OR ""otsuka"" OR ""otsuka seiyaku kabushiki-gaisha"" OR ""astex pharmaceuticals"" OR ""ucb"" OR ""union chimique belge"" OR ""moderna"" OR ""eisai"" OR ""ezai kabushiki-gaisha"" OR ""ea pharma"" OR ""csl"" OR ""zlb behring"" OR ""jiangsu hengrui medicine"" OR ""teva pharmaceuticals"" OR ""sumitomo dainippon pharma"" OR ""dainippon sumitomo seiyaku kabushiki-gaisha"" OR ""fresenius"" OR ""fresenius se & co. kgaa"" OR ""viatris"" OR ""kyowa kirin"" OR ""kyowa hakko kirin"" OR ""ipsen"" OR ""jazz pharmaceuticals"" OR ""azur pharma"" OR ""sino biopharm"" OR ""bausch health companies"" OR ""valeant pharmaceuticals"" OR ""cspc pharmaceutical group"" OR ""galapagos"" OR ""galapagos genomics"" NOT ""La Roche College"") OR author.affiliation.ror_id_lineage:(""01xdqrp08"" OR ""00by1q217"" OR ""04b2dty93"" OR ""02891sr49"" OR ""03qd7mz70"" OR ""00gtmwv55"" OR ""02f9zrr09"" OR ""04r9x1a08"" OR ""01qat3289"" OR ""01xsqw823"" OR ""02g5p4n58"" OR ""02n6c9837"" OR ""056546b03"" OR ""04hjbmv12"" OR ""00q32j219"" OR ""03g03ge92"" OR ""04hmn8g73"" OR ""00anb1726"" OR ""02f51rf24"" OR ""0435rc536"" OR ""02jqkb192"" OR ""027y26122"" OR ""01cjash87"" OR ""013k5y296"" OR ""01n029866"" OR ""01xm4wg91"" OR ""04vvh7p27"" OR ""044tc0x05"" OR ""04ayvvz32"" OR ""01wfv3m53"" OR ""04sapgw72"" OR ""01v376g59"" OR ""01g1gvr46"" OR ""000wej815"" OR ""00d801g55"" OR ""055mhsv54"" OR ""0086q4c12"" OR ""01zgpn844"" OR ""016mq8947"" OR ""04e4j5d46"")) AND publication_type:""journal article"" AND date_published>=now-10y AND field_of_study: ((""Medicine"" OR ""Internal medicine"" OR ""Pharmacology"") AND (""Pharmacology"" OR ""Pharmacokinetics"" OR ""Chemistry"" OR ""Biochemistry"" OR ""Pharmacodynamics"" OR ""In vitro"" OR ""Pharmacotherapy"" OR ""Clinical pharmacology""))",AND date_published>=now-10y,"AND field_of_study: ((""Medicine"" OR ""Internal medicine"" OR ""Pharmacology"") AND (""Pharmacology"" OR ""Pharmacokinetics"" OR ""Chemistry"" OR ""Biochemistry"" OR ""Pharmacodynamics"" OR ""In vitro"" OR ""Pharmacotherapy"" OR ""Clinical pharmacology""))",NA,oa_therapy_area,Pharma,Pharmacology,2017,2145,402,264,312,220,18,1216,929
pharmacology (primary search + pharmacology tags) - pharma,"(author.affiliation.name:(""pfizer"" OR ""astrazeneca"" OR ""eli lilly"" OR ""merck"" OR ""emd serono"" OR ""msd"" OR ""merck sharp & dohme"" OR ""bristol myers squibb"" OR ""novartis"" OR ""roche"" OR ""hoffmann-la roche"" OR ""genentech"" OR ""johnson & johnson"" OR ""janssen"" OR ""biosense webster"" OR ""glaxosmithkline"" OR ""gsk"" OR ""abbvie"" OR ""sanofi"" OR ""sanofi-aventis"" OR ""gilead sciences"" OR ""takeda"" OR ""boehringer ingelheim"" OR ""myokardia"" OR ""amgen"" OR ""applied molecular genetics"" OR ""bayer"" OR ""vertex pharmaceuticals"" OR ""regeneron"" OR ""novo nordisk"" OR ""biogen"" OR ""biogen idec"" OR ""daiichi sankyo"" OR ""astellas pharma"" OR ""asuterasu seiyaku kabushiki-gaisha"" OR ""otsuka"" OR ""otsuka seiyaku kabushiki-gaisha"" OR ""astex pharmaceuticals"" OR ""ucb"" OR ""union chimique belge"" OR ""moderna"" OR ""eisai"" OR ""ezai kabushiki-gaisha"" OR ""ea pharma"" OR ""csl"" OR ""zlb behring"" OR ""jiangsu hengrui medicine"" OR ""teva pharmaceuticals"" OR ""sumitomo dainippon pharma"" OR ""dainippon sumitomo seiyaku kabushiki-gaisha"" OR ""fresenius"" OR ""fresenius se & co. kgaa"" OR ""viatris"" OR ""kyowa kirin"" OR ""kyowa hakko kirin"" OR ""ipsen"" OR ""jazz pharmaceuticals"" OR ""azur pharma"" OR ""sino biopharm"" OR ""bausch health companies"" OR ""valeant pharmaceuticals"" OR ""cspc pharmaceutical group"" OR ""galapagos"" OR ""galapagos genomics"" NOT ""La Roche College"") OR author.affiliation.ror_id_lineage:(""01xdqrp08"" OR ""00by1q217"" OR ""04b2dty93"" OR ""02891sr49"" OR ""03qd7mz70"" OR ""00gtmwv55"" OR ""02f9zrr09"" OR ""04r9x1a08"" OR ""01qat3289"" OR ""01xsqw823"" OR ""02g5p4n58"" OR ""02n6c9837"" OR ""056546b03"" OR ""04hjbmv12"" OR ""00q32j219"" OR ""03g03ge92"" OR ""04hmn8g73"" OR ""00anb1726"" OR ""02f51rf24"" OR ""0435rc536"" OR ""02jqkb192"" OR ""027y26122"" OR ""01cjash87"" OR ""013k5y296"" OR ""01n029866"" OR ""01xm4wg91"" OR ""04vvh7p27"" OR ""044tc0x05"" OR ""04ayvvz32"" OR ""01wfv3m53"" OR ""04sapgw72"" OR ""01v376g59"" OR ""01g1gvr46"" OR ""000wej815"" OR ""00d801g55"" OR ""055mhsv54"" OR ""0086q4c12"" OR ""01zgpn844"" OR ""016mq8947"" OR ""04e4j5d46"")) AND publication_type:""journal article"" AND date_published>=now-10y AND field_of_study: ((""Medicine"" OR ""Internal medicine"" OR ""Pharmacology"") AND (""Pharmacology"" OR ""Pharmacokinetics"" OR ""Chemistry"" OR ""Biochemistry"" OR ""Pharmacodynamics"" OR ""In vitro"" OR ""Pharmacotherapy"" OR ""Clinical pharmacology""))",AND date_published>=now-10y,"AND field_of_study: ((""Medicine"" OR ""Internal medicine"" OR ""Pharmacology"") AND (""Pharmacology"" OR ""Pharmacokinetics"" OR ""Chemistry"" OR ""Biochemistry"" OR ""Pharmacodynamics"" OR ""In vitro"" OR ""Pharmacotherapy"" OR ""Clinical pharmacology""))",NA,oa_therapy_area,Pharma,Pharmacology,2018,1612,323,230,306,178,10,1047,565
pharmacology (primary search + pharmacology tags) - pharma,"(author.affiliation.name:(""pfizer"" OR ""astrazeneca"" OR ""eli lilly"" OR ""merck"" OR ""emd serono"" OR ""msd"" OR ""merck sharp & dohme"" OR ""bristol myers squibb"" OR ""novartis"" OR ""roche"" OR ""hoffmann-la roche"" OR ""genentech"" OR ""johnson & johnson"" OR ""janssen"" OR ""biosense webster"" OR ""glaxosmithkline"" OR ""gsk"" OR ""abbvie"" OR ""sanofi"" OR ""sanofi-aventis"" OR ""gilead sciences"" OR ""takeda"" OR ""boehringer ingelheim"" OR ""myokardia"" OR ""amgen"" OR ""applied molecular genetics"" OR ""bayer"" OR ""vertex pharmaceuticals"" OR ""regeneron"" OR ""novo nordisk"" OR ""biogen"" OR ""biogen idec"" OR ""daiichi sankyo"" OR ""astellas pharma"" OR ""asuterasu seiyaku kabushiki-gaisha"" OR ""otsuka"" OR ""otsuka seiyaku kabushiki-gaisha"" OR ""astex pharmaceuticals"" OR ""ucb"" OR ""union chimique belge"" OR ""moderna"" OR ""eisai"" OR ""ezai kabushiki-gaisha"" OR ""ea pharma"" OR ""csl"" OR ""zlb behring"" OR ""jiangsu hengrui medicine"" OR ""teva pharmaceuticals"" OR ""sumitomo dainippon pharma"" OR ""dainippon sumitomo seiyaku kabushiki-gaisha"" OR ""fresenius"" OR ""fresenius se & co. kgaa"" OR ""viatris"" OR ""kyowa kirin"" OR ""kyowa hakko kirin"" OR ""ipsen"" OR ""jazz pharmaceuticals"" OR ""azur pharma"" OR ""sino biopharm"" OR ""bausch health companies"" OR ""valeant pharmaceuticals"" OR ""cspc pharmaceutical group"" OR ""galapagos"" OR ""galapagos genomics"" NOT ""La Roche College"") OR author.affiliation.ror_id_lineage:(""01xdqrp08"" OR ""00by1q217"" OR ""04b2dty93"" OR ""02891sr49"" OR ""03qd7mz70"" OR ""00gtmwv55"" OR ""02f9zrr09"" OR ""04r9x1a08"" OR ""01qat3289"" OR ""01xsqw823"" OR ""02g5p4n58"" OR ""02n6c9837"" OR ""056546b03"" OR ""04hjbmv12"" OR ""00q32j219"" OR ""03g03ge92"" OR ""04hmn8g73"" OR ""00anb1726"" OR ""02f51rf24"" OR ""0435rc536"" OR ""02jqkb192"" OR ""027y26122"" OR ""01cjash87"" OR ""013k5y296"" OR ""01n029866"" OR ""01xm4wg91"" OR ""04vvh7p27"" OR ""044tc0x05"" OR ""04ayvvz32"" OR ""01wfv3m53"" OR ""04sapgw72"" OR ""01v376g59"" OR ""01g1gvr46"" OR ""000wej815"" OR ""00d801g55"" OR ""055mhsv54"" OR ""0086q4c12"" OR ""01zgpn844"" OR ""016mq8947"" OR ""04e4j5d46"")) AND publication_type:""journal article"" AND date_published>=now-10y AND field_of_study: ((""Medicine"" OR ""Internal medicine"" OR ""Pharmacology"") AND (""Pharmacology"" OR ""Pharmacokinetics"" OR ""Chemistry"" OR ""Biochemistry"" OR ""Pharmacodynamics"" OR ""In vitro"" OR ""Pharmacotherapy"" OR ""Clinical pharmacology""))",AND date_published>=now-10y,"AND field_of_study: ((""Medicine"" OR ""Internal medicine"" OR ""Pharmacology"") AND (""Pharmacology"" OR ""Pharmacokinetics"" OR ""Chemistry"" OR ""Biochemistry"" OR ""Pharmacodynamics"" OR ""In vitro"" OR ""Pharmacotherapy"" OR ""Clinical pharmacology""))",NA,oa_therapy_area,Pharma,Pharmacology,2019,1512,352,169,339,131,5,996,516
pharmacology (primary search + pharmacology tags) - pharma,"(author.affiliation.name:(""pfizer"" OR ""astrazeneca"" OR ""eli lilly"" OR ""merck"" OR ""emd serono"" OR ""msd"" OR ""merck sharp & dohme"" OR ""bristol myers squibb"" OR ""novartis"" OR ""roche"" OR ""hoffmann-la roche"" OR ""genentech"" OR ""johnson & johnson"" OR ""janssen"" OR ""biosense webster"" OR ""glaxosmithkline"" OR ""gsk"" OR ""abbvie"" OR ""sanofi"" OR ""sanofi-aventis"" OR ""gilead sciences"" OR ""takeda"" OR ""boehringer ingelheim"" OR ""myokardia"" OR ""amgen"" OR ""applied molecular genetics"" OR ""bayer"" OR ""vertex pharmaceuticals"" OR ""regeneron"" OR ""novo nordisk"" OR ""biogen"" OR ""biogen idec"" OR ""daiichi sankyo"" OR ""astellas pharma"" OR ""asuterasu seiyaku kabushiki-gaisha"" OR ""otsuka"" OR ""otsuka seiyaku kabushiki-gaisha"" OR ""astex pharmaceuticals"" OR ""ucb"" OR ""union chimique belge"" OR ""moderna"" OR ""eisai"" OR ""ezai kabushiki-gaisha"" OR ""ea pharma"" OR ""csl"" OR ""zlb behring"" OR ""jiangsu hengrui medicine"" OR ""teva pharmaceuticals"" OR ""sumitomo dainippon pharma"" OR ""dainippon sumitomo seiyaku kabushiki-gaisha"" OR ""fresenius"" OR ""fresenius se & co. kgaa"" OR ""viatris"" OR ""kyowa kirin"" OR ""kyowa hakko kirin"" OR ""ipsen"" OR ""jazz pharmaceuticals"" OR ""azur pharma"" OR ""sino biopharm"" OR ""bausch health companies"" OR ""valeant pharmaceuticals"" OR ""cspc pharmaceutical group"" OR ""galapagos"" OR ""galapagos genomics"" NOT ""La Roche College"") OR author.affiliation.ror_id_lineage:(""01xdqrp08"" OR ""00by1q217"" OR ""04b2dty93"" OR ""02891sr49"" OR ""03qd7mz70"" OR ""00gtmwv55"" OR ""02f9zrr09"" OR ""04r9x1a08"" OR ""01qat3289"" OR ""01xsqw823"" OR ""02g5p4n58"" OR ""02n6c9837"" OR ""056546b03"" OR ""04hjbmv12"" OR ""00q32j219"" OR ""03g03ge92"" OR ""04hmn8g73"" OR ""00anb1726"" OR ""02f51rf24"" OR ""0435rc536"" OR ""02jqkb192"" OR ""027y26122"" OR ""01cjash87"" OR ""013k5y296"" OR ""01n029866"" OR ""01xm4wg91"" OR ""04vvh7p27"" OR ""044tc0x05"" OR ""04ayvvz32"" OR ""01wfv3m53"" OR ""04sapgw72"" OR ""01v376g59"" OR ""01g1gvr46"" OR ""000wej815"" OR ""00d801g55"" OR ""055mhsv54"" OR ""0086q4c12"" OR ""01zgpn844"" OR ""016mq8947"" OR ""04e4j5d46"")) AND publication_type:""journal article"" AND date_published>=now-10y AND field_of_study: ((""Medicine"" OR ""Internal medicine"" OR ""Pharmacology"") AND (""Pharmacology"" OR ""Pharmacokinetics"" OR ""Chemistry"" OR ""Biochemistry"" OR ""Pharmacodynamics"" OR ""In vitro"" OR ""Pharmacotherapy"" OR ""Clinical pharmacology""))",AND date_published>=now-10y,"AND field_of_study: ((""Medicine"" OR ""Internal medicine"" OR ""Pharmacology"") AND (""Pharmacology"" OR ""Pharmacokinetics"" OR ""Chemistry"" OR ""Biochemistry"" OR ""Pharmacodynamics"" OR ""In vitro"" OR ""Pharmacotherapy"" OR ""Clinical pharmacology""))",NA,oa_therapy_area,Pharma,Pharmacology,2020,1596,401,152,399,145,17,1114,482
pharmacology (primary search + pharmacology tags) - pharma,"(author.affiliation.name:(""pfizer"" OR ""astrazeneca"" OR ""eli lilly"" OR ""merck"" OR ""emd serono"" OR ""msd"" OR ""merck sharp & dohme"" OR ""bristol myers squibb"" OR ""novartis"" OR ""roche"" OR ""hoffmann-la roche"" OR ""genentech"" OR ""johnson & johnson"" OR ""janssen"" OR ""biosense webster"" OR ""glaxosmithkline"" OR ""gsk"" OR ""abbvie"" OR ""sanofi"" OR ""sanofi-aventis"" OR ""gilead sciences"" OR ""takeda"" OR ""boehringer ingelheim"" OR ""myokardia"" OR ""amgen"" OR ""applied molecular genetics"" OR ""bayer"" OR ""vertex pharmaceuticals"" OR ""regeneron"" OR ""novo nordisk"" OR ""biogen"" OR ""biogen idec"" OR ""daiichi sankyo"" OR ""astellas pharma"" OR ""asuterasu seiyaku kabushiki-gaisha"" OR ""otsuka"" OR ""otsuka seiyaku kabushiki-gaisha"" OR ""astex pharmaceuticals"" OR ""ucb"" OR ""union chimique belge"" OR ""moderna"" OR ""eisai"" OR ""ezai kabushiki-gaisha"" OR ""ea pharma"" OR ""csl"" OR ""zlb behring"" OR ""jiangsu hengrui medicine"" OR ""teva pharmaceuticals"" OR ""sumitomo dainippon pharma"" OR ""dainippon sumitomo seiyaku kabushiki-gaisha"" OR ""fresenius"" OR ""fresenius se & co. kgaa"" OR ""viatris"" OR ""kyowa kirin"" OR ""kyowa hakko kirin"" OR ""ipsen"" OR ""jazz pharmaceuticals"" OR ""azur pharma"" OR ""sino biopharm"" OR ""bausch health companies"" OR ""valeant pharmaceuticals"" OR ""cspc pharmaceutical group"" OR ""galapagos"" OR ""galapagos genomics"" NOT ""La Roche College"") OR author.affiliation.ror_id_lineage:(""01xdqrp08"" OR ""00by1q217"" OR ""04b2dty93"" OR ""02891sr49"" OR ""03qd7mz70"" OR ""00gtmwv55"" OR ""02f9zrr09"" OR ""04r9x1a08"" OR ""01qat3289"" OR ""01xsqw823"" OR ""02g5p4n58"" OR ""02n6c9837"" OR ""056546b03"" OR ""04hjbmv12"" OR ""00q32j219"" OR ""03g03ge92"" OR ""04hmn8g73"" OR ""00anb1726"" OR ""02f51rf24"" OR ""0435rc536"" OR ""02jqkb192"" OR ""027y26122"" OR ""01cjash87"" OR ""013k5y296"" OR ""01n029866"" OR ""01xm4wg91"" OR ""04vvh7p27"" OR ""044tc0x05"" OR ""04ayvvz32"" OR ""01wfv3m53"" OR ""04sapgw72"" OR ""01v376g59"" OR ""01g1gvr46"" OR ""000wej815"" OR ""00d801g55"" OR ""055mhsv54"" OR ""0086q4c12"" OR ""01zgpn844"" OR ""016mq8947"" OR ""04e4j5d46"")) AND publication_type:""journal article"" AND date_published>=now-10y AND field_of_study: ((""Medicine"" OR ""Internal medicine"" OR ""Pharmacology"") AND (""Pharmacology"" OR ""Pharmacokinetics"" OR ""Chemistry"" OR ""Biochemistry"" OR ""Pharmacodynamics"" OR ""In vitro"" OR ""Pharmacotherapy"" OR ""Clinical pharmacology""))",AND date_published>=now-10y,"AND field_of_study: ((""Medicine"" OR ""Internal medicine"" OR ""Pharmacology"") AND (""Pharmacology"" OR ""Pharmacokinetics"" OR ""Chemistry"" OR ""Biochemistry"" OR ""Pharmacodynamics"" OR ""In vitro"" OR ""Pharmacotherapy"" OR ""Clinical pharmacology""))",NA,oa_therapy_area,Pharma,Pharmacology,2021,1811,557,93,504,135,58,1347,464
pharmacology (primary search + pharmacology tags) - pharma,"(author.affiliation.name:(""pfizer"" OR ""astrazeneca"" OR ""eli lilly"" OR ""merck"" OR ""emd serono"" OR ""msd"" OR ""merck sharp & dohme"" OR ""bristol myers squibb"" OR ""novartis"" OR ""roche"" OR ""hoffmann-la roche"" OR ""genentech"" OR ""johnson & johnson"" OR ""janssen"" OR ""biosense webster"" OR ""glaxosmithkline"" OR ""gsk"" OR ""abbvie"" OR ""sanofi"" OR ""sanofi-aventis"" OR ""gilead sciences"" OR ""takeda"" OR ""boehringer ingelheim"" OR ""myokardia"" OR ""amgen"" OR ""applied molecular genetics"" OR ""bayer"" OR ""vertex pharmaceuticals"" OR ""regeneron"" OR ""novo nordisk"" OR ""biogen"" OR ""biogen idec"" OR ""daiichi sankyo"" OR ""astellas pharma"" OR ""asuterasu seiyaku kabushiki-gaisha"" OR ""otsuka"" OR ""otsuka seiyaku kabushiki-gaisha"" OR ""astex pharmaceuticals"" OR ""ucb"" OR ""union chimique belge"" OR ""moderna"" OR ""eisai"" OR ""ezai kabushiki-gaisha"" OR ""ea pharma"" OR ""csl"" OR ""zlb behring"" OR ""jiangsu hengrui medicine"" OR ""teva pharmaceuticals"" OR ""sumitomo dainippon pharma"" OR ""dainippon sumitomo seiyaku kabushiki-gaisha"" OR ""fresenius"" OR ""fresenius se & co. kgaa"" OR ""viatris"" OR ""kyowa kirin"" OR ""kyowa hakko kirin"" OR ""ipsen"" OR ""jazz pharmaceuticals"" OR ""azur pharma"" OR ""sino biopharm"" OR ""bausch health companies"" OR ""valeant pharmaceuticals"" OR ""cspc pharmaceutical group"" OR ""galapagos"" OR ""galapagos genomics"" NOT ""La Roche College"") OR author.affiliation.ror_id_lineage:(""01xdqrp08"" OR ""00by1q217"" OR ""04b2dty93"" OR ""02891sr49"" OR ""03qd7mz70"" OR ""00gtmwv55"" OR ""02f9zrr09"" OR ""04r9x1a08"" OR ""01qat3289"" OR ""01xsqw823"" OR ""02g5p4n58"" OR ""02n6c9837"" OR ""056546b03"" OR ""04hjbmv12"" OR ""00q32j219"" OR ""03g03ge92"" OR ""04hmn8g73"" OR ""00anb1726"" OR ""02f51rf24"" OR ""0435rc536"" OR ""02jqkb192"" OR ""027y26122"" OR ""01cjash87"" OR ""013k5y296"" OR ""01n029866"" OR ""01xm4wg91"" OR ""04vvh7p27"" OR ""044tc0x05"" OR ""04ayvvz32"" OR ""01wfv3m53"" OR ""04sapgw72"" OR ""01v376g59"" OR ""01g1gvr46"" OR ""000wej815"" OR ""00d801g55"" OR ""055mhsv54"" OR ""0086q4c12"" OR ""01zgpn844"" OR ""016mq8947"" OR ""04e4j5d46"")) AND publication_type:""journal article"" AND date_published>=now-10y AND field_of_study: ((""Medicine"" OR ""Internal medicine"" OR ""Pharmacology"") AND (""Pharmacology"" OR ""Pharmacokinetics"" OR ""Chemistry"" OR ""Biochemistry"" OR ""Pharmacodynamics"" OR ""In vitro"" OR ""Pharmacotherapy"" OR ""Clinical pharmacology""))",AND date_published>=now-10y,"AND field_of_study: ((""Medicine"" OR ""Internal medicine"" OR ""Pharmacology"") AND (""Pharmacology"" OR ""Pharmacokinetics"" OR ""Chemistry"" OR ""Biochemistry"" OR ""Pharmacodynamics"" OR ""In vitro"" OR ""Pharmacotherapy"" OR ""Clinical pharmacology""))",NA,oa_therapy_area,Pharma,Pharmacology,2022,3656,1326,224,732,149,102,2533,1123
pharmacology (primary search + pharmacology tags) - pharma,"(author.affiliation.name:(""pfizer"" OR ""astrazeneca"" OR ""eli lilly"" OR ""merck"" OR ""emd serono"" OR ""msd"" OR ""merck sharp & dohme"" OR ""bristol myers squibb"" OR ""novartis"" OR ""roche"" OR ""hoffmann-la roche"" OR ""genentech"" OR ""johnson & johnson"" OR ""janssen"" OR ""biosense webster"" OR ""glaxosmithkline"" OR ""gsk"" OR ""abbvie"" OR ""sanofi"" OR ""sanofi-aventis"" OR ""gilead sciences"" OR ""takeda"" OR ""boehringer ingelheim"" OR ""myokardia"" OR ""amgen"" OR ""applied molecular genetics"" OR ""bayer"" OR ""vertex pharmaceuticals"" OR ""regeneron"" OR ""novo nordisk"" OR ""biogen"" OR ""biogen idec"" OR ""daiichi sankyo"" OR ""astellas pharma"" OR ""asuterasu seiyaku kabushiki-gaisha"" OR ""otsuka"" OR ""otsuka seiyaku kabushiki-gaisha"" OR ""astex pharmaceuticals"" OR ""ucb"" OR ""union chimique belge"" OR ""moderna"" OR ""eisai"" OR ""ezai kabushiki-gaisha"" OR ""ea pharma"" OR ""csl"" OR ""zlb behring"" OR ""jiangsu hengrui medicine"" OR ""teva pharmaceuticals"" OR ""sumitomo dainippon pharma"" OR ""dainippon sumitomo seiyaku kabushiki-gaisha"" OR ""fresenius"" OR ""fresenius se & co. kgaa"" OR ""viatris"" OR ""kyowa kirin"" OR ""kyowa hakko kirin"" OR ""ipsen"" OR ""jazz pharmaceuticals"" OR ""azur pharma"" OR ""sino biopharm"" OR ""bausch health companies"" OR ""valeant pharmaceuticals"" OR ""cspc pharmaceutical group"" OR ""galapagos"" OR ""galapagos genomics"" NOT ""La Roche College"") OR author.affiliation.ror_id_lineage:(""01xdqrp08"" OR ""00by1q217"" OR ""04b2dty93"" OR ""02891sr49"" OR ""03qd7mz70"" OR ""00gtmwv55"" OR ""02f9zrr09"" OR ""04r9x1a08"" OR ""01qat3289"" OR ""01xsqw823"" OR ""02g5p4n58"" OR ""02n6c9837"" OR ""056546b03"" OR ""04hjbmv12"" OR ""00q32j219"" OR ""03g03ge92"" OR ""04hmn8g73"" OR ""00anb1726"" OR ""02f51rf24"" OR ""0435rc536"" OR ""02jqkb192"" OR ""027y26122"" OR ""01cjash87"" OR ""013k5y296"" OR ""01n029866"" OR ""01xm4wg91"" OR ""04vvh7p27"" OR ""044tc0x05"" OR ""04ayvvz32"" OR ""01wfv3m53"" OR ""04sapgw72"" OR ""01v376g59"" OR ""01g1gvr46"" OR ""000wej815"" OR ""00d801g55"" OR ""055mhsv54"" OR ""0086q4c12"" OR ""01zgpn844"" OR ""016mq8947"" OR ""04e4j5d46"")) AND publication_type:""journal article"" AND date_published>=now-10y AND field_of_study: ((""Medicine"" OR ""Internal medicine"" OR ""Pharmacology"") AND (""Pharmacology"" OR ""Pharmacokinetics"" OR ""Chemistry"" OR ""Biochemistry"" OR ""Pharmacodynamics"" OR ""In vitro"" OR ""Pharmacotherapy"" OR ""Clinical pharmacology""))",AND date_published>=now-10y,"AND field_of_study: ((""Medicine"" OR ""Internal medicine"" OR ""Pharmacology"") AND (""Pharmacology"" OR ""Pharmacokinetics"" OR ""Chemistry"" OR ""Biochemistry"" OR ""Pharmacodynamics"" OR ""In vitro"" OR ""Pharmacotherapy"" OR ""Clinical pharmacology""))",NA,oa_therapy_area,Pharma,Pharmacology,2023,1476,504,27,296,53,134,1014,462
immunology (primary search + immunology tags) - pharma,"(author.affiliation.name:(""pfizer"" OR ""astrazeneca"" OR ""eli lilly"" OR ""merck"" OR ""emd serono"" OR ""msd"" OR ""merck sharp & dohme"" OR ""bristol myers squibb"" OR ""novartis"" OR ""roche"" OR ""hoffmann-la roche"" OR ""genentech"" OR ""johnson & johnson"" OR ""janssen"" OR ""biosense webster"" OR ""glaxosmithkline"" OR ""gsk"" OR ""abbvie"" OR ""sanofi"" OR ""sanofi-aventis"" OR ""gilead sciences"" OR ""takeda"" OR ""boehringer ingelheim"" OR ""myokardia"" OR ""amgen"" OR ""applied molecular genetics"" OR ""bayer"" OR ""vertex pharmaceuticals"" OR ""regeneron"" OR ""novo nordisk"" OR ""biogen"" OR ""biogen idec"" OR ""daiichi sankyo"" OR ""astellas pharma"" OR ""asuterasu seiyaku kabushiki-gaisha"" OR ""otsuka"" OR ""otsuka seiyaku kabushiki-gaisha"" OR ""astex pharmaceuticals"" OR ""ucb"" OR ""union chimique belge"" OR ""moderna"" OR ""eisai"" OR ""ezai kabushiki-gaisha"" OR ""ea pharma"" OR ""csl"" OR ""zlb behring"" OR ""jiangsu hengrui medicine"" OR ""teva pharmaceuticals"" OR ""sumitomo dainippon pharma"" OR ""dainippon sumitomo seiyaku kabushiki-gaisha"" OR ""fresenius"" OR ""fresenius se & co. kgaa"" OR ""viatris"" OR ""kyowa kirin"" OR ""kyowa hakko kirin"" OR ""ipsen"" OR ""jazz pharmaceuticals"" OR ""azur pharma"" OR ""sino biopharm"" OR ""bausch health companies"" OR ""valeant pharmaceuticals"" OR ""cspc pharmaceutical group"" OR ""galapagos"" OR ""galapagos genomics"" NOT ""La Roche College"") OR author.affiliation.ror_id_lineage:(""01xdqrp08"" OR ""00by1q217"" OR ""04b2dty93"" OR ""02891sr49"" OR ""03qd7mz70"" OR ""00gtmwv55"" OR ""02f9zrr09"" OR ""04r9x1a08"" OR ""01qat3289"" OR ""01xsqw823"" OR ""02g5p4n58"" OR ""02n6c9837"" OR ""056546b03"" OR ""04hjbmv12"" OR ""00q32j219"" OR ""03g03ge92"" OR ""04hmn8g73"" OR ""00anb1726"" OR ""02f51rf24"" OR ""0435rc536"" OR ""02jqkb192"" OR ""027y26122"" OR ""01cjash87"" OR ""013k5y296"" OR ""01n029866"" OR ""01xm4wg91"" OR ""04vvh7p27"" OR ""044tc0x05"" OR ""04ayvvz32"" OR ""01wfv3m53"" OR ""04sapgw72"" OR ""01v376g59"" OR ""01g1gvr46"" OR ""000wej815"" OR ""00d801g55"" OR ""055mhsv54"" OR ""0086q4c12"" OR ""01zgpn844"" OR ""016mq8947"" OR ""04e4j5d46"")) AND publication_type:""journal article"" AND date_published>=now-10y AND field_of_study: ((""Medicine"" OR ""Internal medicine"" OR ""Pharmacology"") AND (""Immunology"" OR ""Rheumatoid arthritis"" OR ""Immune system"" OR ""Inflammation"" OR ""Psoriatic arthritis"" OR ""Psoriasis"" OR ""Rheumatology"" OR ""Arthritis"" OR ""T cell"" OR ""Ankylosing spondylitis"" OR ""Cytotoxic T cell"" OR ""Proinflammatory cytokine"" OR ""Autoimmune disease""))",AND date_published>=now-10y,"AND field_of_study: ((""Medicine"" OR ""Internal medicine"" OR ""Pharmacology"") AND (""Immunology"" OR ""Rheumatoid arthritis"" OR ""Immune system"" OR ""Inflammation"" OR ""Psoriatic arthritis"" OR ""Psoriasis"" OR ""Rheumatology"" OR ""Arthritis"" OR ""T cell"" OR ""Ankylosing spondylitis"" OR ""Cytotoxic T cell"" OR ""Proinflammatory cytokine"" OR ""Autoimmune disease""))",NA,oa_therapy_area,Pharma,Immunology,2013,477,129,42,51,25,4,251,226
immunology (primary search + immunology tags) - pharma,"(author.affiliation.name:(""pfizer"" OR ""astrazeneca"" OR ""eli lilly"" OR ""merck"" OR ""emd serono"" OR ""msd"" OR ""merck sharp & dohme"" OR ""bristol myers squibb"" OR ""novartis"" OR ""roche"" OR ""hoffmann-la roche"" OR ""genentech"" OR ""johnson & johnson"" OR ""janssen"" OR ""biosense webster"" OR ""glaxosmithkline"" OR ""gsk"" OR ""abbvie"" OR ""sanofi"" OR ""sanofi-aventis"" OR ""gilead sciences"" OR ""takeda"" OR ""boehringer ingelheim"" OR ""myokardia"" OR ""amgen"" OR ""applied molecular genetics"" OR ""bayer"" OR ""vertex pharmaceuticals"" OR ""regeneron"" OR ""novo nordisk"" OR ""biogen"" OR ""biogen idec"" OR ""daiichi sankyo"" OR ""astellas pharma"" OR ""asuterasu seiyaku kabushiki-gaisha"" OR ""otsuka"" OR ""otsuka seiyaku kabushiki-gaisha"" OR ""astex pharmaceuticals"" OR ""ucb"" OR ""union chimique belge"" OR ""moderna"" OR ""eisai"" OR ""ezai kabushiki-gaisha"" OR ""ea pharma"" OR ""csl"" OR ""zlb behring"" OR ""jiangsu hengrui medicine"" OR ""teva pharmaceuticals"" OR ""sumitomo dainippon pharma"" OR ""dainippon sumitomo seiyaku kabushiki-gaisha"" OR ""fresenius"" OR ""fresenius se & co. kgaa"" OR ""viatris"" OR ""kyowa kirin"" OR ""kyowa hakko kirin"" OR ""ipsen"" OR ""jazz pharmaceuticals"" OR ""azur pharma"" OR ""sino biopharm"" OR ""bausch health companies"" OR ""valeant pharmaceuticals"" OR ""cspc pharmaceutical group"" OR ""galapagos"" OR ""galapagos genomics"" NOT ""La Roche College"") OR author.affiliation.ror_id_lineage:(""01xdqrp08"" OR ""00by1q217"" OR ""04b2dty93"" OR ""02891sr49"" OR ""03qd7mz70"" OR ""00gtmwv55"" OR ""02f9zrr09"" OR ""04r9x1a08"" OR ""01qat3289"" OR ""01xsqw823"" OR ""02g5p4n58"" OR ""02n6c9837"" OR ""056546b03"" OR ""04hjbmv12"" OR ""00q32j219"" OR ""03g03ge92"" OR ""04hmn8g73"" OR ""00anb1726"" OR ""02f51rf24"" OR ""0435rc536"" OR ""02jqkb192"" OR ""027y26122"" OR ""01cjash87"" OR ""013k5y296"" OR ""01n029866"" OR ""01xm4wg91"" OR ""04vvh7p27"" OR ""044tc0x05"" OR ""04ayvvz32"" OR ""01wfv3m53"" OR ""04sapgw72"" OR ""01v376g59"" OR ""01g1gvr46"" OR ""000wej815"" OR ""00d801g55"" OR ""055mhsv54"" OR ""0086q4c12"" OR ""01zgpn844"" OR ""016mq8947"" OR ""04e4j5d46"")) AND publication_type:""journal article"" AND date_published>=now-10y AND field_of_study: ((""Medicine"" OR ""Internal medicine"" OR ""Pharmacology"") AND (""Immunology"" OR ""Rheumatoid arthritis"" OR ""Immune system"" OR ""Inflammation"" OR ""Psoriatic arthritis"" OR ""Psoriasis"" OR ""Rheumatology"" OR ""Arthritis"" OR ""T cell"" OR ""Ankylosing spondylitis"" OR ""Cytotoxic T cell"" OR ""Proinflammatory cytokine"" OR ""Autoimmune disease""))",AND date_published>=now-10y,"AND field_of_study: ((""Medicine"" OR ""Internal medicine"" OR ""Pharmacology"") AND (""Immunology"" OR ""Rheumatoid arthritis"" OR ""Immune system"" OR ""Inflammation"" OR ""Psoriatic arthritis"" OR ""Psoriasis"" OR ""Rheumatology"" OR ""Arthritis"" OR ""T cell"" OR ""Ankylosing spondylitis"" OR ""Cytotoxic T cell"" OR ""Proinflammatory cytokine"" OR ""Autoimmune disease""))",NA,oa_therapy_area,Pharma,Immunology,2014,1488,325,143,148,115,51,782,706
immunology (primary search + immunology tags) - pharma,"(author.affiliation.name:(""pfizer"" OR ""astrazeneca"" OR ""eli lilly"" OR ""merck"" OR ""emd serono"" OR ""msd"" OR ""merck sharp & dohme"" OR ""bristol myers squibb"" OR ""novartis"" OR ""roche"" OR ""hoffmann-la roche"" OR ""genentech"" OR ""johnson & johnson"" OR ""janssen"" OR ""biosense webster"" OR ""glaxosmithkline"" OR ""gsk"" OR ""abbvie"" OR ""sanofi"" OR ""sanofi-aventis"" OR ""gilead sciences"" OR ""takeda"" OR ""boehringer ingelheim"" OR ""myokardia"" OR ""amgen"" OR ""applied molecular genetics"" OR ""bayer"" OR ""vertex pharmaceuticals"" OR ""regeneron"" OR ""novo nordisk"" OR ""biogen"" OR ""biogen idec"" OR ""daiichi sankyo"" OR ""astellas pharma"" OR ""asuterasu seiyaku kabushiki-gaisha"" OR ""otsuka"" OR ""otsuka seiyaku kabushiki-gaisha"" OR ""astex pharmaceuticals"" OR ""ucb"" OR ""union chimique belge"" OR ""moderna"" OR ""eisai"" OR ""ezai kabushiki-gaisha"" OR ""ea pharma"" OR ""csl"" OR ""zlb behring"" OR ""jiangsu hengrui medicine"" OR ""teva pharmaceuticals"" OR ""sumitomo dainippon pharma"" OR ""dainippon sumitomo seiyaku kabushiki-gaisha"" OR ""fresenius"" OR ""fresenius se & co. kgaa"" OR ""viatris"" OR ""kyowa kirin"" OR ""kyowa hakko kirin"" OR ""ipsen"" OR ""jazz pharmaceuticals"" OR ""azur pharma"" OR ""sino biopharm"" OR ""bausch health companies"" OR ""valeant pharmaceuticals"" OR ""cspc pharmaceutical group"" OR ""galapagos"" OR ""galapagos genomics"" NOT ""La Roche College"") OR author.affiliation.ror_id_lineage:(""01xdqrp08"" OR ""00by1q217"" OR ""04b2dty93"" OR ""02891sr49"" OR ""03qd7mz70"" OR ""00gtmwv55"" OR ""02f9zrr09"" OR ""04r9x1a08"" OR ""01qat3289"" OR ""01xsqw823"" OR ""02g5p4n58"" OR ""02n6c9837"" OR ""056546b03"" OR ""04hjbmv12"" OR ""00q32j219"" OR ""03g03ge92"" OR ""04hmn8g73"" OR ""00anb1726"" OR ""02f51rf24"" OR ""0435rc536"" OR ""02jqkb192"" OR ""027y26122"" OR ""01cjash87"" OR ""013k5y296"" OR ""01n029866"" OR ""01xm4wg91"" OR ""04vvh7p27"" OR ""044tc0x05"" OR ""04ayvvz32"" OR ""01wfv3m53"" OR ""04sapgw72"" OR ""01v376g59"" OR ""01g1gvr46"" OR ""000wej815"" OR ""00d801g55"" OR ""055mhsv54"" OR ""0086q4c12"" OR ""01zgpn844"" OR ""016mq8947"" OR ""04e4j5d46"")) AND publication_type:""journal article"" AND date_published>=now-10y AND field_of_study: ((""Medicine"" OR ""Internal medicine"" OR ""Pharmacology"") AND (""Immunology"" OR ""Rheumatoid arthritis"" OR ""Immune system"" OR ""Inflammation"" OR ""Psoriatic arthritis"" OR ""Psoriasis"" OR ""Rheumatology"" OR ""Arthritis"" OR ""T cell"" OR ""Ankylosing spondylitis"" OR ""Cytotoxic T cell"" OR ""Proinflammatory cytokine"" OR ""Autoimmune disease""))",AND date_published>=now-10y,"AND field_of_study: ((""Medicine"" OR ""Internal medicine"" OR ""Pharmacology"") AND (""Immunology"" OR ""Rheumatoid arthritis"" OR ""Immune system"" OR ""Inflammation"" OR ""Psoriatic arthritis"" OR ""Psoriasis"" OR ""Rheumatology"" OR ""Arthritis"" OR ""T cell"" OR ""Ankylosing spondylitis"" OR ""Cytotoxic T cell"" OR ""Proinflammatory cytokine"" OR ""Autoimmune disease""))",NA,oa_therapy_area,Pharma,Immunology,2015,1636,320,153,185,128,17,803,833
immunology (primary search + immunology tags) - pharma,"(author.affiliation.name:(""pfizer"" OR ""astrazeneca"" OR ""eli lilly"" OR ""merck"" OR ""emd serono"" OR ""msd"" OR ""merck sharp & dohme"" OR ""bristol myers squibb"" OR ""novartis"" OR ""roche"" OR ""hoffmann-la roche"" OR ""genentech"" OR ""johnson & johnson"" OR ""janssen"" OR ""biosense webster"" OR ""glaxosmithkline"" OR ""gsk"" OR ""abbvie"" OR ""sanofi"" OR ""sanofi-aventis"" OR ""gilead sciences"" OR ""takeda"" OR ""boehringer ingelheim"" OR ""myokardia"" OR ""amgen"" OR ""applied molecular genetics"" OR ""bayer"" OR ""vertex pharmaceuticals"" OR ""regeneron"" OR ""novo nordisk"" OR ""biogen"" OR ""biogen idec"" OR ""daiichi sankyo"" OR ""astellas pharma"" OR ""asuterasu seiyaku kabushiki-gaisha"" OR ""otsuka"" OR ""otsuka seiyaku kabushiki-gaisha"" OR ""astex pharmaceuticals"" OR ""ucb"" OR ""union chimique belge"" OR ""moderna"" OR ""eisai"" OR ""ezai kabushiki-gaisha"" OR ""ea pharma"" OR ""csl"" OR ""zlb behring"" OR ""jiangsu hengrui medicine"" OR ""teva pharmaceuticals"" OR ""sumitomo dainippon pharma"" OR ""dainippon sumitomo seiyaku kabushiki-gaisha"" OR ""fresenius"" OR ""fresenius se & co. kgaa"" OR ""viatris"" OR ""kyowa kirin"" OR ""kyowa hakko kirin"" OR ""ipsen"" OR ""jazz pharmaceuticals"" OR ""azur pharma"" OR ""sino biopharm"" OR ""bausch health companies"" OR ""valeant pharmaceuticals"" OR ""cspc pharmaceutical group"" OR ""galapagos"" OR ""galapagos genomics"" NOT ""La Roche College"") OR author.affiliation.ror_id_lineage:(""01xdqrp08"" OR ""00by1q217"" OR ""04b2dty93"" OR ""02891sr49"" OR ""03qd7mz70"" OR ""00gtmwv55"" OR ""02f9zrr09"" OR ""04r9x1a08"" OR ""01qat3289"" OR ""01xsqw823"" OR ""02g5p4n58"" OR ""02n6c9837"" OR ""056546b03"" OR ""04hjbmv12"" OR ""00q32j219"" OR ""03g03ge92"" OR ""04hmn8g73"" OR ""00anb1726"" OR ""02f51rf24"" OR ""0435rc536"" OR ""02jqkb192"" OR ""027y26122"" OR ""01cjash87"" OR ""013k5y296"" OR ""01n029866"" OR ""01xm4wg91"" OR ""04vvh7p27"" OR ""044tc0x05"" OR ""04ayvvz32"" OR ""01wfv3m53"" OR ""04sapgw72"" OR ""01v376g59"" OR ""01g1gvr46"" OR ""000wej815"" OR ""00d801g55"" OR ""055mhsv54"" OR ""0086q4c12"" OR ""01zgpn844"" OR ""016mq8947"" OR ""04e4j5d46"")) AND publication_type:""journal article"" AND date_published>=now-10y AND field_of_study: ((""Medicine"" OR ""Internal medicine"" OR ""Pharmacology"") AND (""Immunology"" OR ""Rheumatoid arthritis"" OR ""Immune system"" OR ""Inflammation"" OR ""Psoriatic arthritis"" OR ""Psoriasis"" OR ""Rheumatology"" OR ""Arthritis"" OR ""T cell"" OR ""Ankylosing spondylitis"" OR ""Cytotoxic T cell"" OR ""Proinflammatory cytokine"" OR ""Autoimmune disease""))",AND date_published>=now-10y,"AND field_of_study: ((""Medicine"" OR ""Internal medicine"" OR ""Pharmacology"") AND (""Immunology"" OR ""Rheumatoid arthritis"" OR ""Immune system"" OR ""Inflammation"" OR ""Psoriatic arthritis"" OR ""Psoriasis"" OR ""Rheumatology"" OR ""Arthritis"" OR ""T cell"" OR ""Ankylosing spondylitis"" OR ""Cytotoxic T cell"" OR ""Proinflammatory cytokine"" OR ""Autoimmune disease""))",NA,oa_therapy_area,Pharma,Immunology,2016,1749,378,145,224,175,8,930,819
immunology (primary search + immunology tags) - pharma,"(author.affiliation.name:(""pfizer"" OR ""astrazeneca"" OR ""eli lilly"" OR ""merck"" OR ""emd serono"" OR ""msd"" OR ""merck sharp & dohme"" OR ""bristol myers squibb"" OR ""novartis"" OR ""roche"" OR ""hoffmann-la roche"" OR ""genentech"" OR ""johnson & johnson"" OR ""janssen"" OR ""biosense webster"" OR ""glaxosmithkline"" OR ""gsk"" OR ""abbvie"" OR ""sanofi"" OR ""sanofi-aventis"" OR ""gilead sciences"" OR ""takeda"" OR ""boehringer ingelheim"" OR ""myokardia"" OR ""amgen"" OR ""applied molecular genetics"" OR ""bayer"" OR ""vertex pharmaceuticals"" OR ""regeneron"" OR ""novo nordisk"" OR ""biogen"" OR ""biogen idec"" OR ""daiichi sankyo"" OR ""astellas pharma"" OR ""asuterasu seiyaku kabushiki-gaisha"" OR ""otsuka"" OR ""otsuka seiyaku kabushiki-gaisha"" OR ""astex pharmaceuticals"" OR ""ucb"" OR ""union chimique belge"" OR ""moderna"" OR ""eisai"" OR ""ezai kabushiki-gaisha"" OR ""ea pharma"" OR ""csl"" OR ""zlb behring"" OR ""jiangsu hengrui medicine"" OR ""teva pharmaceuticals"" OR ""sumitomo dainippon pharma"" OR ""dainippon sumitomo seiyaku kabushiki-gaisha"" OR ""fresenius"" OR ""fresenius se & co. kgaa"" OR ""viatris"" OR ""kyowa kirin"" OR ""kyowa hakko kirin"" OR ""ipsen"" OR ""jazz pharmaceuticals"" OR ""azur pharma"" OR ""sino biopharm"" OR ""bausch health companies"" OR ""valeant pharmaceuticals"" OR ""cspc pharmaceutical group"" OR ""galapagos"" OR ""galapagos genomics"" NOT ""La Roche College"") OR author.affiliation.ror_id_lineage:(""01xdqrp08"" OR ""00by1q217"" OR ""04b2dty93"" OR ""02891sr49"" OR ""03qd7mz70"" OR ""00gtmwv55"" OR ""02f9zrr09"" OR ""04r9x1a08"" OR ""01qat3289"" OR ""01xsqw823"" OR ""02g5p4n58"" OR ""02n6c9837"" OR ""056546b03"" OR ""04hjbmv12"" OR ""00q32j219"" OR ""03g03ge92"" OR ""04hmn8g73"" OR ""00anb1726"" OR ""02f51rf24"" OR ""0435rc536"" OR ""02jqkb192"" OR ""027y26122"" OR ""01cjash87"" OR ""013k5y296"" OR ""01n029866"" OR ""01xm4wg91"" OR ""04vvh7p27"" OR ""044tc0x05"" OR ""04ayvvz32"" OR ""01wfv3m53"" OR ""04sapgw72"" OR ""01v376g59"" OR ""01g1gvr46"" OR ""000wej815"" OR ""00d801g55"" OR ""055mhsv54"" OR ""0086q4c12"" OR ""01zgpn844"" OR ""016mq8947"" OR ""04e4j5d46"")) AND publication_type:""journal article"" AND date_published>=now-10y AND field_of_study: ((""Medicine"" OR ""Internal medicine"" OR ""Pharmacology"") AND (""Immunology"" OR ""Rheumatoid arthritis"" OR ""Immune system"" OR ""Inflammation"" OR ""Psoriatic arthritis"" OR ""Psoriasis"" OR ""Rheumatology"" OR ""Arthritis"" OR ""T cell"" OR ""Ankylosing spondylitis"" OR ""Cytotoxic T cell"" OR ""Proinflammatory cytokine"" OR ""Autoimmune disease""))",AND date_published>=now-10y,"AND field_of_study: ((""Medicine"" OR ""Internal medicine"" OR ""Pharmacology"") AND (""Immunology"" OR ""Rheumatoid arthritis"" OR ""Immune system"" OR ""Inflammation"" OR ""Psoriatic arthritis"" OR ""Psoriasis"" OR ""Rheumatology"" OR ""Arthritis"" OR ""T cell"" OR ""Ankylosing spondylitis"" OR ""Cytotoxic T cell"" OR ""Proinflammatory cytokine"" OR ""Autoimmune disease""))",NA,oa_therapy_area,Pharma,Immunology,2017,1636,409,170,222,364,17,1182,454
immunology (primary search + immunology tags) - pharma,"(author.affiliation.name:(""pfizer"" OR ""astrazeneca"" OR ""eli lilly"" OR ""merck"" OR ""emd serono"" OR ""msd"" OR ""merck sharp & dohme"" OR ""bristol myers squibb"" OR ""novartis"" OR ""roche"" OR ""hoffmann-la roche"" OR ""genentech"" OR ""johnson & johnson"" OR ""janssen"" OR ""biosense webster"" OR ""glaxosmithkline"" OR ""gsk"" OR ""abbvie"" OR ""sanofi"" OR ""sanofi-aventis"" OR ""gilead sciences"" OR ""takeda"" OR ""boehringer ingelheim"" OR ""myokardia"" OR ""amgen"" OR ""applied molecular genetics"" OR ""bayer"" OR ""vertex pharmaceuticals"" OR ""regeneron"" OR ""novo nordisk"" OR ""biogen"" OR ""biogen idec"" OR ""daiichi sankyo"" OR ""astellas pharma"" OR ""asuterasu seiyaku kabushiki-gaisha"" OR ""otsuka"" OR ""otsuka seiyaku kabushiki-gaisha"" OR ""astex pharmaceuticals"" OR ""ucb"" OR ""union chimique belge"" OR ""moderna"" OR ""eisai"" OR ""ezai kabushiki-gaisha"" OR ""ea pharma"" OR ""csl"" OR ""zlb behring"" OR ""jiangsu hengrui medicine"" OR ""teva pharmaceuticals"" OR ""sumitomo dainippon pharma"" OR ""dainippon sumitomo seiyaku kabushiki-gaisha"" OR ""fresenius"" OR ""fresenius se & co. kgaa"" OR ""viatris"" OR ""kyowa kirin"" OR ""kyowa hakko kirin"" OR ""ipsen"" OR ""jazz pharmaceuticals"" OR ""azur pharma"" OR ""sino biopharm"" OR ""bausch health companies"" OR ""valeant pharmaceuticals"" OR ""cspc pharmaceutical group"" OR ""galapagos"" OR ""galapagos genomics"" NOT ""La Roche College"") OR author.affiliation.ror_id_lineage:(""01xdqrp08"" OR ""00by1q217"" OR ""04b2dty93"" OR ""02891sr49"" OR ""03qd7mz70"" OR ""00gtmwv55"" OR ""02f9zrr09"" OR ""04r9x1a08"" OR ""01qat3289"" OR ""01xsqw823"" OR ""02g5p4n58"" OR ""02n6c9837"" OR ""056546b03"" OR ""04hjbmv12"" OR ""00q32j219"" OR ""03g03ge92"" OR ""04hmn8g73"" OR ""00anb1726"" OR ""02f51rf24"" OR ""0435rc536"" OR ""02jqkb192"" OR ""027y26122"" OR ""01cjash87"" OR ""013k5y296"" OR ""01n029866"" OR ""01xm4wg91"" OR ""04vvh7p27"" OR ""044tc0x05"" OR ""04ayvvz32"" OR ""01wfv3m53"" OR ""04sapgw72"" OR ""01v376g59"" OR ""01g1gvr46"" OR ""000wej815"" OR ""00d801g55"" OR ""055mhsv54"" OR ""0086q4c12"" OR ""01zgpn844"" OR ""016mq8947"" OR ""04e4j5d46"")) AND publication_type:""journal article"" AND date_published>=now-10y AND field_of_study: ((""Medicine"" OR ""Internal medicine"" OR ""Pharmacology"") AND (""Immunology"" OR ""Rheumatoid arthritis"" OR ""Immune system"" OR ""Inflammation"" OR ""Psoriatic arthritis"" OR ""Psoriasis"" OR ""Rheumatology"" OR ""Arthritis"" OR ""T cell"" OR ""Ankylosing spondylitis"" OR ""Cytotoxic T cell"" OR ""Proinflammatory cytokine"" OR ""Autoimmune disease""))",AND date_published>=now-10y,"AND field_of_study: ((""Medicine"" OR ""Internal medicine"" OR ""Pharmacology"") AND (""Immunology"" OR ""Rheumatoid arthritis"" OR ""Immune system"" OR ""Inflammation"" OR ""Psoriatic arthritis"" OR ""Psoriasis"" OR ""Rheumatology"" OR ""Arthritis"" OR ""T cell"" OR ""Ankylosing spondylitis"" OR ""Cytotoxic T cell"" OR ""Proinflammatory cytokine"" OR ""Autoimmune disease""))",NA,oa_therapy_area,Pharma,Immunology,2018,1362,345,128,200,364,10,1047,315
immunology (primary search + immunology tags) - pharma,"(author.affiliation.name:(""pfizer"" OR ""astrazeneca"" OR ""eli lilly"" OR ""merck"" OR ""emd serono"" OR ""msd"" OR ""merck sharp & dohme"" OR ""bristol myers squibb"" OR ""novartis"" OR ""roche"" OR ""hoffmann-la roche"" OR ""genentech"" OR ""johnson & johnson"" OR ""janssen"" OR ""biosense webster"" OR ""glaxosmithkline"" OR ""gsk"" OR ""abbvie"" OR ""sanofi"" OR ""sanofi-aventis"" OR ""gilead sciences"" OR ""takeda"" OR ""boehringer ingelheim"" OR ""myokardia"" OR ""amgen"" OR ""applied molecular genetics"" OR ""bayer"" OR ""vertex pharmaceuticals"" OR ""regeneron"" OR ""novo nordisk"" OR ""biogen"" OR ""biogen idec"" OR ""daiichi sankyo"" OR ""astellas pharma"" OR ""asuterasu seiyaku kabushiki-gaisha"" OR ""otsuka"" OR ""otsuka seiyaku kabushiki-gaisha"" OR ""astex pharmaceuticals"" OR ""ucb"" OR ""union chimique belge"" OR ""moderna"" OR ""eisai"" OR ""ezai kabushiki-gaisha"" OR ""ea pharma"" OR ""csl"" OR ""zlb behring"" OR ""jiangsu hengrui medicine"" OR ""teva pharmaceuticals"" OR ""sumitomo dainippon pharma"" OR ""dainippon sumitomo seiyaku kabushiki-gaisha"" OR ""fresenius"" OR ""fresenius se & co. kgaa"" OR ""viatris"" OR ""kyowa kirin"" OR ""kyowa hakko kirin"" OR ""ipsen"" OR ""jazz pharmaceuticals"" OR ""azur pharma"" OR ""sino biopharm"" OR ""bausch health companies"" OR ""valeant pharmaceuticals"" OR ""cspc pharmaceutical group"" OR ""galapagos"" OR ""galapagos genomics"" NOT ""La Roche College"") OR author.affiliation.ror_id_lineage:(""01xdqrp08"" OR ""00by1q217"" OR ""04b2dty93"" OR ""02891sr49"" OR ""03qd7mz70"" OR ""00gtmwv55"" OR ""02f9zrr09"" OR ""04r9x1a08"" OR ""01qat3289"" OR ""01xsqw823"" OR ""02g5p4n58"" OR ""02n6c9837"" OR ""056546b03"" OR ""04hjbmv12"" OR ""00q32j219"" OR ""03g03ge92"" OR ""04hmn8g73"" OR ""00anb1726"" OR ""02f51rf24"" OR ""0435rc536"" OR ""02jqkb192"" OR ""027y26122"" OR ""01cjash87"" OR ""013k5y296"" OR ""01n029866"" OR ""01xm4wg91"" OR ""04vvh7p27"" OR ""044tc0x05"" OR ""04ayvvz32"" OR ""01wfv3m53"" OR ""04sapgw72"" OR ""01v376g59"" OR ""01g1gvr46"" OR ""000wej815"" OR ""00d801g55"" OR ""055mhsv54"" OR ""0086q4c12"" OR ""01zgpn844"" OR ""016mq8947"" OR ""04e4j5d46"")) AND publication_type:""journal article"" AND date_published>=now-10y AND field_of_study: ((""Medicine"" OR ""Internal medicine"" OR ""Pharmacology"") AND (""Immunology"" OR ""Rheumatoid arthritis"" OR ""Immune system"" OR ""Inflammation"" OR ""Psoriatic arthritis"" OR ""Psoriasis"" OR ""Rheumatology"" OR ""Arthritis"" OR ""T cell"" OR ""Ankylosing spondylitis"" OR ""Cytotoxic T cell"" OR ""Proinflammatory cytokine"" OR ""Autoimmune disease""))",AND date_published>=now-10y,"AND field_of_study: ((""Medicine"" OR ""Internal medicine"" OR ""Pharmacology"") AND (""Immunology"" OR ""Rheumatoid arthritis"" OR ""Immune system"" OR ""Inflammation"" OR ""Psoriatic arthritis"" OR ""Psoriasis"" OR ""Rheumatology"" OR ""Arthritis"" OR ""T cell"" OR ""Ankylosing spondylitis"" OR ""Cytotoxic T cell"" OR ""Proinflammatory cytokine"" OR ""Autoimmune disease""))",NA,oa_therapy_area,Pharma,Immunology,2019,1232,400,126,259,96,7,888,344
immunology (primary search + immunology tags) - pharma,"(author.affiliation.name:(""pfizer"" OR ""astrazeneca"" OR ""eli lilly"" OR ""merck"" OR ""emd serono"" OR ""msd"" OR ""merck sharp & dohme"" OR ""bristol myers squibb"" OR ""novartis"" OR ""roche"" OR ""hoffmann-la roche"" OR ""genentech"" OR ""johnson & johnson"" OR ""janssen"" OR ""biosense webster"" OR ""glaxosmithkline"" OR ""gsk"" OR ""abbvie"" OR ""sanofi"" OR ""sanofi-aventis"" OR ""gilead sciences"" OR ""takeda"" OR ""boehringer ingelheim"" OR ""myokardia"" OR ""amgen"" OR ""applied molecular genetics"" OR ""bayer"" OR ""vertex pharmaceuticals"" OR ""regeneron"" OR ""novo nordisk"" OR ""biogen"" OR ""biogen idec"" OR ""daiichi sankyo"" OR ""astellas pharma"" OR ""asuterasu seiyaku kabushiki-gaisha"" OR ""otsuka"" OR ""otsuka seiyaku kabushiki-gaisha"" OR ""astex pharmaceuticals"" OR ""ucb"" OR ""union chimique belge"" OR ""moderna"" OR ""eisai"" OR ""ezai kabushiki-gaisha"" OR ""ea pharma"" OR ""csl"" OR ""zlb behring"" OR ""jiangsu hengrui medicine"" OR ""teva pharmaceuticals"" OR ""sumitomo dainippon pharma"" OR ""dainippon sumitomo seiyaku kabushiki-gaisha"" OR ""fresenius"" OR ""fresenius se & co. kgaa"" OR ""viatris"" OR ""kyowa kirin"" OR ""kyowa hakko kirin"" OR ""ipsen"" OR ""jazz pharmaceuticals"" OR ""azur pharma"" OR ""sino biopharm"" OR ""bausch health companies"" OR ""valeant pharmaceuticals"" OR ""cspc pharmaceutical group"" OR ""galapagos"" OR ""galapagos genomics"" NOT ""La Roche College"") OR author.affiliation.ror_id_lineage:(""01xdqrp08"" OR ""00by1q217"" OR ""04b2dty93"" OR ""02891sr49"" OR ""03qd7mz70"" OR ""00gtmwv55"" OR ""02f9zrr09"" OR ""04r9x1a08"" OR ""01qat3289"" OR ""01xsqw823"" OR ""02g5p4n58"" OR ""02n6c9837"" OR ""056546b03"" OR ""04hjbmv12"" OR ""00q32j219"" OR ""03g03ge92"" OR ""04hmn8g73"" OR ""00anb1726"" OR ""02f51rf24"" OR ""0435rc536"" OR ""02jqkb192"" OR ""027y26122"" OR ""01cjash87"" OR ""013k5y296"" OR ""01n029866"" OR ""01xm4wg91"" OR ""04vvh7p27"" OR ""044tc0x05"" OR ""04ayvvz32"" OR ""01wfv3m53"" OR ""04sapgw72"" OR ""01v376g59"" OR ""01g1gvr46"" OR ""000wej815"" OR ""00d801g55"" OR ""055mhsv54"" OR ""0086q4c12"" OR ""01zgpn844"" OR ""016mq8947"" OR ""04e4j5d46"")) AND publication_type:""journal article"" AND date_published>=now-10y AND field_of_study: ((""Medicine"" OR ""Internal medicine"" OR ""Pharmacology"") AND (""Immunology"" OR ""Rheumatoid arthritis"" OR ""Immune system"" OR ""Inflammation"" OR ""Psoriatic arthritis"" OR ""Psoriasis"" OR ""Rheumatology"" OR ""Arthritis"" OR ""T cell"" OR ""Ankylosing spondylitis"" OR ""Cytotoxic T cell"" OR ""Proinflammatory cytokine"" OR ""Autoimmune disease""))",AND date_published>=now-10y,"AND field_of_study: ((""Medicine"" OR ""Internal medicine"" OR ""Pharmacology"") AND (""Immunology"" OR ""Rheumatoid arthritis"" OR ""Immune system"" OR ""Inflammation"" OR ""Psoriatic arthritis"" OR ""Psoriasis"" OR ""Rheumatology"" OR ""Arthritis"" OR ""T cell"" OR ""Ankylosing spondylitis"" OR ""Cytotoxic T cell"" OR ""Proinflammatory cytokine"" OR ""Autoimmune disease""))",NA,oa_therapy_area,Pharma,Immunology,2020,1503,471,120,285,224,13,1113,390
immunology (primary search + immunology tags) - pharma,"(author.affiliation.name:(""pfizer"" OR ""astrazeneca"" OR ""eli lilly"" OR ""merck"" OR ""emd serono"" OR ""msd"" OR ""merck sharp & dohme"" OR ""bristol myers squibb"" OR ""novartis"" OR ""roche"" OR ""hoffmann-la roche"" OR ""genentech"" OR ""johnson & johnson"" OR ""janssen"" OR ""biosense webster"" OR ""glaxosmithkline"" OR ""gsk"" OR ""abbvie"" OR ""sanofi"" OR ""sanofi-aventis"" OR ""gilead sciences"" OR ""takeda"" OR ""boehringer ingelheim"" OR ""myokardia"" OR ""amgen"" OR ""applied molecular genetics"" OR ""bayer"" OR ""vertex pharmaceuticals"" OR ""regeneron"" OR ""novo nordisk"" OR ""biogen"" OR ""biogen idec"" OR ""daiichi sankyo"" OR ""astellas pharma"" OR ""asuterasu seiyaku kabushiki-gaisha"" OR ""otsuka"" OR ""otsuka seiyaku kabushiki-gaisha"" OR ""astex pharmaceuticals"" OR ""ucb"" OR ""union chimique belge"" OR ""moderna"" OR ""eisai"" OR ""ezai kabushiki-gaisha"" OR ""ea pharma"" OR ""csl"" OR ""zlb behring"" OR ""jiangsu hengrui medicine"" OR ""teva pharmaceuticals"" OR ""sumitomo dainippon pharma"" OR ""dainippon sumitomo seiyaku kabushiki-gaisha"" OR ""fresenius"" OR ""fresenius se & co. kgaa"" OR ""viatris"" OR ""kyowa kirin"" OR ""kyowa hakko kirin"" OR ""ipsen"" OR ""jazz pharmaceuticals"" OR ""azur pharma"" OR ""sino biopharm"" OR ""bausch health companies"" OR ""valeant pharmaceuticals"" OR ""cspc pharmaceutical group"" OR ""galapagos"" OR ""galapagos genomics"" NOT ""La Roche College"") OR author.affiliation.ror_id_lineage:(""01xdqrp08"" OR ""00by1q217"" OR ""04b2dty93"" OR ""02891sr49"" OR ""03qd7mz70"" OR ""00gtmwv55"" OR ""02f9zrr09"" OR ""04r9x1a08"" OR ""01qat3289"" OR ""01xsqw823"" OR ""02g5p4n58"" OR ""02n6c9837"" OR ""056546b03"" OR ""04hjbmv12"" OR ""00q32j219"" OR ""03g03ge92"" OR ""04hmn8g73"" OR ""00anb1726"" OR ""02f51rf24"" OR ""0435rc536"" OR ""02jqkb192"" OR ""027y26122"" OR ""01cjash87"" OR ""013k5y296"" OR ""01n029866"" OR ""01xm4wg91"" OR ""04vvh7p27"" OR ""044tc0x05"" OR ""04ayvvz32"" OR ""01wfv3m53"" OR ""04sapgw72"" OR ""01v376g59"" OR ""01g1gvr46"" OR ""000wej815"" OR ""00d801g55"" OR ""055mhsv54"" OR ""0086q4c12"" OR ""01zgpn844"" OR ""016mq8947"" OR ""04e4j5d46"")) AND publication_type:""journal article"" AND date_published>=now-10y AND field_of_study: ((""Medicine"" OR ""Internal medicine"" OR ""Pharmacology"") AND (""Immunology"" OR ""Rheumatoid arthritis"" OR ""Immune system"" OR ""Inflammation"" OR ""Psoriatic arthritis"" OR ""Psoriasis"" OR ""Rheumatology"" OR ""Arthritis"" OR ""T cell"" OR ""Ankylosing spondylitis"" OR ""Cytotoxic T cell"" OR ""Proinflammatory cytokine"" OR ""Autoimmune disease""))",AND date_published>=now-10y,"AND field_of_study: ((""Medicine"" OR ""Internal medicine"" OR ""Pharmacology"") AND (""Immunology"" OR ""Rheumatoid arthritis"" OR ""Immune system"" OR ""Inflammation"" OR ""Psoriatic arthritis"" OR ""Psoriasis"" OR ""Rheumatology"" OR ""Arthritis"" OR ""T cell"" OR ""Ankylosing spondylitis"" OR ""Cytotoxic T cell"" OR ""Proinflammatory cytokine"" OR ""Autoimmune disease""))",NA,oa_therapy_area,Pharma,Immunology,2021,1567,646,78,323,208,38,1293,274
immunology (primary search + immunology tags) - pharma,"(author.affiliation.name:(""pfizer"" OR ""astrazeneca"" OR ""eli lilly"" OR ""merck"" OR ""emd serono"" OR ""msd"" OR ""merck sharp & dohme"" OR ""bristol myers squibb"" OR ""novartis"" OR ""roche"" OR ""hoffmann-la roche"" OR ""genentech"" OR ""johnson & johnson"" OR ""janssen"" OR ""biosense webster"" OR ""glaxosmithkline"" OR ""gsk"" OR ""abbvie"" OR ""sanofi"" OR ""sanofi-aventis"" OR ""gilead sciences"" OR ""takeda"" OR ""boehringer ingelheim"" OR ""myokardia"" OR ""amgen"" OR ""applied molecular genetics"" OR ""bayer"" OR ""vertex pharmaceuticals"" OR ""regeneron"" OR ""novo nordisk"" OR ""biogen"" OR ""biogen idec"" OR ""daiichi sankyo"" OR ""astellas pharma"" OR ""asuterasu seiyaku kabushiki-gaisha"" OR ""otsuka"" OR ""otsuka seiyaku kabushiki-gaisha"" OR ""astex pharmaceuticals"" OR ""ucb"" OR ""union chimique belge"" OR ""moderna"" OR ""eisai"" OR ""ezai kabushiki-gaisha"" OR ""ea pharma"" OR ""csl"" OR ""zlb behring"" OR ""jiangsu hengrui medicine"" OR ""teva pharmaceuticals"" OR ""sumitomo dainippon pharma"" OR ""dainippon sumitomo seiyaku kabushiki-gaisha"" OR ""fresenius"" OR ""fresenius se & co. kgaa"" OR ""viatris"" OR ""kyowa kirin"" OR ""kyowa hakko kirin"" OR ""ipsen"" OR ""jazz pharmaceuticals"" OR ""azur pharma"" OR ""sino biopharm"" OR ""bausch health companies"" OR ""valeant pharmaceuticals"" OR ""cspc pharmaceutical group"" OR ""galapagos"" OR ""galapagos genomics"" NOT ""La Roche College"") OR author.affiliation.ror_id_lineage:(""01xdqrp08"" OR ""00by1q217"" OR ""04b2dty93"" OR ""02891sr49"" OR ""03qd7mz70"" OR ""00gtmwv55"" OR ""02f9zrr09"" OR ""04r9x1a08"" OR ""01qat3289"" OR ""01xsqw823"" OR ""02g5p4n58"" OR ""02n6c9837"" OR ""056546b03"" OR ""04hjbmv12"" OR ""00q32j219"" OR ""03g03ge92"" OR ""04hmn8g73"" OR ""00anb1726"" OR ""02f51rf24"" OR ""0435rc536"" OR ""02jqkb192"" OR ""027y26122"" OR ""01cjash87"" OR ""013k5y296"" OR ""01n029866"" OR ""01xm4wg91"" OR ""04vvh7p27"" OR ""044tc0x05"" OR ""04ayvvz32"" OR ""01wfv3m53"" OR ""04sapgw72"" OR ""01v376g59"" OR ""01g1gvr46"" OR ""000wej815"" OR ""00d801g55"" OR ""055mhsv54"" OR ""0086q4c12"" OR ""01zgpn844"" OR ""016mq8947"" OR ""04e4j5d46"")) AND publication_type:""journal article"" AND date_published>=now-10y AND field_of_study: ((""Medicine"" OR ""Internal medicine"" OR ""Pharmacology"") AND (""Immunology"" OR ""Rheumatoid arthritis"" OR ""Immune system"" OR ""Inflammation"" OR ""Psoriatic arthritis"" OR ""Psoriasis"" OR ""Rheumatology"" OR ""Arthritis"" OR ""T cell"" OR ""Ankylosing spondylitis"" OR ""Cytotoxic T cell"" OR ""Proinflammatory cytokine"" OR ""Autoimmune disease""))",AND date_published>=now-10y,"AND field_of_study: ((""Medicine"" OR ""Internal medicine"" OR ""Pharmacology"") AND (""Immunology"" OR ""Rheumatoid arthritis"" OR ""Immune system"" OR ""Inflammation"" OR ""Psoriatic arthritis"" OR ""Psoriasis"" OR ""Rheumatology"" OR ""Arthritis"" OR ""T cell"" OR ""Ankylosing spondylitis"" OR ""Cytotoxic T cell"" OR ""Proinflammatory cytokine"" OR ""Autoimmune disease""))",NA,oa_therapy_area,Pharma,Immunology,2022,2975,1341,179,548,296,76,2440,535
immunology (primary search + immunology tags) - pharma,"(author.affiliation.name:(""pfizer"" OR ""astrazeneca"" OR ""eli lilly"" OR ""merck"" OR ""emd serono"" OR ""msd"" OR ""merck sharp & dohme"" OR ""bristol myers squibb"" OR ""novartis"" OR ""roche"" OR ""hoffmann-la roche"" OR ""genentech"" OR ""johnson & johnson"" OR ""janssen"" OR ""biosense webster"" OR ""glaxosmithkline"" OR ""gsk"" OR ""abbvie"" OR ""sanofi"" OR ""sanofi-aventis"" OR ""gilead sciences"" OR ""takeda"" OR ""boehringer ingelheim"" OR ""myokardia"" OR ""amgen"" OR ""applied molecular genetics"" OR ""bayer"" OR ""vertex pharmaceuticals"" OR ""regeneron"" OR ""novo nordisk"" OR ""biogen"" OR ""biogen idec"" OR ""daiichi sankyo"" OR ""astellas pharma"" OR ""asuterasu seiyaku kabushiki-gaisha"" OR ""otsuka"" OR ""otsuka seiyaku kabushiki-gaisha"" OR ""astex pharmaceuticals"" OR ""ucb"" OR ""union chimique belge"" OR ""moderna"" OR ""eisai"" OR ""ezai kabushiki-gaisha"" OR ""ea pharma"" OR ""csl"" OR ""zlb behring"" OR ""jiangsu hengrui medicine"" OR ""teva pharmaceuticals"" OR ""sumitomo dainippon pharma"" OR ""dainippon sumitomo seiyaku kabushiki-gaisha"" OR ""fresenius"" OR ""fresenius se & co. kgaa"" OR ""viatris"" OR ""kyowa kirin"" OR ""kyowa hakko kirin"" OR ""ipsen"" OR ""jazz pharmaceuticals"" OR ""azur pharma"" OR ""sino biopharm"" OR ""bausch health companies"" OR ""valeant pharmaceuticals"" OR ""cspc pharmaceutical group"" OR ""galapagos"" OR ""galapagos genomics"" NOT ""La Roche College"") OR author.affiliation.ror_id_lineage:(""01xdqrp08"" OR ""00by1q217"" OR ""04b2dty93"" OR ""02891sr49"" OR ""03qd7mz70"" OR ""00gtmwv55"" OR ""02f9zrr09"" OR ""04r9x1a08"" OR ""01qat3289"" OR ""01xsqw823"" OR ""02g5p4n58"" OR ""02n6c9837"" OR ""056546b03"" OR ""04hjbmv12"" OR ""00q32j219"" OR ""03g03ge92"" OR ""04hmn8g73"" OR ""00anb1726"" OR ""02f51rf24"" OR ""0435rc536"" OR ""02jqkb192"" OR ""027y26122"" OR ""01cjash87"" OR ""013k5y296"" OR ""01n029866"" OR ""01xm4wg91"" OR ""04vvh7p27"" OR ""044tc0x05"" OR ""04ayvvz32"" OR ""01wfv3m53"" OR ""04sapgw72"" OR ""01v376g59"" OR ""01g1gvr46"" OR ""000wej815"" OR ""00d801g55"" OR ""055mhsv54"" OR ""0086q4c12"" OR ""01zgpn844"" OR ""016mq8947"" OR ""04e4j5d46"")) AND publication_type:""journal article"" AND date_published>=now-10y AND field_of_study: ((""Medicine"" OR ""Internal medicine"" OR ""Pharmacology"") AND (""Immunology"" OR ""Rheumatoid arthritis"" OR ""Immune system"" OR ""Inflammation"" OR ""Psoriatic arthritis"" OR ""Psoriasis"" OR ""Rheumatology"" OR ""Arthritis"" OR ""T cell"" OR ""Ankylosing spondylitis"" OR ""Cytotoxic T cell"" OR ""Proinflammatory cytokine"" OR ""Autoimmune disease""))",AND date_published>=now-10y,"AND field_of_study: ((""Medicine"" OR ""Internal medicine"" OR ""Pharmacology"") AND (""Immunology"" OR ""Rheumatoid arthritis"" OR ""Immune system"" OR ""Inflammation"" OR ""Psoriatic arthritis"" OR ""Psoriasis"" OR ""Rheumatology"" OR ""Arthritis"" OR ""T cell"" OR ""Ankylosing spondylitis"" OR ""Cytotoxic T cell"" OR ""Proinflammatory cytokine"" OR ""Autoimmune disease""))",NA,oa_therapy_area,Pharma,Immunology,2023,1150,516,13,194,57,121,901,249
endocrinology (primary search + endocrinology tags) - pharma,"(author.affiliation.name:(""pfizer"" OR ""astrazeneca"" OR ""eli lilly"" OR ""merck"" OR ""emd serono"" OR ""msd"" OR ""merck sharp & dohme"" OR ""bristol myers squibb"" OR ""novartis"" OR ""roche"" OR ""hoffmann-la roche"" OR ""genentech"" OR ""johnson & johnson"" OR ""janssen"" OR ""biosense webster"" OR ""glaxosmithkline"" OR ""gsk"" OR ""abbvie"" OR ""sanofi"" OR ""sanofi-aventis"" OR ""gilead sciences"" OR ""takeda"" OR ""boehringer ingelheim"" OR ""myokardia"" OR ""amgen"" OR ""applied molecular genetics"" OR ""bayer"" OR ""vertex pharmaceuticals"" OR ""regeneron"" OR ""novo nordisk"" OR ""biogen"" OR ""biogen idec"" OR ""daiichi sankyo"" OR ""astellas pharma"" OR ""asuterasu seiyaku kabushiki-gaisha"" OR ""otsuka"" OR ""otsuka seiyaku kabushiki-gaisha"" OR ""astex pharmaceuticals"" OR ""ucb"" OR ""union chimique belge"" OR ""moderna"" OR ""eisai"" OR ""ezai kabushiki-gaisha"" OR ""ea pharma"" OR ""csl"" OR ""zlb behring"" OR ""jiangsu hengrui medicine"" OR ""teva pharmaceuticals"" OR ""sumitomo dainippon pharma"" OR ""dainippon sumitomo seiyaku kabushiki-gaisha"" OR ""fresenius"" OR ""fresenius se & co. kgaa"" OR ""viatris"" OR ""kyowa kirin"" OR ""kyowa hakko kirin"" OR ""ipsen"" OR ""jazz pharmaceuticals"" OR ""azur pharma"" OR ""sino biopharm"" OR ""bausch health companies"" OR ""valeant pharmaceuticals"" OR ""cspc pharmaceutical group"" OR ""galapagos"" OR ""galapagos genomics"" NOT ""La Roche College"") OR author.affiliation.ror_id_lineage:(""01xdqrp08"" OR ""00by1q217"" OR ""04b2dty93"" OR ""02891sr49"" OR ""03qd7mz70"" OR ""00gtmwv55"" OR ""02f9zrr09"" OR ""04r9x1a08"" OR ""01qat3289"" OR ""01xsqw823"" OR ""02g5p4n58"" OR ""02n6c9837"" OR ""056546b03"" OR ""04hjbmv12"" OR ""00q32j219"" OR ""03g03ge92"" OR ""04hmn8g73"" OR ""00anb1726"" OR ""02f51rf24"" OR ""0435rc536"" OR ""02jqkb192"" OR ""027y26122"" OR ""01cjash87"" OR ""013k5y296"" OR ""01n029866"" OR ""01xm4wg91"" OR ""04vvh7p27"" OR ""044tc0x05"" OR ""04ayvvz32"" OR ""01wfv3m53"" OR ""04sapgw72"" OR ""01v376g59"" OR ""01g1gvr46"" OR ""000wej815"" OR ""00d801g55"" OR ""055mhsv54"" OR ""0086q4c12"" OR ""01zgpn844"" OR ""016mq8947"" OR ""04e4j5d46"")) AND publication_type:""journal article"" AND date_published>=now-10y AND field_of_study: ((""Medicine"" OR ""Internal medicine"" OR ""Pharmacology"") AND (""Endocrinology"" OR ""Diabetes mellitus"" OR ""Type 2 diabetes"" OR ""Insulin"" OR ""Type 2 Diabetes Mellitus"" OR ""Hypoglycemia"" OR ""Type 1 diabetes"" OR ""Insulin resistance"" OR ""Dyslipidemia"" OR ""Diabetic retinopathy"" OR ""Diabetic nephropathy"" OR ""Endocrine system""))",AND date_published>=now-10y,"AND field_of_study: ((""Medicine"" OR ""Internal medicine"" OR ""Pharmacology"") AND (""Endocrinology"" OR ""Diabetes mellitus"" OR ""Type 2 diabetes"" OR ""Insulin"" OR ""Type 2 Diabetes Mellitus"" OR ""Hypoglycemia"" OR ""Type 1 diabetes"" OR ""Insulin resistance"" OR ""Dyslipidemia"" OR ""Diabetic retinopathy"" OR ""Diabetic nephropathy"" OR ""Endocrine system""))",NA,oa_therapy_area,Pharma,Endocrinology,2013,564,125,72,80,53,5,335,229
endocrinology (primary search + endocrinology tags) - pharma,"(author.affiliation.name:(""pfizer"" OR ""astrazeneca"" OR ""eli lilly"" OR ""merck"" OR ""emd serono"" OR ""msd"" OR ""merck sharp & dohme"" OR ""bristol myers squibb"" OR ""novartis"" OR ""roche"" OR ""hoffmann-la roche"" OR ""genentech"" OR ""johnson & johnson"" OR ""janssen"" OR ""biosense webster"" OR ""glaxosmithkline"" OR ""gsk"" OR ""abbvie"" OR ""sanofi"" OR ""sanofi-aventis"" OR ""gilead sciences"" OR ""takeda"" OR ""boehringer ingelheim"" OR ""myokardia"" OR ""amgen"" OR ""applied molecular genetics"" OR ""bayer"" OR ""vertex pharmaceuticals"" OR ""regeneron"" OR ""novo nordisk"" OR ""biogen"" OR ""biogen idec"" OR ""daiichi sankyo"" OR ""astellas pharma"" OR ""asuterasu seiyaku kabushiki-gaisha"" OR ""otsuka"" OR ""otsuka seiyaku kabushiki-gaisha"" OR ""astex pharmaceuticals"" OR ""ucb"" OR ""union chimique belge"" OR ""moderna"" OR ""eisai"" OR ""ezai kabushiki-gaisha"" OR ""ea pharma"" OR ""csl"" OR ""zlb behring"" OR ""jiangsu hengrui medicine"" OR ""teva pharmaceuticals"" OR ""sumitomo dainippon pharma"" OR ""dainippon sumitomo seiyaku kabushiki-gaisha"" OR ""fresenius"" OR ""fresenius se & co. kgaa"" OR ""viatris"" OR ""kyowa kirin"" OR ""kyowa hakko kirin"" OR ""ipsen"" OR ""jazz pharmaceuticals"" OR ""azur pharma"" OR ""sino biopharm"" OR ""bausch health companies"" OR ""valeant pharmaceuticals"" OR ""cspc pharmaceutical group"" OR ""galapagos"" OR ""galapagos genomics"" NOT ""La Roche College"") OR author.affiliation.ror_id_lineage:(""01xdqrp08"" OR ""00by1q217"" OR ""04b2dty93"" OR ""02891sr49"" OR ""03qd7mz70"" OR ""00gtmwv55"" OR ""02f9zrr09"" OR ""04r9x1a08"" OR ""01qat3289"" OR ""01xsqw823"" OR ""02g5p4n58"" OR ""02n6c9837"" OR ""056546b03"" OR ""04hjbmv12"" OR ""00q32j219"" OR ""03g03ge92"" OR ""04hmn8g73"" OR ""00anb1726"" OR ""02f51rf24"" OR ""0435rc536"" OR ""02jqkb192"" OR ""027y26122"" OR ""01cjash87"" OR ""013k5y296"" OR ""01n029866"" OR ""01xm4wg91"" OR ""04vvh7p27"" OR ""044tc0x05"" OR ""04ayvvz32"" OR ""01wfv3m53"" OR ""04sapgw72"" OR ""01v376g59"" OR ""01g1gvr46"" OR ""000wej815"" OR ""00d801g55"" OR ""055mhsv54"" OR ""0086q4c12"" OR ""01zgpn844"" OR ""016mq8947"" OR ""04e4j5d46"")) AND publication_type:""journal article"" AND date_published>=now-10y AND field_of_study: ((""Medicine"" OR ""Internal medicine"" OR ""Pharmacology"") AND (""Endocrinology"" OR ""Diabetes mellitus"" OR ""Type 2 diabetes"" OR ""Insulin"" OR ""Type 2 Diabetes Mellitus"" OR ""Hypoglycemia"" OR ""Type 1 diabetes"" OR ""Insulin resistance"" OR ""Dyslipidemia"" OR ""Diabetic retinopathy"" OR ""Diabetic nephropathy"" OR ""Endocrine system""))",AND date_published>=now-10y,"AND field_of_study: ((""Medicine"" OR ""Internal medicine"" OR ""Pharmacology"") AND (""Endocrinology"" OR ""Diabetes mellitus"" OR ""Type 2 diabetes"" OR ""Insulin"" OR ""Type 2 Diabetes Mellitus"" OR ""Hypoglycemia"" OR ""Type 1 diabetes"" OR ""Insulin resistance"" OR ""Dyslipidemia"" OR ""Diabetic retinopathy"" OR ""Diabetic nephropathy"" OR ""Endocrine system""))",NA,oa_therapy_area,Pharma,Endocrinology,2014,1555,294,211,165,141,95,906,649
endocrinology (primary search + endocrinology tags) - pharma,"(author.affiliation.name:(""pfizer"" OR ""astrazeneca"" OR ""eli lilly"" OR ""merck"" OR ""emd serono"" OR ""msd"" OR ""merck sharp & dohme"" OR ""bristol myers squibb"" OR ""novartis"" OR ""roche"" OR ""hoffmann-la roche"" OR ""genentech"" OR ""johnson & johnson"" OR ""janssen"" OR ""biosense webster"" OR ""glaxosmithkline"" OR ""gsk"" OR ""abbvie"" OR ""sanofi"" OR ""sanofi-aventis"" OR ""gilead sciences"" OR ""takeda"" OR ""boehringer ingelheim"" OR ""myokardia"" OR ""amgen"" OR ""applied molecular genetics"" OR ""bayer"" OR ""vertex pharmaceuticals"" OR ""regeneron"" OR ""novo nordisk"" OR ""biogen"" OR ""biogen idec"" OR ""daiichi sankyo"" OR ""astellas pharma"" OR ""asuterasu seiyaku kabushiki-gaisha"" OR ""otsuka"" OR ""otsuka seiyaku kabushiki-gaisha"" OR ""astex pharmaceuticals"" OR ""ucb"" OR ""union chimique belge"" OR ""moderna"" OR ""eisai"" OR ""ezai kabushiki-gaisha"" OR ""ea pharma"" OR ""csl"" OR ""zlb behring"" OR ""jiangsu hengrui medicine"" OR ""teva pharmaceuticals"" OR ""sumitomo dainippon pharma"" OR ""dainippon sumitomo seiyaku kabushiki-gaisha"" OR ""fresenius"" OR ""fresenius se & co. kgaa"" OR ""viatris"" OR ""kyowa kirin"" OR ""kyowa hakko kirin"" OR ""ipsen"" OR ""jazz pharmaceuticals"" OR ""azur pharma"" OR ""sino biopharm"" OR ""bausch health companies"" OR ""valeant pharmaceuticals"" OR ""cspc pharmaceutical group"" OR ""galapagos"" OR ""galapagos genomics"" NOT ""La Roche College"") OR author.affiliation.ror_id_lineage:(""01xdqrp08"" OR ""00by1q217"" OR ""04b2dty93"" OR ""02891sr49"" OR ""03qd7mz70"" OR ""00gtmwv55"" OR ""02f9zrr09"" OR ""04r9x1a08"" OR ""01qat3289"" OR ""01xsqw823"" OR ""02g5p4n58"" OR ""02n6c9837"" OR ""056546b03"" OR ""04hjbmv12"" OR ""00q32j219"" OR ""03g03ge92"" OR ""04hmn8g73"" OR ""00anb1726"" OR ""02f51rf24"" OR ""0435rc536"" OR ""02jqkb192"" OR ""027y26122"" OR ""01cjash87"" OR ""013k5y296"" OR ""01n029866"" OR ""01xm4wg91"" OR ""04vvh7p27"" OR ""044tc0x05"" OR ""04ayvvz32"" OR ""01wfv3m53"" OR ""04sapgw72"" OR ""01v376g59"" OR ""01g1gvr46"" OR ""000wej815"" OR ""00d801g55"" OR ""055mhsv54"" OR ""0086q4c12"" OR ""01zgpn844"" OR ""016mq8947"" OR ""04e4j5d46"")) AND publication_type:""journal article"" AND date_published>=now-10y AND field_of_study: ((""Medicine"" OR ""Internal medicine"" OR ""Pharmacology"") AND (""Endocrinology"" OR ""Diabetes mellitus"" OR ""Type 2 diabetes"" OR ""Insulin"" OR ""Type 2 Diabetes Mellitus"" OR ""Hypoglycemia"" OR ""Type 1 diabetes"" OR ""Insulin resistance"" OR ""Dyslipidemia"" OR ""Diabetic retinopathy"" OR ""Diabetic nephropathy"" OR ""Endocrine system""))",AND date_published>=now-10y,"AND field_of_study: ((""Medicine"" OR ""Internal medicine"" OR ""Pharmacology"") AND (""Endocrinology"" OR ""Diabetes mellitus"" OR ""Type 2 diabetes"" OR ""Insulin"" OR ""Type 2 Diabetes Mellitus"" OR ""Hypoglycemia"" OR ""Type 1 diabetes"" OR ""Insulin resistance"" OR ""Dyslipidemia"" OR ""Diabetic retinopathy"" OR ""Diabetic nephropathy"" OR ""Endocrine system""))",NA,oa_therapy_area,Pharma,Endocrinology,2015,1472,325,253,177,125,15,895,577
endocrinology (primary search + endocrinology tags) - pharma,"(author.affiliation.name:(""pfizer"" OR ""astrazeneca"" OR ""eli lilly"" OR ""merck"" OR ""emd serono"" OR ""msd"" OR ""merck sharp & dohme"" OR ""bristol myers squibb"" OR ""novartis"" OR ""roche"" OR ""hoffmann-la roche"" OR ""genentech"" OR ""johnson & johnson"" OR ""janssen"" OR ""biosense webster"" OR ""glaxosmithkline"" OR ""gsk"" OR ""abbvie"" OR ""sanofi"" OR ""sanofi-aventis"" OR ""gilead sciences"" OR ""takeda"" OR ""boehringer ingelheim"" OR ""myokardia"" OR ""amgen"" OR ""applied molecular genetics"" OR ""bayer"" OR ""vertex pharmaceuticals"" OR ""regeneron"" OR ""novo nordisk"" OR ""biogen"" OR ""biogen idec"" OR ""daiichi sankyo"" OR ""astellas pharma"" OR ""asuterasu seiyaku kabushiki-gaisha"" OR ""otsuka"" OR ""otsuka seiyaku kabushiki-gaisha"" OR ""astex pharmaceuticals"" OR ""ucb"" OR ""union chimique belge"" OR ""moderna"" OR ""eisai"" OR ""ezai kabushiki-gaisha"" OR ""ea pharma"" OR ""csl"" OR ""zlb behring"" OR ""jiangsu hengrui medicine"" OR ""teva pharmaceuticals"" OR ""sumitomo dainippon pharma"" OR ""dainippon sumitomo seiyaku kabushiki-gaisha"" OR ""fresenius"" OR ""fresenius se & co. kgaa"" OR ""viatris"" OR ""kyowa kirin"" OR ""kyowa hakko kirin"" OR ""ipsen"" OR ""jazz pharmaceuticals"" OR ""azur pharma"" OR ""sino biopharm"" OR ""bausch health companies"" OR ""valeant pharmaceuticals"" OR ""cspc pharmaceutical group"" OR ""galapagos"" OR ""galapagos genomics"" NOT ""La Roche College"") OR author.affiliation.ror_id_lineage:(""01xdqrp08"" OR ""00by1q217"" OR ""04b2dty93"" OR ""02891sr49"" OR ""03qd7mz70"" OR ""00gtmwv55"" OR ""02f9zrr09"" OR ""04r9x1a08"" OR ""01qat3289"" OR ""01xsqw823"" OR ""02g5p4n58"" OR ""02n6c9837"" OR ""056546b03"" OR ""04hjbmv12"" OR ""00q32j219"" OR ""03g03ge92"" OR ""04hmn8g73"" OR ""00anb1726"" OR ""02f51rf24"" OR ""0435rc536"" OR ""02jqkb192"" OR ""027y26122"" OR ""01cjash87"" OR ""013k5y296"" OR ""01n029866"" OR ""01xm4wg91"" OR ""04vvh7p27"" OR ""044tc0x05"" OR ""04ayvvz32"" OR ""01wfv3m53"" OR ""04sapgw72"" OR ""01v376g59"" OR ""01g1gvr46"" OR ""000wej815"" OR ""00d801g55"" OR ""055mhsv54"" OR ""0086q4c12"" OR ""01zgpn844"" OR ""016mq8947"" OR ""04e4j5d46"")) AND publication_type:""journal article"" AND date_published>=now-10y AND field_of_study: ((""Medicine"" OR ""Internal medicine"" OR ""Pharmacology"") AND (""Endocrinology"" OR ""Diabetes mellitus"" OR ""Type 2 diabetes"" OR ""Insulin"" OR ""Type 2 Diabetes Mellitus"" OR ""Hypoglycemia"" OR ""Type 1 diabetes"" OR ""Insulin resistance"" OR ""Dyslipidemia"" OR ""Diabetic retinopathy"" OR ""Diabetic nephropathy"" OR ""Endocrine system""))",AND date_published>=now-10y,"AND field_of_study: ((""Medicine"" OR ""Internal medicine"" OR ""Pharmacology"") AND (""Endocrinology"" OR ""Diabetes mellitus"" OR ""Type 2 diabetes"" OR ""Insulin"" OR ""Type 2 Diabetes Mellitus"" OR ""Hypoglycemia"" OR ""Type 1 diabetes"" OR ""Insulin resistance"" OR ""Dyslipidemia"" OR ""Diabetic retinopathy"" OR ""Diabetic nephropathy"" OR ""Endocrine system""))",NA,oa_therapy_area,Pharma,Endocrinology,2016,1522,413,229,221,170,19,1052,470
endocrinology (primary search + endocrinology tags) - pharma,"(author.affiliation.name:(""pfizer"" OR ""astrazeneca"" OR ""eli lilly"" OR ""merck"" OR ""emd serono"" OR ""msd"" OR ""merck sharp & dohme"" OR ""bristol myers squibb"" OR ""novartis"" OR ""roche"" OR ""hoffmann-la roche"" OR ""genentech"" OR ""johnson & johnson"" OR ""janssen"" OR ""biosense webster"" OR ""glaxosmithkline"" OR ""gsk"" OR ""abbvie"" OR ""sanofi"" OR ""sanofi-aventis"" OR ""gilead sciences"" OR ""takeda"" OR ""boehringer ingelheim"" OR ""myokardia"" OR ""amgen"" OR ""applied molecular genetics"" OR ""bayer"" OR ""vertex pharmaceuticals"" OR ""regeneron"" OR ""novo nordisk"" OR ""biogen"" OR ""biogen idec"" OR ""daiichi sankyo"" OR ""astellas pharma"" OR ""asuterasu seiyaku kabushiki-gaisha"" OR ""otsuka"" OR ""otsuka seiyaku kabushiki-gaisha"" OR ""astex pharmaceuticals"" OR ""ucb"" OR ""union chimique belge"" OR ""moderna"" OR ""eisai"" OR ""ezai kabushiki-gaisha"" OR ""ea pharma"" OR ""csl"" OR ""zlb behring"" OR ""jiangsu hengrui medicine"" OR ""teva pharmaceuticals"" OR ""sumitomo dainippon pharma"" OR ""dainippon sumitomo seiyaku kabushiki-gaisha"" OR ""fresenius"" OR ""fresenius se & co. kgaa"" OR ""viatris"" OR ""kyowa kirin"" OR ""kyowa hakko kirin"" OR ""ipsen"" OR ""jazz pharmaceuticals"" OR ""azur pharma"" OR ""sino biopharm"" OR ""bausch health companies"" OR ""valeant pharmaceuticals"" OR ""cspc pharmaceutical group"" OR ""galapagos"" OR ""galapagos genomics"" NOT ""La Roche College"") OR author.affiliation.ror_id_lineage:(""01xdqrp08"" OR ""00by1q217"" OR ""04b2dty93"" OR ""02891sr49"" OR ""03qd7mz70"" OR ""00gtmwv55"" OR ""02f9zrr09"" OR ""04r9x1a08"" OR ""01qat3289"" OR ""01xsqw823"" OR ""02g5p4n58"" OR ""02n6c9837"" OR ""056546b03"" OR ""04hjbmv12"" OR ""00q32j219"" OR ""03g03ge92"" OR ""04hmn8g73"" OR ""00anb1726"" OR ""02f51rf24"" OR ""0435rc536"" OR ""02jqkb192"" OR ""027y26122"" OR ""01cjash87"" OR ""013k5y296"" OR ""01n029866"" OR ""01xm4wg91"" OR ""04vvh7p27"" OR ""044tc0x05"" OR ""04ayvvz32"" OR ""01wfv3m53"" OR ""04sapgw72"" OR ""01v376g59"" OR ""01g1gvr46"" OR ""000wej815"" OR ""00d801g55"" OR ""055mhsv54"" OR ""0086q4c12"" OR ""01zgpn844"" OR ""016mq8947"" OR ""04e4j5d46"")) AND publication_type:""journal article"" AND date_published>=now-10y AND field_of_study: ((""Medicine"" OR ""Internal medicine"" OR ""Pharmacology"") AND (""Endocrinology"" OR ""Diabetes mellitus"" OR ""Type 2 diabetes"" OR ""Insulin"" OR ""Type 2 Diabetes Mellitus"" OR ""Hypoglycemia"" OR ""Type 1 diabetes"" OR ""Insulin resistance"" OR ""Dyslipidemia"" OR ""Diabetic retinopathy"" OR ""Diabetic nephropathy"" OR ""Endocrine system""))",AND date_published>=now-10y,"AND field_of_study: ((""Medicine"" OR ""Internal medicine"" OR ""Pharmacology"") AND (""Endocrinology"" OR ""Diabetes mellitus"" OR ""Type 2 diabetes"" OR ""Insulin"" OR ""Type 2 Diabetes Mellitus"" OR ""Hypoglycemia"" OR ""Type 1 diabetes"" OR ""Insulin resistance"" OR ""Dyslipidemia"" OR ""Diabetic retinopathy"" OR ""Diabetic nephropathy"" OR ""Endocrine system""))",NA,oa_therapy_area,Pharma,Endocrinology,2017,1414,406,223,215,157,22,1023,391
endocrinology (primary search + endocrinology tags) - pharma,"(author.affiliation.name:(""pfizer"" OR ""astrazeneca"" OR ""eli lilly"" OR ""merck"" OR ""emd serono"" OR ""msd"" OR ""merck sharp & dohme"" OR ""bristol myers squibb"" OR ""novartis"" OR ""roche"" OR ""hoffmann-la roche"" OR ""genentech"" OR ""johnson & johnson"" OR ""janssen"" OR ""biosense webster"" OR ""glaxosmithkline"" OR ""gsk"" OR ""abbvie"" OR ""sanofi"" OR ""sanofi-aventis"" OR ""gilead sciences"" OR ""takeda"" OR ""boehringer ingelheim"" OR ""myokardia"" OR ""amgen"" OR ""applied molecular genetics"" OR ""bayer"" OR ""vertex pharmaceuticals"" OR ""regeneron"" OR ""novo nordisk"" OR ""biogen"" OR ""biogen idec"" OR ""daiichi sankyo"" OR ""astellas pharma"" OR ""asuterasu seiyaku kabushiki-gaisha"" OR ""otsuka"" OR ""otsuka seiyaku kabushiki-gaisha"" OR ""astex pharmaceuticals"" OR ""ucb"" OR ""union chimique belge"" OR ""moderna"" OR ""eisai"" OR ""ezai kabushiki-gaisha"" OR ""ea pharma"" OR ""csl"" OR ""zlb behring"" OR ""jiangsu hengrui medicine"" OR ""teva pharmaceuticals"" OR ""sumitomo dainippon pharma"" OR ""dainippon sumitomo seiyaku kabushiki-gaisha"" OR ""fresenius"" OR ""fresenius se & co. kgaa"" OR ""viatris"" OR ""kyowa kirin"" OR ""kyowa hakko kirin"" OR ""ipsen"" OR ""jazz pharmaceuticals"" OR ""azur pharma"" OR ""sino biopharm"" OR ""bausch health companies"" OR ""valeant pharmaceuticals"" OR ""cspc pharmaceutical group"" OR ""galapagos"" OR ""galapagos genomics"" NOT ""La Roche College"") OR author.affiliation.ror_id_lineage:(""01xdqrp08"" OR ""00by1q217"" OR ""04b2dty93"" OR ""02891sr49"" OR ""03qd7mz70"" OR ""00gtmwv55"" OR ""02f9zrr09"" OR ""04r9x1a08"" OR ""01qat3289"" OR ""01xsqw823"" OR ""02g5p4n58"" OR ""02n6c9837"" OR ""056546b03"" OR ""04hjbmv12"" OR ""00q32j219"" OR ""03g03ge92"" OR ""04hmn8g73"" OR ""00anb1726"" OR ""02f51rf24"" OR ""0435rc536"" OR ""02jqkb192"" OR ""027y26122"" OR ""01cjash87"" OR ""013k5y296"" OR ""01n029866"" OR ""01xm4wg91"" OR ""04vvh7p27"" OR ""044tc0x05"" OR ""04ayvvz32"" OR ""01wfv3m53"" OR ""04sapgw72"" OR ""01v376g59"" OR ""01g1gvr46"" OR ""000wej815"" OR ""00d801g55"" OR ""055mhsv54"" OR ""0086q4c12"" OR ""01zgpn844"" OR ""016mq8947"" OR ""04e4j5d46"")) AND publication_type:""journal article"" AND date_published>=now-10y AND field_of_study: ((""Medicine"" OR ""Internal medicine"" OR ""Pharmacology"") AND (""Endocrinology"" OR ""Diabetes mellitus"" OR ""Type 2 diabetes"" OR ""Insulin"" OR ""Type 2 Diabetes Mellitus"" OR ""Hypoglycemia"" OR ""Type 1 diabetes"" OR ""Insulin resistance"" OR ""Dyslipidemia"" OR ""Diabetic retinopathy"" OR ""Diabetic nephropathy"" OR ""Endocrine system""))",AND date_published>=now-10y,"AND field_of_study: ((""Medicine"" OR ""Internal medicine"" OR ""Pharmacology"") AND (""Endocrinology"" OR ""Diabetes mellitus"" OR ""Type 2 diabetes"" OR ""Insulin"" OR ""Type 2 Diabetes Mellitus"" OR ""Hypoglycemia"" OR ""Type 1 diabetes"" OR ""Insulin resistance"" OR ""Dyslipidemia"" OR ""Diabetic retinopathy"" OR ""Diabetic nephropathy"" OR ""Endocrine system""))",NA,oa_therapy_area,Pharma,Endocrinology,2018,1167,363,159,223,130,16,891,276
endocrinology (primary search + endocrinology tags) - pharma,"(author.affiliation.name:(""pfizer"" OR ""astrazeneca"" OR ""eli lilly"" OR ""merck"" OR ""emd serono"" OR ""msd"" OR ""merck sharp & dohme"" OR ""bristol myers squibb"" OR ""novartis"" OR ""roche"" OR ""hoffmann-la roche"" OR ""genentech"" OR ""johnson & johnson"" OR ""janssen"" OR ""biosense webster"" OR ""glaxosmithkline"" OR ""gsk"" OR ""abbvie"" OR ""sanofi"" OR ""sanofi-aventis"" OR ""gilead sciences"" OR ""takeda"" OR ""boehringer ingelheim"" OR ""myokardia"" OR ""amgen"" OR ""applied molecular genetics"" OR ""bayer"" OR ""vertex pharmaceuticals"" OR ""regeneron"" OR ""novo nordisk"" OR ""biogen"" OR ""biogen idec"" OR ""daiichi sankyo"" OR ""astellas pharma"" OR ""asuterasu seiyaku kabushiki-gaisha"" OR ""otsuka"" OR ""otsuka seiyaku kabushiki-gaisha"" OR ""astex pharmaceuticals"" OR ""ucb"" OR ""union chimique belge"" OR ""moderna"" OR ""eisai"" OR ""ezai kabushiki-gaisha"" OR ""ea pharma"" OR ""csl"" OR ""zlb behring"" OR ""jiangsu hengrui medicine"" OR ""teva pharmaceuticals"" OR ""sumitomo dainippon pharma"" OR ""dainippon sumitomo seiyaku kabushiki-gaisha"" OR ""fresenius"" OR ""fresenius se & co. kgaa"" OR ""viatris"" OR ""kyowa kirin"" OR ""kyowa hakko kirin"" OR ""ipsen"" OR ""jazz pharmaceuticals"" OR ""azur pharma"" OR ""sino biopharm"" OR ""bausch health companies"" OR ""valeant pharmaceuticals"" OR ""cspc pharmaceutical group"" OR ""galapagos"" OR ""galapagos genomics"" NOT ""La Roche College"") OR author.affiliation.ror_id_lineage:(""01xdqrp08"" OR ""00by1q217"" OR ""04b2dty93"" OR ""02891sr49"" OR ""03qd7mz70"" OR ""00gtmwv55"" OR ""02f9zrr09"" OR ""04r9x1a08"" OR ""01qat3289"" OR ""01xsqw823"" OR ""02g5p4n58"" OR ""02n6c9837"" OR ""056546b03"" OR ""04hjbmv12"" OR ""00q32j219"" OR ""03g03ge92"" OR ""04hmn8g73"" OR ""00anb1726"" OR ""02f51rf24"" OR ""0435rc536"" OR ""02jqkb192"" OR ""027y26122"" OR ""01cjash87"" OR ""013k5y296"" OR ""01n029866"" OR ""01xm4wg91"" OR ""04vvh7p27"" OR ""044tc0x05"" OR ""04ayvvz32"" OR ""01wfv3m53"" OR ""04sapgw72"" OR ""01v376g59"" OR ""01g1gvr46"" OR ""000wej815"" OR ""00d801g55"" OR ""055mhsv54"" OR ""0086q4c12"" OR ""01zgpn844"" OR ""016mq8947"" OR ""04e4j5d46"")) AND publication_type:""journal article"" AND date_published>=now-10y AND field_of_study: ((""Medicine"" OR ""Internal medicine"" OR ""Pharmacology"") AND (""Endocrinology"" OR ""Diabetes mellitus"" OR ""Type 2 diabetes"" OR ""Insulin"" OR ""Type 2 Diabetes Mellitus"" OR ""Hypoglycemia"" OR ""Type 1 diabetes"" OR ""Insulin resistance"" OR ""Dyslipidemia"" OR ""Diabetic retinopathy"" OR ""Diabetic nephropathy"" OR ""Endocrine system""))",AND date_published>=now-10y,"AND field_of_study: ((""Medicine"" OR ""Internal medicine"" OR ""Pharmacology"") AND (""Endocrinology"" OR ""Diabetes mellitus"" OR ""Type 2 diabetes"" OR ""Insulin"" OR ""Type 2 Diabetes Mellitus"" OR ""Hypoglycemia"" OR ""Type 1 diabetes"" OR ""Insulin resistance"" OR ""Dyslipidemia"" OR ""Diabetic retinopathy"" OR ""Diabetic nephropathy"" OR ""Endocrine system""))",NA,oa_therapy_area,Pharma,Endocrinology,2019,1166,403,149,247,104,3,906,260
endocrinology (primary search + endocrinology tags) - pharma,"(author.affiliation.name:(""pfizer"" OR ""astrazeneca"" OR ""eli lilly"" OR ""merck"" OR ""emd serono"" OR ""msd"" OR ""merck sharp & dohme"" OR ""bristol myers squibb"" OR ""novartis"" OR ""roche"" OR ""hoffmann-la roche"" OR ""genentech"" OR ""johnson & johnson"" OR ""janssen"" OR ""biosense webster"" OR ""glaxosmithkline"" OR ""gsk"" OR ""abbvie"" OR ""sanofi"" OR ""sanofi-aventis"" OR ""gilead sciences"" OR ""takeda"" OR ""boehringer ingelheim"" OR ""myokardia"" OR ""amgen"" OR ""applied molecular genetics"" OR ""bayer"" OR ""vertex pharmaceuticals"" OR ""regeneron"" OR ""novo nordisk"" OR ""biogen"" OR ""biogen idec"" OR ""daiichi sankyo"" OR ""astellas pharma"" OR ""asuterasu seiyaku kabushiki-gaisha"" OR ""otsuka"" OR ""otsuka seiyaku kabushiki-gaisha"" OR ""astex pharmaceuticals"" OR ""ucb"" OR ""union chimique belge"" OR ""moderna"" OR ""eisai"" OR ""ezai kabushiki-gaisha"" OR ""ea pharma"" OR ""csl"" OR ""zlb behring"" OR ""jiangsu hengrui medicine"" OR ""teva pharmaceuticals"" OR ""sumitomo dainippon pharma"" OR ""dainippon sumitomo seiyaku kabushiki-gaisha"" OR ""fresenius"" OR ""fresenius se & co. kgaa"" OR ""viatris"" OR ""kyowa kirin"" OR ""kyowa hakko kirin"" OR ""ipsen"" OR ""jazz pharmaceuticals"" OR ""azur pharma"" OR ""sino biopharm"" OR ""bausch health companies"" OR ""valeant pharmaceuticals"" OR ""cspc pharmaceutical group"" OR ""galapagos"" OR ""galapagos genomics"" NOT ""La Roche College"") OR author.affiliation.ror_id_lineage:(""01xdqrp08"" OR ""00by1q217"" OR ""04b2dty93"" OR ""02891sr49"" OR ""03qd7mz70"" OR ""00gtmwv55"" OR ""02f9zrr09"" OR ""04r9x1a08"" OR ""01qat3289"" OR ""01xsqw823"" OR ""02g5p4n58"" OR ""02n6c9837"" OR ""056546b03"" OR ""04hjbmv12"" OR ""00q32j219"" OR ""03g03ge92"" OR ""04hmn8g73"" OR ""00anb1726"" OR ""02f51rf24"" OR ""0435rc536"" OR ""02jqkb192"" OR ""027y26122"" OR ""01cjash87"" OR ""013k5y296"" OR ""01n029866"" OR ""01xm4wg91"" OR ""04vvh7p27"" OR ""044tc0x05"" OR ""04ayvvz32"" OR ""01wfv3m53"" OR ""04sapgw72"" OR ""01v376g59"" OR ""01g1gvr46"" OR ""000wej815"" OR ""00d801g55"" OR ""055mhsv54"" OR ""0086q4c12"" OR ""01zgpn844"" OR ""016mq8947"" OR ""04e4j5d46"")) AND publication_type:""journal article"" AND date_published>=now-10y AND field_of_study: ((""Medicine"" OR ""Internal medicine"" OR ""Pharmacology"") AND (""Endocrinology"" OR ""Diabetes mellitus"" OR ""Type 2 diabetes"" OR ""Insulin"" OR ""Type 2 Diabetes Mellitus"" OR ""Hypoglycemia"" OR ""Type 1 diabetes"" OR ""Insulin resistance"" OR ""Dyslipidemia"" OR ""Diabetic retinopathy"" OR ""Diabetic nephropathy"" OR ""Endocrine system""))",AND date_published>=now-10y,"AND field_of_study: ((""Medicine"" OR ""Internal medicine"" OR ""Pharmacology"") AND (""Endocrinology"" OR ""Diabetes mellitus"" OR ""Type 2 diabetes"" OR ""Insulin"" OR ""Type 2 Diabetes Mellitus"" OR ""Hypoglycemia"" OR ""Type 1 diabetes"" OR ""Insulin resistance"" OR ""Dyslipidemia"" OR ""Diabetic retinopathy"" OR ""Diabetic nephropathy"" OR ""Endocrine system""))",NA,oa_therapy_area,Pharma,Endocrinology,2020,1230,428,143,321,83,14,989,241
endocrinology (primary search + endocrinology tags) - pharma,"(author.affiliation.name:(""pfizer"" OR ""astrazeneca"" OR ""eli lilly"" OR ""merck"" OR ""emd serono"" OR ""msd"" OR ""merck sharp & dohme"" OR ""bristol myers squibb"" OR ""novartis"" OR ""roche"" OR ""hoffmann-la roche"" OR ""genentech"" OR ""johnson & johnson"" OR ""janssen"" OR ""biosense webster"" OR ""glaxosmithkline"" OR ""gsk"" OR ""abbvie"" OR ""sanofi"" OR ""sanofi-aventis"" OR ""gilead sciences"" OR ""takeda"" OR ""boehringer ingelheim"" OR ""myokardia"" OR ""amgen"" OR ""applied molecular genetics"" OR ""bayer"" OR ""vertex pharmaceuticals"" OR ""regeneron"" OR ""novo nordisk"" OR ""biogen"" OR ""biogen idec"" OR ""daiichi sankyo"" OR ""astellas pharma"" OR ""asuterasu seiyaku kabushiki-gaisha"" OR ""otsuka"" OR ""otsuka seiyaku kabushiki-gaisha"" OR ""astex pharmaceuticals"" OR ""ucb"" OR ""union chimique belge"" OR ""moderna"" OR ""eisai"" OR ""ezai kabushiki-gaisha"" OR ""ea pharma"" OR ""csl"" OR ""zlb behring"" OR ""jiangsu hengrui medicine"" OR ""teva pharmaceuticals"" OR ""sumitomo dainippon pharma"" OR ""dainippon sumitomo seiyaku kabushiki-gaisha"" OR ""fresenius"" OR ""fresenius se & co. kgaa"" OR ""viatris"" OR ""kyowa kirin"" OR ""kyowa hakko kirin"" OR ""ipsen"" OR ""jazz pharmaceuticals"" OR ""azur pharma"" OR ""sino biopharm"" OR ""bausch health companies"" OR ""valeant pharmaceuticals"" OR ""cspc pharmaceutical group"" OR ""galapagos"" OR ""galapagos genomics"" NOT ""La Roche College"") OR author.affiliation.ror_id_lineage:(""01xdqrp08"" OR ""00by1q217"" OR ""04b2dty93"" OR ""02891sr49"" OR ""03qd7mz70"" OR ""00gtmwv55"" OR ""02f9zrr09"" OR ""04r9x1a08"" OR ""01qat3289"" OR ""01xsqw823"" OR ""02g5p4n58"" OR ""02n6c9837"" OR ""056546b03"" OR ""04hjbmv12"" OR ""00q32j219"" OR ""03g03ge92"" OR ""04hmn8g73"" OR ""00anb1726"" OR ""02f51rf24"" OR ""0435rc536"" OR ""02jqkb192"" OR ""027y26122"" OR ""01cjash87"" OR ""013k5y296"" OR ""01n029866"" OR ""01xm4wg91"" OR ""04vvh7p27"" OR ""044tc0x05"" OR ""04ayvvz32"" OR ""01wfv3m53"" OR ""04sapgw72"" OR ""01v376g59"" OR ""01g1gvr46"" OR ""000wej815"" OR ""00d801g55"" OR ""055mhsv54"" OR ""0086q4c12"" OR ""01zgpn844"" OR ""016mq8947"" OR ""04e4j5d46"")) AND publication_type:""journal article"" AND date_published>=now-10y AND field_of_study: ((""Medicine"" OR ""Internal medicine"" OR ""Pharmacology"") AND (""Endocrinology"" OR ""Diabetes mellitus"" OR ""Type 2 diabetes"" OR ""Insulin"" OR ""Type 2 Diabetes Mellitus"" OR ""Hypoglycemia"" OR ""Type 1 diabetes"" OR ""Insulin resistance"" OR ""Dyslipidemia"" OR ""Diabetic retinopathy"" OR ""Diabetic nephropathy"" OR ""Endocrine system""))",AND date_published>=now-10y,"AND field_of_study: ((""Medicine"" OR ""Internal medicine"" OR ""Pharmacology"") AND (""Endocrinology"" OR ""Diabetes mellitus"" OR ""Type 2 diabetes"" OR ""Insulin"" OR ""Type 2 Diabetes Mellitus"" OR ""Hypoglycemia"" OR ""Type 1 diabetes"" OR ""Insulin resistance"" OR ""Dyslipidemia"" OR ""Diabetic retinopathy"" OR ""Diabetic nephropathy"" OR ""Endocrine system""))",NA,oa_therapy_area,Pharma,Endocrinology,2021,1175,453,74,310,61,46,944,231
endocrinology (primary search + endocrinology tags) - pharma,"(author.affiliation.name:(""pfizer"" OR ""astrazeneca"" OR ""eli lilly"" OR ""merck"" OR ""emd serono"" OR ""msd"" OR ""merck sharp & dohme"" OR ""bristol myers squibb"" OR ""novartis"" OR ""roche"" OR ""hoffmann-la roche"" OR ""genentech"" OR ""johnson & johnson"" OR ""janssen"" OR ""biosense webster"" OR ""glaxosmithkline"" OR ""gsk"" OR ""abbvie"" OR ""sanofi"" OR ""sanofi-aventis"" OR ""gilead sciences"" OR ""takeda"" OR ""boehringer ingelheim"" OR ""myokardia"" OR ""amgen"" OR ""applied molecular genetics"" OR ""bayer"" OR ""vertex pharmaceuticals"" OR ""regeneron"" OR ""novo nordisk"" OR ""biogen"" OR ""biogen idec"" OR ""daiichi sankyo"" OR ""astellas pharma"" OR ""asuterasu seiyaku kabushiki-gaisha"" OR ""otsuka"" OR ""otsuka seiyaku kabushiki-gaisha"" OR ""astex pharmaceuticals"" OR ""ucb"" OR ""union chimique belge"" OR ""moderna"" OR ""eisai"" OR ""ezai kabushiki-gaisha"" OR ""ea pharma"" OR ""csl"" OR ""zlb behring"" OR ""jiangsu hengrui medicine"" OR ""teva pharmaceuticals"" OR ""sumitomo dainippon pharma"" OR ""dainippon sumitomo seiyaku kabushiki-gaisha"" OR ""fresenius"" OR ""fresenius se & co. kgaa"" OR ""viatris"" OR ""kyowa kirin"" OR ""kyowa hakko kirin"" OR ""ipsen"" OR ""jazz pharmaceuticals"" OR ""azur pharma"" OR ""sino biopharm"" OR ""bausch health companies"" OR ""valeant pharmaceuticals"" OR ""cspc pharmaceutical group"" OR ""galapagos"" OR ""galapagos genomics"" NOT ""La Roche College"") OR author.affiliation.ror_id_lineage:(""01xdqrp08"" OR ""00by1q217"" OR ""04b2dty93"" OR ""02891sr49"" OR ""03qd7mz70"" OR ""00gtmwv55"" OR ""02f9zrr09"" OR ""04r9x1a08"" OR ""01qat3289"" OR ""01xsqw823"" OR ""02g5p4n58"" OR ""02n6c9837"" OR ""056546b03"" OR ""04hjbmv12"" OR ""00q32j219"" OR ""03g03ge92"" OR ""04hmn8g73"" OR ""00anb1726"" OR ""02f51rf24"" OR ""0435rc536"" OR ""02jqkb192"" OR ""027y26122"" OR ""01cjash87"" OR ""013k5y296"" OR ""01n029866"" OR ""01xm4wg91"" OR ""04vvh7p27"" OR ""044tc0x05"" OR ""04ayvvz32"" OR ""01wfv3m53"" OR ""04sapgw72"" OR ""01v376g59"" OR ""01g1gvr46"" OR ""000wej815"" OR ""00d801g55"" OR ""055mhsv54"" OR ""0086q4c12"" OR ""01zgpn844"" OR ""016mq8947"" OR ""04e4j5d46"")) AND publication_type:""journal article"" AND date_published>=now-10y AND field_of_study: ((""Medicine"" OR ""Internal medicine"" OR ""Pharmacology"") AND (""Endocrinology"" OR ""Diabetes mellitus"" OR ""Type 2 diabetes"" OR ""Insulin"" OR ""Type 2 Diabetes Mellitus"" OR ""Hypoglycemia"" OR ""Type 1 diabetes"" OR ""Insulin resistance"" OR ""Dyslipidemia"" OR ""Diabetic retinopathy"" OR ""Diabetic nephropathy"" OR ""Endocrine system""))",AND date_published>=now-10y,"AND field_of_study: ((""Medicine"" OR ""Internal medicine"" OR ""Pharmacology"") AND (""Endocrinology"" OR ""Diabetes mellitus"" OR ""Type 2 diabetes"" OR ""Insulin"" OR ""Type 2 Diabetes Mellitus"" OR ""Hypoglycemia"" OR ""Type 1 diabetes"" OR ""Insulin resistance"" OR ""Dyslipidemia"" OR ""Diabetic retinopathy"" OR ""Diabetic nephropathy"" OR ""Endocrine system""))",NA,oa_therapy_area,Pharma,Endocrinology,2022,1394,569,129,294,76,42,1110,284
endocrinology (primary search + endocrinology tags) - pharma,"(author.affiliation.name:(""pfizer"" OR ""astrazeneca"" OR ""eli lilly"" OR ""merck"" OR ""emd serono"" OR ""msd"" OR ""merck sharp & dohme"" OR ""bristol myers squibb"" OR ""novartis"" OR ""roche"" OR ""hoffmann-la roche"" OR ""genentech"" OR ""johnson & johnson"" OR ""janssen"" OR ""biosense webster"" OR ""glaxosmithkline"" OR ""gsk"" OR ""abbvie"" OR ""sanofi"" OR ""sanofi-aventis"" OR ""gilead sciences"" OR ""takeda"" OR ""boehringer ingelheim"" OR ""myokardia"" OR ""amgen"" OR ""applied molecular genetics"" OR ""bayer"" OR ""vertex pharmaceuticals"" OR ""regeneron"" OR ""novo nordisk"" OR ""biogen"" OR ""biogen idec"" OR ""daiichi sankyo"" OR ""astellas pharma"" OR ""asuterasu seiyaku kabushiki-gaisha"" OR ""otsuka"" OR ""otsuka seiyaku kabushiki-gaisha"" OR ""astex pharmaceuticals"" OR ""ucb"" OR ""union chimique belge"" OR ""moderna"" OR ""eisai"" OR ""ezai kabushiki-gaisha"" OR ""ea pharma"" OR ""csl"" OR ""zlb behring"" OR ""jiangsu hengrui medicine"" OR ""teva pharmaceuticals"" OR ""sumitomo dainippon pharma"" OR ""dainippon sumitomo seiyaku kabushiki-gaisha"" OR ""fresenius"" OR ""fresenius se & co. kgaa"" OR ""viatris"" OR ""kyowa kirin"" OR ""kyowa hakko kirin"" OR ""ipsen"" OR ""jazz pharmaceuticals"" OR ""azur pharma"" OR ""sino biopharm"" OR ""bausch health companies"" OR ""valeant pharmaceuticals"" OR ""cspc pharmaceutical group"" OR ""galapagos"" OR ""galapagos genomics"" NOT ""La Roche College"") OR author.affiliation.ror_id_lineage:(""01xdqrp08"" OR ""00by1q217"" OR ""04b2dty93"" OR ""02891sr49"" OR ""03qd7mz70"" OR ""00gtmwv55"" OR ""02f9zrr09"" OR ""04r9x1a08"" OR ""01qat3289"" OR ""01xsqw823"" OR ""02g5p4n58"" OR ""02n6c9837"" OR ""056546b03"" OR ""04hjbmv12"" OR ""00q32j219"" OR ""03g03ge92"" OR ""04hmn8g73"" OR ""00anb1726"" OR ""02f51rf24"" OR ""0435rc536"" OR ""02jqkb192"" OR ""027y26122"" OR ""01cjash87"" OR ""013k5y296"" OR ""01n029866"" OR ""01xm4wg91"" OR ""04vvh7p27"" OR ""044tc0x05"" OR ""04ayvvz32"" OR ""01wfv3m53"" OR ""04sapgw72"" OR ""01v376g59"" OR ""01g1gvr46"" OR ""000wej815"" OR ""00d801g55"" OR ""055mhsv54"" OR ""0086q4c12"" OR ""01zgpn844"" OR ""016mq8947"" OR ""04e4j5d46"")) AND publication_type:""journal article"" AND date_published>=now-10y AND field_of_study: ((""Medicine"" OR ""Internal medicine"" OR ""Pharmacology"") AND (""Endocrinology"" OR ""Diabetes mellitus"" OR ""Type 2 diabetes"" OR ""Insulin"" OR ""Type 2 Diabetes Mellitus"" OR ""Hypoglycemia"" OR ""Type 1 diabetes"" OR ""Insulin resistance"" OR ""Dyslipidemia"" OR ""Diabetic retinopathy"" OR ""Diabetic nephropathy"" OR ""Endocrine system""))",AND date_published>=now-10y,"AND field_of_study: ((""Medicine"" OR ""Internal medicine"" OR ""Pharmacology"") AND (""Endocrinology"" OR ""Diabetes mellitus"" OR ""Type 2 diabetes"" OR ""Insulin"" OR ""Type 2 Diabetes Mellitus"" OR ""Hypoglycemia"" OR ""Type 1 diabetes"" OR ""Insulin resistance"" OR ""Dyslipidemia"" OR ""Diabetic retinopathy"" OR ""Diabetic nephropathy"" OR ""Endocrine system""))",NA,oa_therapy_area,Pharma,Endocrinology,2023,600,233,13,122,20,74,462,138
cardiovascular (primary search + cardiovascular tags) - pharma,"(author.affiliation.name:(""pfizer"" OR ""astrazeneca"" OR ""eli lilly"" OR ""merck"" OR ""emd serono"" OR ""msd"" OR ""merck sharp & dohme"" OR ""bristol myers squibb"" OR ""novartis"" OR ""roche"" OR ""hoffmann-la roche"" OR ""genentech"" OR ""johnson & johnson"" OR ""janssen"" OR ""biosense webster"" OR ""glaxosmithkline"" OR ""gsk"" OR ""abbvie"" OR ""sanofi"" OR ""sanofi-aventis"" OR ""gilead sciences"" OR ""takeda"" OR ""boehringer ingelheim"" OR ""myokardia"" OR ""amgen"" OR ""applied molecular genetics"" OR ""bayer"" OR ""vertex pharmaceuticals"" OR ""regeneron"" OR ""novo nordisk"" OR ""biogen"" OR ""biogen idec"" OR ""daiichi sankyo"" OR ""astellas pharma"" OR ""asuterasu seiyaku kabushiki-gaisha"" OR ""otsuka"" OR ""otsuka seiyaku kabushiki-gaisha"" OR ""astex pharmaceuticals"" OR ""ucb"" OR ""union chimique belge"" OR ""moderna"" OR ""eisai"" OR ""ezai kabushiki-gaisha"" OR ""ea pharma"" OR ""csl"" OR ""zlb behring"" OR ""jiangsu hengrui medicine"" OR ""teva pharmaceuticals"" OR ""sumitomo dainippon pharma"" OR ""dainippon sumitomo seiyaku kabushiki-gaisha"" OR ""fresenius"" OR ""fresenius se & co. kgaa"" OR ""viatris"" OR ""kyowa kirin"" OR ""kyowa hakko kirin"" OR ""ipsen"" OR ""jazz pharmaceuticals"" OR ""azur pharma"" OR ""sino biopharm"" OR ""bausch health companies"" OR ""valeant pharmaceuticals"" OR ""cspc pharmaceutical group"" OR ""galapagos"" OR ""galapagos genomics"" NOT ""La Roche College"") OR author.affiliation.ror_id_lineage:(""01xdqrp08"" OR ""00by1q217"" OR ""04b2dty93"" OR ""02891sr49"" OR ""03qd7mz70"" OR ""00gtmwv55"" OR ""02f9zrr09"" OR ""04r9x1a08"" OR ""01qat3289"" OR ""01xsqw823"" OR ""02g5p4n58"" OR ""02n6c9837"" OR ""056546b03"" OR ""04hjbmv12"" OR ""00q32j219"" OR ""03g03ge92"" OR ""04hmn8g73"" OR ""00anb1726"" OR ""02f51rf24"" OR ""0435rc536"" OR ""02jqkb192"" OR ""027y26122"" OR ""01cjash87"" OR ""013k5y296"" OR ""01n029866"" OR ""01xm4wg91"" OR ""04vvh7p27"" OR ""044tc0x05"" OR ""04ayvvz32"" OR ""01wfv3m53"" OR ""04sapgw72"" OR ""01v376g59"" OR ""01g1gvr46"" OR ""000wej815"" OR ""00d801g55"" OR ""055mhsv54"" OR ""0086q4c12"" OR ""01zgpn844"" OR ""016mq8947"" OR ""04e4j5d46"")) AND publication_type:""journal article"" AND date_published>=now-10y AND field_of_study: ((""Medicine"" OR ""Internal medicine"" OR ""Pharmacology"") AND (""Cardiology"" OR ""Heart failure"" OR ""Atrial fibrillation"" OR ""Myocardial infarction"" OR ""Stroke"" OR ""Blood pressure"" OR ""Acute coronary syndrome"" OR ""Coronary artery disease"" OR ""Thrombosis"" OR ""QT interval"" OR ""Heart rate"" OR ""Heart failure with preserved ejection fraction"" OR ""Cardiomyopathy""))",AND date_published>=now-10y,"AND field_of_study: ((""Medicine"" OR ""Internal medicine"" OR ""Pharmacology"") AND (""Cardiology"" OR ""Heart failure"" OR ""Atrial fibrillation"" OR ""Myocardial infarction"" OR ""Stroke"" OR ""Blood pressure"" OR ""Acute coronary syndrome"" OR ""Coronary artery disease"" OR ""Thrombosis"" OR ""QT interval"" OR ""Heart rate"" OR ""Heart failure with preserved ejection fraction"" OR ""Cardiomyopathy""))",NA,oa_therapy_area,Pharma,Cardiovascular,2013,265,42,40,26,29,11,148,117
cardiovascular (primary search + cardiovascular tags) - pharma,"(author.affiliation.name:(""pfizer"" OR ""astrazeneca"" OR ""eli lilly"" OR ""merck"" OR ""emd serono"" OR ""msd"" OR ""merck sharp & dohme"" OR ""bristol myers squibb"" OR ""novartis"" OR ""roche"" OR ""hoffmann-la roche"" OR ""genentech"" OR ""johnson & johnson"" OR ""janssen"" OR ""biosense webster"" OR ""glaxosmithkline"" OR ""gsk"" OR ""abbvie"" OR ""sanofi"" OR ""sanofi-aventis"" OR ""gilead sciences"" OR ""takeda"" OR ""boehringer ingelheim"" OR ""myokardia"" OR ""amgen"" OR ""applied molecular genetics"" OR ""bayer"" OR ""vertex pharmaceuticals"" OR ""regeneron"" OR ""novo nordisk"" OR ""biogen"" OR ""biogen idec"" OR ""daiichi sankyo"" OR ""astellas pharma"" OR ""asuterasu seiyaku kabushiki-gaisha"" OR ""otsuka"" OR ""otsuka seiyaku kabushiki-gaisha"" OR ""astex pharmaceuticals"" OR ""ucb"" OR ""union chimique belge"" OR ""moderna"" OR ""eisai"" OR ""ezai kabushiki-gaisha"" OR ""ea pharma"" OR ""csl"" OR ""zlb behring"" OR ""jiangsu hengrui medicine"" OR ""teva pharmaceuticals"" OR ""sumitomo dainippon pharma"" OR ""dainippon sumitomo seiyaku kabushiki-gaisha"" OR ""fresenius"" OR ""fresenius se & co. kgaa"" OR ""viatris"" OR ""kyowa kirin"" OR ""kyowa hakko kirin"" OR ""ipsen"" OR ""jazz pharmaceuticals"" OR ""azur pharma"" OR ""sino biopharm"" OR ""bausch health companies"" OR ""valeant pharmaceuticals"" OR ""cspc pharmaceutical group"" OR ""galapagos"" OR ""galapagos genomics"" NOT ""La Roche College"") OR author.affiliation.ror_id_lineage:(""01xdqrp08"" OR ""00by1q217"" OR ""04b2dty93"" OR ""02891sr49"" OR ""03qd7mz70"" OR ""00gtmwv55"" OR ""02f9zrr09"" OR ""04r9x1a08"" OR ""01qat3289"" OR ""01xsqw823"" OR ""02g5p4n58"" OR ""02n6c9837"" OR ""056546b03"" OR ""04hjbmv12"" OR ""00q32j219"" OR ""03g03ge92"" OR ""04hmn8g73"" OR ""00anb1726"" OR ""02f51rf24"" OR ""0435rc536"" OR ""02jqkb192"" OR ""027y26122"" OR ""01cjash87"" OR ""013k5y296"" OR ""01n029866"" OR ""01xm4wg91"" OR ""04vvh7p27"" OR ""044tc0x05"" OR ""04ayvvz32"" OR ""01wfv3m53"" OR ""04sapgw72"" OR ""01v376g59"" OR ""01g1gvr46"" OR ""000wej815"" OR ""00d801g55"" OR ""055mhsv54"" OR ""0086q4c12"" OR ""01zgpn844"" OR ""016mq8947"" OR ""04e4j5d46"")) AND publication_type:""journal article"" AND date_published>=now-10y AND field_of_study: ((""Medicine"" OR ""Internal medicine"" OR ""Pharmacology"") AND (""Cardiology"" OR ""Heart failure"" OR ""Atrial fibrillation"" OR ""Myocardial infarction"" OR ""Stroke"" OR ""Blood pressure"" OR ""Acute coronary syndrome"" OR ""Coronary artery disease"" OR ""Thrombosis"" OR ""QT interval"" OR ""Heart rate"" OR ""Heart failure with preserved ejection fraction"" OR ""Cardiomyopathy""))",AND date_published>=now-10y,"AND field_of_study: ((""Medicine"" OR ""Internal medicine"" OR ""Pharmacology"") AND (""Cardiology"" OR ""Heart failure"" OR ""Atrial fibrillation"" OR ""Myocardial infarction"" OR ""Stroke"" OR ""Blood pressure"" OR ""Acute coronary syndrome"" OR ""Coronary artery disease"" OR ""Thrombosis"" OR ""QT interval"" OR ""Heart rate"" OR ""Heart failure with preserved ejection fraction"" OR ""Cardiomyopathy""))",NA,oa_therapy_area,Pharma,Cardiovascular,2014,757,121,77,64,74,45,381,376
cardiovascular (primary search + cardiovascular tags) - pharma,"(author.affiliation.name:(""pfizer"" OR ""astrazeneca"" OR ""eli lilly"" OR ""merck"" OR ""emd serono"" OR ""msd"" OR ""merck sharp & dohme"" OR ""bristol myers squibb"" OR ""novartis"" OR ""roche"" OR ""hoffmann-la roche"" OR ""genentech"" OR ""johnson & johnson"" OR ""janssen"" OR ""biosense webster"" OR ""glaxosmithkline"" OR ""gsk"" OR ""abbvie"" OR ""sanofi"" OR ""sanofi-aventis"" OR ""gilead sciences"" OR ""takeda"" OR ""boehringer ingelheim"" OR ""myokardia"" OR ""amgen"" OR ""applied molecular genetics"" OR ""bayer"" OR ""vertex pharmaceuticals"" OR ""regeneron"" OR ""novo nordisk"" OR ""biogen"" OR ""biogen idec"" OR ""daiichi sankyo"" OR ""astellas pharma"" OR ""asuterasu seiyaku kabushiki-gaisha"" OR ""otsuka"" OR ""otsuka seiyaku kabushiki-gaisha"" OR ""astex pharmaceuticals"" OR ""ucb"" OR ""union chimique belge"" OR ""moderna"" OR ""eisai"" OR ""ezai kabushiki-gaisha"" OR ""ea pharma"" OR ""csl"" OR ""zlb behring"" OR ""jiangsu hengrui medicine"" OR ""teva pharmaceuticals"" OR ""sumitomo dainippon pharma"" OR ""dainippon sumitomo seiyaku kabushiki-gaisha"" OR ""fresenius"" OR ""fresenius se & co. kgaa"" OR ""viatris"" OR ""kyowa kirin"" OR ""kyowa hakko kirin"" OR ""ipsen"" OR ""jazz pharmaceuticals"" OR ""azur pharma"" OR ""sino biopharm"" OR ""bausch health companies"" OR ""valeant pharmaceuticals"" OR ""cspc pharmaceutical group"" OR ""galapagos"" OR ""galapagos genomics"" NOT ""La Roche College"") OR author.affiliation.ror_id_lineage:(""01xdqrp08"" OR ""00by1q217"" OR ""04b2dty93"" OR ""02891sr49"" OR ""03qd7mz70"" OR ""00gtmwv55"" OR ""02f9zrr09"" OR ""04r9x1a08"" OR ""01qat3289"" OR ""01xsqw823"" OR ""02g5p4n58"" OR ""02n6c9837"" OR ""056546b03"" OR ""04hjbmv12"" OR ""00q32j219"" OR ""03g03ge92"" OR ""04hmn8g73"" OR ""00anb1726"" OR ""02f51rf24"" OR ""0435rc536"" OR ""02jqkb192"" OR ""027y26122"" OR ""01cjash87"" OR ""013k5y296"" OR ""01n029866"" OR ""01xm4wg91"" OR ""04vvh7p27"" OR ""044tc0x05"" OR ""04ayvvz32"" OR ""01wfv3m53"" OR ""04sapgw72"" OR ""01v376g59"" OR ""01g1gvr46"" OR ""000wej815"" OR ""00d801g55"" OR ""055mhsv54"" OR ""0086q4c12"" OR ""01zgpn844"" OR ""016mq8947"" OR ""04e4j5d46"")) AND publication_type:""journal article"" AND date_published>=now-10y AND field_of_study: ((""Medicine"" OR ""Internal medicine"" OR ""Pharmacology"") AND (""Cardiology"" OR ""Heart failure"" OR ""Atrial fibrillation"" OR ""Myocardial infarction"" OR ""Stroke"" OR ""Blood pressure"" OR ""Acute coronary syndrome"" OR ""Coronary artery disease"" OR ""Thrombosis"" OR ""QT interval"" OR ""Heart rate"" OR ""Heart failure with preserved ejection fraction"" OR ""Cardiomyopathy""))",AND date_published>=now-10y,"AND field_of_study: ((""Medicine"" OR ""Internal medicine"" OR ""Pharmacology"") AND (""Cardiology"" OR ""Heart failure"" OR ""Atrial fibrillation"" OR ""Myocardial infarction"" OR ""Stroke"" OR ""Blood pressure"" OR ""Acute coronary syndrome"" OR ""Coronary artery disease"" OR ""Thrombosis"" OR ""QT interval"" OR ""Heart rate"" OR ""Heart failure with preserved ejection fraction"" OR ""Cardiomyopathy""))",NA,oa_therapy_area,Pharma,Cardiovascular,2015,727,127,76,93,78,15,389,338
cardiovascular (primary search + cardiovascular tags) - pharma,"(author.affiliation.name:(""pfizer"" OR ""astrazeneca"" OR ""eli lilly"" OR ""merck"" OR ""emd serono"" OR ""msd"" OR ""merck sharp & dohme"" OR ""bristol myers squibb"" OR ""novartis"" OR ""roche"" OR ""hoffmann-la roche"" OR ""genentech"" OR ""johnson & johnson"" OR ""janssen"" OR ""biosense webster"" OR ""glaxosmithkline"" OR ""gsk"" OR ""abbvie"" OR ""sanofi"" OR ""sanofi-aventis"" OR ""gilead sciences"" OR ""takeda"" OR ""boehringer ingelheim"" OR ""myokardia"" OR ""amgen"" OR ""applied molecular genetics"" OR ""bayer"" OR ""vertex pharmaceuticals"" OR ""regeneron"" OR ""novo nordisk"" OR ""biogen"" OR ""biogen idec"" OR ""daiichi sankyo"" OR ""astellas pharma"" OR ""asuterasu seiyaku kabushiki-gaisha"" OR ""otsuka"" OR ""otsuka seiyaku kabushiki-gaisha"" OR ""astex pharmaceuticals"" OR ""ucb"" OR ""union chimique belge"" OR ""moderna"" OR ""eisai"" OR ""ezai kabushiki-gaisha"" OR ""ea pharma"" OR ""csl"" OR ""zlb behring"" OR ""jiangsu hengrui medicine"" OR ""teva pharmaceuticals"" OR ""sumitomo dainippon pharma"" OR ""dainippon sumitomo seiyaku kabushiki-gaisha"" OR ""fresenius"" OR ""fresenius se & co. kgaa"" OR ""viatris"" OR ""kyowa kirin"" OR ""kyowa hakko kirin"" OR ""ipsen"" OR ""jazz pharmaceuticals"" OR ""azur pharma"" OR ""sino biopharm"" OR ""bausch health companies"" OR ""valeant pharmaceuticals"" OR ""cspc pharmaceutical group"" OR ""galapagos"" OR ""galapagos genomics"" NOT ""La Roche College"") OR author.affiliation.ror_id_lineage:(""01xdqrp08"" OR ""00by1q217"" OR ""04b2dty93"" OR ""02891sr49"" OR ""03qd7mz70"" OR ""00gtmwv55"" OR ""02f9zrr09"" OR ""04r9x1a08"" OR ""01qat3289"" OR ""01xsqw823"" OR ""02g5p4n58"" OR ""02n6c9837"" OR ""056546b03"" OR ""04hjbmv12"" OR ""00q32j219"" OR ""03g03ge92"" OR ""04hmn8g73"" OR ""00anb1726"" OR ""02f51rf24"" OR ""0435rc536"" OR ""02jqkb192"" OR ""027y26122"" OR ""01cjash87"" OR ""013k5y296"" OR ""01n029866"" OR ""01xm4wg91"" OR ""04vvh7p27"" OR ""044tc0x05"" OR ""04ayvvz32"" OR ""01wfv3m53"" OR ""04sapgw72"" OR ""01v376g59"" OR ""01g1gvr46"" OR ""000wej815"" OR ""00d801g55"" OR ""055mhsv54"" OR ""0086q4c12"" OR ""01zgpn844"" OR ""016mq8947"" OR ""04e4j5d46"")) AND publication_type:""journal article"" AND date_published>=now-10y AND field_of_study: ((""Medicine"" OR ""Internal medicine"" OR ""Pharmacology"") AND (""Cardiology"" OR ""Heart failure"" OR ""Atrial fibrillation"" OR ""Myocardial infarction"" OR ""Stroke"" OR ""Blood pressure"" OR ""Acute coronary syndrome"" OR ""Coronary artery disease"" OR ""Thrombosis"" OR ""QT interval"" OR ""Heart rate"" OR ""Heart failure with preserved ejection fraction"" OR ""Cardiomyopathy""))",AND date_published>=now-10y,"AND field_of_study: ((""Medicine"" OR ""Internal medicine"" OR ""Pharmacology"") AND (""Cardiology"" OR ""Heart failure"" OR ""Atrial fibrillation"" OR ""Myocardial infarction"" OR ""Stroke"" OR ""Blood pressure"" OR ""Acute coronary syndrome"" OR ""Coronary artery disease"" OR ""Thrombosis"" OR ""QT interval"" OR ""Heart rate"" OR ""Heart failure with preserved ejection fraction"" OR ""Cardiomyopathy""))",NA,oa_therapy_area,Pharma,Cardiovascular,2016,764,160,80,113,66,28,447,317
cardiovascular (primary search + cardiovascular tags) - pharma,"(author.affiliation.name:(""pfizer"" OR ""astrazeneca"" OR ""eli lilly"" OR ""merck"" OR ""emd serono"" OR ""msd"" OR ""merck sharp & dohme"" OR ""bristol myers squibb"" OR ""novartis"" OR ""roche"" OR ""hoffmann-la roche"" OR ""genentech"" OR ""johnson & johnson"" OR ""janssen"" OR ""biosense webster"" OR ""glaxosmithkline"" OR ""gsk"" OR ""abbvie"" OR ""sanofi"" OR ""sanofi-aventis"" OR ""gilead sciences"" OR ""takeda"" OR ""boehringer ingelheim"" OR ""myokardia"" OR ""amgen"" OR ""applied molecular genetics"" OR ""bayer"" OR ""vertex pharmaceuticals"" OR ""regeneron"" OR ""novo nordisk"" OR ""biogen"" OR ""biogen idec"" OR ""daiichi sankyo"" OR ""astellas pharma"" OR ""asuterasu seiyaku kabushiki-gaisha"" OR ""otsuka"" OR ""otsuka seiyaku kabushiki-gaisha"" OR ""astex pharmaceuticals"" OR ""ucb"" OR ""union chimique belge"" OR ""moderna"" OR ""eisai"" OR ""ezai kabushiki-gaisha"" OR ""ea pharma"" OR ""csl"" OR ""zlb behring"" OR ""jiangsu hengrui medicine"" OR ""teva pharmaceuticals"" OR ""sumitomo dainippon pharma"" OR ""dainippon sumitomo seiyaku kabushiki-gaisha"" OR ""fresenius"" OR ""fresenius se & co. kgaa"" OR ""viatris"" OR ""kyowa kirin"" OR ""kyowa hakko kirin"" OR ""ipsen"" OR ""jazz pharmaceuticals"" OR ""azur pharma"" OR ""sino biopharm"" OR ""bausch health companies"" OR ""valeant pharmaceuticals"" OR ""cspc pharmaceutical group"" OR ""galapagos"" OR ""galapagos genomics"" NOT ""La Roche College"") OR author.affiliation.ror_id_lineage:(""01xdqrp08"" OR ""00by1q217"" OR ""04b2dty93"" OR ""02891sr49"" OR ""03qd7mz70"" OR ""00gtmwv55"" OR ""02f9zrr09"" OR ""04r9x1a08"" OR ""01qat3289"" OR ""01xsqw823"" OR ""02g5p4n58"" OR ""02n6c9837"" OR ""056546b03"" OR ""04hjbmv12"" OR ""00q32j219"" OR ""03g03ge92"" OR ""04hmn8g73"" OR ""00anb1726"" OR ""02f51rf24"" OR ""0435rc536"" OR ""02jqkb192"" OR ""027y26122"" OR ""01cjash87"" OR ""013k5y296"" OR ""01n029866"" OR ""01xm4wg91"" OR ""04vvh7p27"" OR ""044tc0x05"" OR ""04ayvvz32"" OR ""01wfv3m53"" OR ""04sapgw72"" OR ""01v376g59"" OR ""01g1gvr46"" OR ""000wej815"" OR ""00d801g55"" OR ""055mhsv54"" OR ""0086q4c12"" OR ""01zgpn844"" OR ""016mq8947"" OR ""04e4j5d46"")) AND publication_type:""journal article"" AND date_published>=now-10y AND field_of_study: ((""Medicine"" OR ""Internal medicine"" OR ""Pharmacology"") AND (""Cardiology"" OR ""Heart failure"" OR ""Atrial fibrillation"" OR ""Myocardial infarction"" OR ""Stroke"" OR ""Blood pressure"" OR ""Acute coronary syndrome"" OR ""Coronary artery disease"" OR ""Thrombosis"" OR ""QT interval"" OR ""Heart rate"" OR ""Heart failure with preserved ejection fraction"" OR ""Cardiomyopathy""))",AND date_published>=now-10y,"AND field_of_study: ((""Medicine"" OR ""Internal medicine"" OR ""Pharmacology"") AND (""Cardiology"" OR ""Heart failure"" OR ""Atrial fibrillation"" OR ""Myocardial infarction"" OR ""Stroke"" OR ""Blood pressure"" OR ""Acute coronary syndrome"" OR ""Coronary artery disease"" OR ""Thrombosis"" OR ""QT interval"" OR ""Heart rate"" OR ""Heart failure with preserved ejection fraction"" OR ""Cardiomyopathy""))",NA,oa_therapy_area,Pharma,Cardiovascular,2017,720,163,112,104,108,33,520,200
cardiovascular (primary search + cardiovascular tags) - pharma,"(author.affiliation.name:(""pfizer"" OR ""astrazeneca"" OR ""eli lilly"" OR ""merck"" OR ""emd serono"" OR ""msd"" OR ""merck sharp & dohme"" OR ""bristol myers squibb"" OR ""novartis"" OR ""roche"" OR ""hoffmann-la roche"" OR ""genentech"" OR ""johnson & johnson"" OR ""janssen"" OR ""biosense webster"" OR ""glaxosmithkline"" OR ""gsk"" OR ""abbvie"" OR ""sanofi"" OR ""sanofi-aventis"" OR ""gilead sciences"" OR ""takeda"" OR ""boehringer ingelheim"" OR ""myokardia"" OR ""amgen"" OR ""applied molecular genetics"" OR ""bayer"" OR ""vertex pharmaceuticals"" OR ""regeneron"" OR ""novo nordisk"" OR ""biogen"" OR ""biogen idec"" OR ""daiichi sankyo"" OR ""astellas pharma"" OR ""asuterasu seiyaku kabushiki-gaisha"" OR ""otsuka"" OR ""otsuka seiyaku kabushiki-gaisha"" OR ""astex pharmaceuticals"" OR ""ucb"" OR ""union chimique belge"" OR ""moderna"" OR ""eisai"" OR ""ezai kabushiki-gaisha"" OR ""ea pharma"" OR ""csl"" OR ""zlb behring"" OR ""jiangsu hengrui medicine"" OR ""teva pharmaceuticals"" OR ""sumitomo dainippon pharma"" OR ""dainippon sumitomo seiyaku kabushiki-gaisha"" OR ""fresenius"" OR ""fresenius se & co. kgaa"" OR ""viatris"" OR ""kyowa kirin"" OR ""kyowa hakko kirin"" OR ""ipsen"" OR ""jazz pharmaceuticals"" OR ""azur pharma"" OR ""sino biopharm"" OR ""bausch health companies"" OR ""valeant pharmaceuticals"" OR ""cspc pharmaceutical group"" OR ""galapagos"" OR ""galapagos genomics"" NOT ""La Roche College"") OR author.affiliation.ror_id_lineage:(""01xdqrp08"" OR ""00by1q217"" OR ""04b2dty93"" OR ""02891sr49"" OR ""03qd7mz70"" OR ""00gtmwv55"" OR ""02f9zrr09"" OR ""04r9x1a08"" OR ""01qat3289"" OR ""01xsqw823"" OR ""02g5p4n58"" OR ""02n6c9837"" OR ""056546b03"" OR ""04hjbmv12"" OR ""00q32j219"" OR ""03g03ge92"" OR ""04hmn8g73"" OR ""00anb1726"" OR ""02f51rf24"" OR ""0435rc536"" OR ""02jqkb192"" OR ""027y26122"" OR ""01cjash87"" OR ""013k5y296"" OR ""01n029866"" OR ""01xm4wg91"" OR ""04vvh7p27"" OR ""044tc0x05"" OR ""04ayvvz32"" OR ""01wfv3m53"" OR ""04sapgw72"" OR ""01v376g59"" OR ""01g1gvr46"" OR ""000wej815"" OR ""00d801g55"" OR ""055mhsv54"" OR ""0086q4c12"" OR ""01zgpn844"" OR ""016mq8947"" OR ""04e4j5d46"")) AND publication_type:""journal article"" AND date_published>=now-10y AND field_of_study: ((""Medicine"" OR ""Internal medicine"" OR ""Pharmacology"") AND (""Cardiology"" OR ""Heart failure"" OR ""Atrial fibrillation"" OR ""Myocardial infarction"" OR ""Stroke"" OR ""Blood pressure"" OR ""Acute coronary syndrome"" OR ""Coronary artery disease"" OR ""Thrombosis"" OR ""QT interval"" OR ""Heart rate"" OR ""Heart failure with preserved ejection fraction"" OR ""Cardiomyopathy""))",AND date_published>=now-10y,"AND field_of_study: ((""Medicine"" OR ""Internal medicine"" OR ""Pharmacology"") AND (""Cardiology"" OR ""Heart failure"" OR ""Atrial fibrillation"" OR ""Myocardial infarction"" OR ""Stroke"" OR ""Blood pressure"" OR ""Acute coronary syndrome"" OR ""Coronary artery disease"" OR ""Thrombosis"" OR ""QT interval"" OR ""Heart rate"" OR ""Heart failure with preserved ejection fraction"" OR ""Cardiomyopathy""))",NA,oa_therapy_area,Pharma,Cardiovascular,2018,752,197,94,114,119,24,548,204
cardiovascular (primary search + cardiovascular tags) - pharma,"(author.affiliation.name:(""pfizer"" OR ""astrazeneca"" OR ""eli lilly"" OR ""merck"" OR ""emd serono"" OR ""msd"" OR ""merck sharp & dohme"" OR ""bristol myers squibb"" OR ""novartis"" OR ""roche"" OR ""hoffmann-la roche"" OR ""genentech"" OR ""johnson & johnson"" OR ""janssen"" OR ""biosense webster"" OR ""glaxosmithkline"" OR ""gsk"" OR ""abbvie"" OR ""sanofi"" OR ""sanofi-aventis"" OR ""gilead sciences"" OR ""takeda"" OR ""boehringer ingelheim"" OR ""myokardia"" OR ""amgen"" OR ""applied molecular genetics"" OR ""bayer"" OR ""vertex pharmaceuticals"" OR ""regeneron"" OR ""novo nordisk"" OR ""biogen"" OR ""biogen idec"" OR ""daiichi sankyo"" OR ""astellas pharma"" OR ""asuterasu seiyaku kabushiki-gaisha"" OR ""otsuka"" OR ""otsuka seiyaku kabushiki-gaisha"" OR ""astex pharmaceuticals"" OR ""ucb"" OR ""union chimique belge"" OR ""moderna"" OR ""eisai"" OR ""ezai kabushiki-gaisha"" OR ""ea pharma"" OR ""csl"" OR ""zlb behring"" OR ""jiangsu hengrui medicine"" OR ""teva pharmaceuticals"" OR ""sumitomo dainippon pharma"" OR ""dainippon sumitomo seiyaku kabushiki-gaisha"" OR ""fresenius"" OR ""fresenius se & co. kgaa"" OR ""viatris"" OR ""kyowa kirin"" OR ""kyowa hakko kirin"" OR ""ipsen"" OR ""jazz pharmaceuticals"" OR ""azur pharma"" OR ""sino biopharm"" OR ""bausch health companies"" OR ""valeant pharmaceuticals"" OR ""cspc pharmaceutical group"" OR ""galapagos"" OR ""galapagos genomics"" NOT ""La Roche College"") OR author.affiliation.ror_id_lineage:(""01xdqrp08"" OR ""00by1q217"" OR ""04b2dty93"" OR ""02891sr49"" OR ""03qd7mz70"" OR ""00gtmwv55"" OR ""02f9zrr09"" OR ""04r9x1a08"" OR ""01qat3289"" OR ""01xsqw823"" OR ""02g5p4n58"" OR ""02n6c9837"" OR ""056546b03"" OR ""04hjbmv12"" OR ""00q32j219"" OR ""03g03ge92"" OR ""04hmn8g73"" OR ""00anb1726"" OR ""02f51rf24"" OR ""0435rc536"" OR ""02jqkb192"" OR ""027y26122"" OR ""01cjash87"" OR ""013k5y296"" OR ""01n029866"" OR ""01xm4wg91"" OR ""04vvh7p27"" OR ""044tc0x05"" OR ""04ayvvz32"" OR ""01wfv3m53"" OR ""04sapgw72"" OR ""01v376g59"" OR ""01g1gvr46"" OR ""000wej815"" OR ""00d801g55"" OR ""055mhsv54"" OR ""0086q4c12"" OR ""01zgpn844"" OR ""016mq8947"" OR ""04e4j5d46"")) AND publication_type:""journal article"" AND date_published>=now-10y AND field_of_study: ((""Medicine"" OR ""Internal medicine"" OR ""Pharmacology"") AND (""Cardiology"" OR ""Heart failure"" OR ""Atrial fibrillation"" OR ""Myocardial infarction"" OR ""Stroke"" OR ""Blood pressure"" OR ""Acute coronary syndrome"" OR ""Coronary artery disease"" OR ""Thrombosis"" OR ""QT interval"" OR ""Heart rate"" OR ""Heart failure with preserved ejection fraction"" OR ""Cardiomyopathy""))",AND date_published>=now-10y,"AND field_of_study: ((""Medicine"" OR ""Internal medicine"" OR ""Pharmacology"") AND (""Cardiology"" OR ""Heart failure"" OR ""Atrial fibrillation"" OR ""Myocardial infarction"" OR ""Stroke"" OR ""Blood pressure"" OR ""Acute coronary syndrome"" OR ""Coronary artery disease"" OR ""Thrombosis"" OR ""QT interval"" OR ""Heart rate"" OR ""Heart failure with preserved ejection fraction"" OR ""Cardiomyopathy""))",NA,oa_therapy_area,Pharma,Cardiovascular,2019,801,194,100,158,72,21,545,256
cardiovascular (primary search + cardiovascular tags) - pharma,"(author.affiliation.name:(""pfizer"" OR ""astrazeneca"" OR ""eli lilly"" OR ""merck"" OR ""emd serono"" OR ""msd"" OR ""merck sharp & dohme"" OR ""bristol myers squibb"" OR ""novartis"" OR ""roche"" OR ""hoffmann-la roche"" OR ""genentech"" OR ""johnson & johnson"" OR ""janssen"" OR ""biosense webster"" OR ""glaxosmithkline"" OR ""gsk"" OR ""abbvie"" OR ""sanofi"" OR ""sanofi-aventis"" OR ""gilead sciences"" OR ""takeda"" OR ""boehringer ingelheim"" OR ""myokardia"" OR ""amgen"" OR ""applied molecular genetics"" OR ""bayer"" OR ""vertex pharmaceuticals"" OR ""regeneron"" OR ""novo nordisk"" OR ""biogen"" OR ""biogen idec"" OR ""daiichi sankyo"" OR ""astellas pharma"" OR ""asuterasu seiyaku kabushiki-gaisha"" OR ""otsuka"" OR ""otsuka seiyaku kabushiki-gaisha"" OR ""astex pharmaceuticals"" OR ""ucb"" OR ""union chimique belge"" OR ""moderna"" OR ""eisai"" OR ""ezai kabushiki-gaisha"" OR ""ea pharma"" OR ""csl"" OR ""zlb behring"" OR ""jiangsu hengrui medicine"" OR ""teva pharmaceuticals"" OR ""sumitomo dainippon pharma"" OR ""dainippon sumitomo seiyaku kabushiki-gaisha"" OR ""fresenius"" OR ""fresenius se & co. kgaa"" OR ""viatris"" OR ""kyowa kirin"" OR ""kyowa hakko kirin"" OR ""ipsen"" OR ""jazz pharmaceuticals"" OR ""azur pharma"" OR ""sino biopharm"" OR ""bausch health companies"" OR ""valeant pharmaceuticals"" OR ""cspc pharmaceutical group"" OR ""galapagos"" OR ""galapagos genomics"" NOT ""La Roche College"") OR author.affiliation.ror_id_lineage:(""01xdqrp08"" OR ""00by1q217"" OR ""04b2dty93"" OR ""02891sr49"" OR ""03qd7mz70"" OR ""00gtmwv55"" OR ""02f9zrr09"" OR ""04r9x1a08"" OR ""01qat3289"" OR ""01xsqw823"" OR ""02g5p4n58"" OR ""02n6c9837"" OR ""056546b03"" OR ""04hjbmv12"" OR ""00q32j219"" OR ""03g03ge92"" OR ""04hmn8g73"" OR ""00anb1726"" OR ""02f51rf24"" OR ""0435rc536"" OR ""02jqkb192"" OR ""027y26122"" OR ""01cjash87"" OR ""013k5y296"" OR ""01n029866"" OR ""01xm4wg91"" OR ""04vvh7p27"" OR ""044tc0x05"" OR ""04ayvvz32"" OR ""01wfv3m53"" OR ""04sapgw72"" OR ""01v376g59"" OR ""01g1gvr46"" OR ""000wej815"" OR ""00d801g55"" OR ""055mhsv54"" OR ""0086q4c12"" OR ""01zgpn844"" OR ""016mq8947"" OR ""04e4j5d46"")) AND publication_type:""journal article"" AND date_published>=now-10y AND field_of_study: ((""Medicine"" OR ""Internal medicine"" OR ""Pharmacology"") AND (""Cardiology"" OR ""Heart failure"" OR ""Atrial fibrillation"" OR ""Myocardial infarction"" OR ""Stroke"" OR ""Blood pressure"" OR ""Acute coronary syndrome"" OR ""Coronary artery disease"" OR ""Thrombosis"" OR ""QT interval"" OR ""Heart rate"" OR ""Heart failure with preserved ejection fraction"" OR ""Cardiomyopathy""))",AND date_published>=now-10y,"AND field_of_study: ((""Medicine"" OR ""Internal medicine"" OR ""Pharmacology"") AND (""Cardiology"" OR ""Heart failure"" OR ""Atrial fibrillation"" OR ""Myocardial infarction"" OR ""Stroke"" OR ""Blood pressure"" OR ""Acute coronary syndrome"" OR ""Coronary artery disease"" OR ""Thrombosis"" OR ""QT interval"" OR ""Heart rate"" OR ""Heart failure with preserved ejection fraction"" OR ""Cardiomyopathy""))",NA,oa_therapy_area,Pharma,Cardiovascular,2020,1024,271,108,243,105,18,745,279
cardiovascular (primary search + cardiovascular tags) - pharma,"(author.affiliation.name:(""pfizer"" OR ""astrazeneca"" OR ""eli lilly"" OR ""merck"" OR ""emd serono"" OR ""msd"" OR ""merck sharp & dohme"" OR ""bristol myers squibb"" OR ""novartis"" OR ""roche"" OR ""hoffmann-la roche"" OR ""genentech"" OR ""johnson & johnson"" OR ""janssen"" OR ""biosense webster"" OR ""glaxosmithkline"" OR ""gsk"" OR ""abbvie"" OR ""sanofi"" OR ""sanofi-aventis"" OR ""gilead sciences"" OR ""takeda"" OR ""boehringer ingelheim"" OR ""myokardia"" OR ""amgen"" OR ""applied molecular genetics"" OR ""bayer"" OR ""vertex pharmaceuticals"" OR ""regeneron"" OR ""novo nordisk"" OR ""biogen"" OR ""biogen idec"" OR ""daiichi sankyo"" OR ""astellas pharma"" OR ""asuterasu seiyaku kabushiki-gaisha"" OR ""otsuka"" OR ""otsuka seiyaku kabushiki-gaisha"" OR ""astex pharmaceuticals"" OR ""ucb"" OR ""union chimique belge"" OR ""moderna"" OR ""eisai"" OR ""ezai kabushiki-gaisha"" OR ""ea pharma"" OR ""csl"" OR ""zlb behring"" OR ""jiangsu hengrui medicine"" OR ""teva pharmaceuticals"" OR ""sumitomo dainippon pharma"" OR ""dainippon sumitomo seiyaku kabushiki-gaisha"" OR ""fresenius"" OR ""fresenius se & co. kgaa"" OR ""viatris"" OR ""kyowa kirin"" OR ""kyowa hakko kirin"" OR ""ipsen"" OR ""jazz pharmaceuticals"" OR ""azur pharma"" OR ""sino biopharm"" OR ""bausch health companies"" OR ""valeant pharmaceuticals"" OR ""cspc pharmaceutical group"" OR ""galapagos"" OR ""galapagos genomics"" NOT ""La Roche College"") OR author.affiliation.ror_id_lineage:(""01xdqrp08"" OR ""00by1q217"" OR ""04b2dty93"" OR ""02891sr49"" OR ""03qd7mz70"" OR ""00gtmwv55"" OR ""02f9zrr09"" OR ""04r9x1a08"" OR ""01qat3289"" OR ""01xsqw823"" OR ""02g5p4n58"" OR ""02n6c9837"" OR ""056546b03"" OR ""04hjbmv12"" OR ""00q32j219"" OR ""03g03ge92"" OR ""04hmn8g73"" OR ""00anb1726"" OR ""02f51rf24"" OR ""0435rc536"" OR ""02jqkb192"" OR ""027y26122"" OR ""01cjash87"" OR ""013k5y296"" OR ""01n029866"" OR ""01xm4wg91"" OR ""04vvh7p27"" OR ""044tc0x05"" OR ""04ayvvz32"" OR ""01wfv3m53"" OR ""04sapgw72"" OR ""01v376g59"" OR ""01g1gvr46"" OR ""000wej815"" OR ""00d801g55"" OR ""055mhsv54"" OR ""0086q4c12"" OR ""01zgpn844"" OR ""016mq8947"" OR ""04e4j5d46"")) AND publication_type:""journal article"" AND date_published>=now-10y AND field_of_study: ((""Medicine"" OR ""Internal medicine"" OR ""Pharmacology"") AND (""Cardiology"" OR ""Heart failure"" OR ""Atrial fibrillation"" OR ""Myocardial infarction"" OR ""Stroke"" OR ""Blood pressure"" OR ""Acute coronary syndrome"" OR ""Coronary artery disease"" OR ""Thrombosis"" OR ""QT interval"" OR ""Heart rate"" OR ""Heart failure with preserved ejection fraction"" OR ""Cardiomyopathy""))",AND date_published>=now-10y,"AND field_of_study: ((""Medicine"" OR ""Internal medicine"" OR ""Pharmacology"") AND (""Cardiology"" OR ""Heart failure"" OR ""Atrial fibrillation"" OR ""Myocardial infarction"" OR ""Stroke"" OR ""Blood pressure"" OR ""Acute coronary syndrome"" OR ""Coronary artery disease"" OR ""Thrombosis"" OR ""QT interval"" OR ""Heart rate"" OR ""Heart failure with preserved ejection fraction"" OR ""Cardiomyopathy""))",NA,oa_therapy_area,Pharma,Cardiovascular,2021,882,286,55,225,98,29,693,189
cardiovascular (primary search + cardiovascular tags) - pharma,"(author.affiliation.name:(""pfizer"" OR ""astrazeneca"" OR ""eli lilly"" OR ""merck"" OR ""emd serono"" OR ""msd"" OR ""merck sharp & dohme"" OR ""bristol myers squibb"" OR ""novartis"" OR ""roche"" OR ""hoffmann-la roche"" OR ""genentech"" OR ""johnson & johnson"" OR ""janssen"" OR ""biosense webster"" OR ""glaxosmithkline"" OR ""gsk"" OR ""abbvie"" OR ""sanofi"" OR ""sanofi-aventis"" OR ""gilead sciences"" OR ""takeda"" OR ""boehringer ingelheim"" OR ""myokardia"" OR ""amgen"" OR ""applied molecular genetics"" OR ""bayer"" OR ""vertex pharmaceuticals"" OR ""regeneron"" OR ""novo nordisk"" OR ""biogen"" OR ""biogen idec"" OR ""daiichi sankyo"" OR ""astellas pharma"" OR ""asuterasu seiyaku kabushiki-gaisha"" OR ""otsuka"" OR ""otsuka seiyaku kabushiki-gaisha"" OR ""astex pharmaceuticals"" OR ""ucb"" OR ""union chimique belge"" OR ""moderna"" OR ""eisai"" OR ""ezai kabushiki-gaisha"" OR ""ea pharma"" OR ""csl"" OR ""zlb behring"" OR ""jiangsu hengrui medicine"" OR ""teva pharmaceuticals"" OR ""sumitomo dainippon pharma"" OR ""dainippon sumitomo seiyaku kabushiki-gaisha"" OR ""fresenius"" OR ""fresenius se & co. kgaa"" OR ""viatris"" OR ""kyowa kirin"" OR ""kyowa hakko kirin"" OR ""ipsen"" OR ""jazz pharmaceuticals"" OR ""azur pharma"" OR ""sino biopharm"" OR ""bausch health companies"" OR ""valeant pharmaceuticals"" OR ""cspc pharmaceutical group"" OR ""galapagos"" OR ""galapagos genomics"" NOT ""La Roche College"") OR author.affiliation.ror_id_lineage:(""01xdqrp08"" OR ""00by1q217"" OR ""04b2dty93"" OR ""02891sr49"" OR ""03qd7mz70"" OR ""00gtmwv55"" OR ""02f9zrr09"" OR ""04r9x1a08"" OR ""01qat3289"" OR ""01xsqw823"" OR ""02g5p4n58"" OR ""02n6c9837"" OR ""056546b03"" OR ""04hjbmv12"" OR ""00q32j219"" OR ""03g03ge92"" OR ""04hmn8g73"" OR ""00anb1726"" OR ""02f51rf24"" OR ""0435rc536"" OR ""02jqkb192"" OR ""027y26122"" OR ""01cjash87"" OR ""013k5y296"" OR ""01n029866"" OR ""01xm4wg91"" OR ""04vvh7p27"" OR ""044tc0x05"" OR ""04ayvvz32"" OR ""01wfv3m53"" OR ""04sapgw72"" OR ""01v376g59"" OR ""01g1gvr46"" OR ""000wej815"" OR ""00d801g55"" OR ""055mhsv54"" OR ""0086q4c12"" OR ""01zgpn844"" OR ""016mq8947"" OR ""04e4j5d46"")) AND publication_type:""journal article"" AND date_published>=now-10y AND field_of_study: ((""Medicine"" OR ""Internal medicine"" OR ""Pharmacology"") AND (""Cardiology"" OR ""Heart failure"" OR ""Atrial fibrillation"" OR ""Myocardial infarction"" OR ""Stroke"" OR ""Blood pressure"" OR ""Acute coronary syndrome"" OR ""Coronary artery disease"" OR ""Thrombosis"" OR ""QT interval"" OR ""Heart rate"" OR ""Heart failure with preserved ejection fraction"" OR ""Cardiomyopathy""))",AND date_published>=now-10y,"AND field_of_study: ((""Medicine"" OR ""Internal medicine"" OR ""Pharmacology"") AND (""Cardiology"" OR ""Heart failure"" OR ""Atrial fibrillation"" OR ""Myocardial infarction"" OR ""Stroke"" OR ""Blood pressure"" OR ""Acute coronary syndrome"" OR ""Coronary artery disease"" OR ""Thrombosis"" OR ""QT interval"" OR ""Heart rate"" OR ""Heart failure with preserved ejection fraction"" OR ""Cardiomyopathy""))",NA,oa_therapy_area,Pharma,Cardiovascular,2022,947,360,71,208,89,55,783,164
cardiovascular (primary search + cardiovascular tags) - pharma,"(author.affiliation.name:(""pfizer"" OR ""astrazeneca"" OR ""eli lilly"" OR ""merck"" OR ""emd serono"" OR ""msd"" OR ""merck sharp & dohme"" OR ""bristol myers squibb"" OR ""novartis"" OR ""roche"" OR ""hoffmann-la roche"" OR ""genentech"" OR ""johnson & johnson"" OR ""janssen"" OR ""biosense webster"" OR ""glaxosmithkline"" OR ""gsk"" OR ""abbvie"" OR ""sanofi"" OR ""sanofi-aventis"" OR ""gilead sciences"" OR ""takeda"" OR ""boehringer ingelheim"" OR ""myokardia"" OR ""amgen"" OR ""applied molecular genetics"" OR ""bayer"" OR ""vertex pharmaceuticals"" OR ""regeneron"" OR ""novo nordisk"" OR ""biogen"" OR ""biogen idec"" OR ""daiichi sankyo"" OR ""astellas pharma"" OR ""asuterasu seiyaku kabushiki-gaisha"" OR ""otsuka"" OR ""otsuka seiyaku kabushiki-gaisha"" OR ""astex pharmaceuticals"" OR ""ucb"" OR ""union chimique belge"" OR ""moderna"" OR ""eisai"" OR ""ezai kabushiki-gaisha"" OR ""ea pharma"" OR ""csl"" OR ""zlb behring"" OR ""jiangsu hengrui medicine"" OR ""teva pharmaceuticals"" OR ""sumitomo dainippon pharma"" OR ""dainippon sumitomo seiyaku kabushiki-gaisha"" OR ""fresenius"" OR ""fresenius se & co. kgaa"" OR ""viatris"" OR ""kyowa kirin"" OR ""kyowa hakko kirin"" OR ""ipsen"" OR ""jazz pharmaceuticals"" OR ""azur pharma"" OR ""sino biopharm"" OR ""bausch health companies"" OR ""valeant pharmaceuticals"" OR ""cspc pharmaceutical group"" OR ""galapagos"" OR ""galapagos genomics"" NOT ""La Roche College"") OR author.affiliation.ror_id_lineage:(""01xdqrp08"" OR ""00by1q217"" OR ""04b2dty93"" OR ""02891sr49"" OR ""03qd7mz70"" OR ""00gtmwv55"" OR ""02f9zrr09"" OR ""04r9x1a08"" OR ""01qat3289"" OR ""01xsqw823"" OR ""02g5p4n58"" OR ""02n6c9837"" OR ""056546b03"" OR ""04hjbmv12"" OR ""00q32j219"" OR ""03g03ge92"" OR ""04hmn8g73"" OR ""00anb1726"" OR ""02f51rf24"" OR ""0435rc536"" OR ""02jqkb192"" OR ""027y26122"" OR ""01cjash87"" OR ""013k5y296"" OR ""01n029866"" OR ""01xm4wg91"" OR ""04vvh7p27"" OR ""044tc0x05"" OR ""04ayvvz32"" OR ""01wfv3m53"" OR ""04sapgw72"" OR ""01v376g59"" OR ""01g1gvr46"" OR ""000wej815"" OR ""00d801g55"" OR ""055mhsv54"" OR ""0086q4c12"" OR ""01zgpn844"" OR ""016mq8947"" OR ""04e4j5d46"")) AND publication_type:""journal article"" AND date_published>=now-10y AND field_of_study: ((""Medicine"" OR ""Internal medicine"" OR ""Pharmacology"") AND (""Cardiology"" OR ""Heart failure"" OR ""Atrial fibrillation"" OR ""Myocardial infarction"" OR ""Stroke"" OR ""Blood pressure"" OR ""Acute coronary syndrome"" OR ""Coronary artery disease"" OR ""Thrombosis"" OR ""QT interval"" OR ""Heart rate"" OR ""Heart failure with preserved ejection fraction"" OR ""Cardiomyopathy""))",AND date_published>=now-10y,"AND field_of_study: ((""Medicine"" OR ""Internal medicine"" OR ""Pharmacology"") AND (""Cardiology"" OR ""Heart failure"" OR ""Atrial fibrillation"" OR ""Myocardial infarction"" OR ""Stroke"" OR ""Blood pressure"" OR ""Acute coronary syndrome"" OR ""Coronary artery disease"" OR ""Thrombosis"" OR ""QT interval"" OR ""Heart rate"" OR ""Heart failure with preserved ejection fraction"" OR ""Cardiomyopathy""))",NA,oa_therapy_area,Pharma,Cardiovascular,2023,374,136,7,71,7,59,280,94
gastroenterology  (primary search + gastroenterology tags) - pharma,"(author.affiliation.name:(""pfizer"" OR ""astrazeneca"" OR ""eli lilly"" OR ""merck"" OR ""emd serono"" OR ""msd"" OR ""merck sharp & dohme"" OR ""bristol myers squibb"" OR ""novartis"" OR ""roche"" OR ""hoffmann-la roche"" OR ""genentech"" OR ""johnson & johnson"" OR ""janssen"" OR ""biosense webster"" OR ""glaxosmithkline"" OR ""gsk"" OR ""abbvie"" OR ""sanofi"" OR ""sanofi-aventis"" OR ""gilead sciences"" OR ""takeda"" OR ""boehringer ingelheim"" OR ""myokardia"" OR ""amgen"" OR ""applied molecular genetics"" OR ""bayer"" OR ""vertex pharmaceuticals"" OR ""regeneron"" OR ""novo nordisk"" OR ""biogen"" OR ""biogen idec"" OR ""daiichi sankyo"" OR ""astellas pharma"" OR ""asuterasu seiyaku kabushiki-gaisha"" OR ""otsuka"" OR ""otsuka seiyaku kabushiki-gaisha"" OR ""astex pharmaceuticals"" OR ""ucb"" OR ""union chimique belge"" OR ""moderna"" OR ""eisai"" OR ""ezai kabushiki-gaisha"" OR ""ea pharma"" OR ""csl"" OR ""zlb behring"" OR ""jiangsu hengrui medicine"" OR ""teva pharmaceuticals"" OR ""sumitomo dainippon pharma"" OR ""dainippon sumitomo seiyaku kabushiki-gaisha"" OR ""fresenius"" OR ""fresenius se & co. kgaa"" OR ""viatris"" OR ""kyowa kirin"" OR ""kyowa hakko kirin"" OR ""ipsen"" OR ""jazz pharmaceuticals"" OR ""azur pharma"" OR ""sino biopharm"" OR ""bausch health companies"" OR ""valeant pharmaceuticals"" OR ""cspc pharmaceutical group"" OR ""galapagos"" OR ""galapagos genomics"" NOT ""La Roche College"") OR author.affiliation.ror_id_lineage:(""01xdqrp08"" OR ""00by1q217"" OR ""04b2dty93"" OR ""02891sr49"" OR ""03qd7mz70"" OR ""00gtmwv55"" OR ""02f9zrr09"" OR ""04r9x1a08"" OR ""01qat3289"" OR ""01xsqw823"" OR ""02g5p4n58"" OR ""02n6c9837"" OR ""056546b03"" OR ""04hjbmv12"" OR ""00q32j219"" OR ""03g03ge92"" OR ""04hmn8g73"" OR ""00anb1726"" OR ""02f51rf24"" OR ""0435rc536"" OR ""02jqkb192"" OR ""027y26122"" OR ""01cjash87"" OR ""013k5y296"" OR ""01n029866"" OR ""01xm4wg91"" OR ""04vvh7p27"" OR ""044tc0x05"" OR ""04ayvvz32"" OR ""01wfv3m53"" OR ""04sapgw72"" OR ""01v376g59"" OR ""01g1gvr46"" OR ""000wej815"" OR ""00d801g55"" OR ""055mhsv54"" OR ""0086q4c12"" OR ""01zgpn844"" OR ""016mq8947"" OR ""04e4j5d46"")) AND publication_type:""journal article"" AND date_published>=now-10y AND field_of_study: ((""Medicine"" OR ""Internal medicine"" OR ""Pharmacology"") AND (""Gastroenterology"" OR ""Ulcerative colitis"" OR ""Inflammatory bowel disease"" OR ""Crohn's disease""))",AND date_published>=now-10y,"AND field_of_study: ((""Medicine"" OR ""Internal medicine"" OR ""Pharmacology"") AND (""Gastroenterology"" OR ""Ulcerative colitis"" OR ""Inflammatory bowel disease"" OR ""Crohn's disease""))",NA,oa_therapy_area,Pharma,Gastroenterology,2013,305,25,34,40,16,2,117,188
gastroenterology  (primary search + gastroenterology tags) - pharma,"(author.affiliation.name:(""pfizer"" OR ""astrazeneca"" OR ""eli lilly"" OR ""merck"" OR ""emd serono"" OR ""msd"" OR ""merck sharp & dohme"" OR ""bristol myers squibb"" OR ""novartis"" OR ""roche"" OR ""hoffmann-la roche"" OR ""genentech"" OR ""johnson & johnson"" OR ""janssen"" OR ""biosense webster"" OR ""glaxosmithkline"" OR ""gsk"" OR ""abbvie"" OR ""sanofi"" OR ""sanofi-aventis"" OR ""gilead sciences"" OR ""takeda"" OR ""boehringer ingelheim"" OR ""myokardia"" OR ""amgen"" OR ""applied molecular genetics"" OR ""bayer"" OR ""vertex pharmaceuticals"" OR ""regeneron"" OR ""novo nordisk"" OR ""biogen"" OR ""biogen idec"" OR ""daiichi sankyo"" OR ""astellas pharma"" OR ""asuterasu seiyaku kabushiki-gaisha"" OR ""otsuka"" OR ""otsuka seiyaku kabushiki-gaisha"" OR ""astex pharmaceuticals"" OR ""ucb"" OR ""union chimique belge"" OR ""moderna"" OR ""eisai"" OR ""ezai kabushiki-gaisha"" OR ""ea pharma"" OR ""csl"" OR ""zlb behring"" OR ""jiangsu hengrui medicine"" OR ""teva pharmaceuticals"" OR ""sumitomo dainippon pharma"" OR ""dainippon sumitomo seiyaku kabushiki-gaisha"" OR ""fresenius"" OR ""fresenius se & co. kgaa"" OR ""viatris"" OR ""kyowa kirin"" OR ""kyowa hakko kirin"" OR ""ipsen"" OR ""jazz pharmaceuticals"" OR ""azur pharma"" OR ""sino biopharm"" OR ""bausch health companies"" OR ""valeant pharmaceuticals"" OR ""cspc pharmaceutical group"" OR ""galapagos"" OR ""galapagos genomics"" NOT ""La Roche College"") OR author.affiliation.ror_id_lineage:(""01xdqrp08"" OR ""00by1q217"" OR ""04b2dty93"" OR ""02891sr49"" OR ""03qd7mz70"" OR ""00gtmwv55"" OR ""02f9zrr09"" OR ""04r9x1a08"" OR ""01qat3289"" OR ""01xsqw823"" OR ""02g5p4n58"" OR ""02n6c9837"" OR ""056546b03"" OR ""04hjbmv12"" OR ""00q32j219"" OR ""03g03ge92"" OR ""04hmn8g73"" OR ""00anb1726"" OR ""02f51rf24"" OR ""0435rc536"" OR ""02jqkb192"" OR ""027y26122"" OR ""01cjash87"" OR ""013k5y296"" OR ""01n029866"" OR ""01xm4wg91"" OR ""04vvh7p27"" OR ""044tc0x05"" OR ""04ayvvz32"" OR ""01wfv3m53"" OR ""04sapgw72"" OR ""01v376g59"" OR ""01g1gvr46"" OR ""000wej815"" OR ""00d801g55"" OR ""055mhsv54"" OR ""0086q4c12"" OR ""01zgpn844"" OR ""016mq8947"" OR ""04e4j5d46"")) AND publication_type:""journal article"" AND date_published>=now-10y AND field_of_study: ((""Medicine"" OR ""Internal medicine"" OR ""Pharmacology"") AND (""Gastroenterology"" OR ""Ulcerative colitis"" OR ""Inflammatory bowel disease"" OR ""Crohn's disease""))",AND date_published>=now-10y,"AND field_of_study: ((""Medicine"" OR ""Internal medicine"" OR ""Pharmacology"") AND (""Gastroenterology"" OR ""Ulcerative colitis"" OR ""Inflammatory bowel disease"" OR ""Crohn's disease""))",NA,oa_therapy_area,Pharma,Gastroenterology,2014,786,105,99,81,103,19,407,379
gastroenterology  (primary search + gastroenterology tags) - pharma,"(author.affiliation.name:(""pfizer"" OR ""astrazeneca"" OR ""eli lilly"" OR ""merck"" OR ""emd serono"" OR ""msd"" OR ""merck sharp & dohme"" OR ""bristol myers squibb"" OR ""novartis"" OR ""roche"" OR ""hoffmann-la roche"" OR ""genentech"" OR ""johnson & johnson"" OR ""janssen"" OR ""biosense webster"" OR ""glaxosmithkline"" OR ""gsk"" OR ""abbvie"" OR ""sanofi"" OR ""sanofi-aventis"" OR ""gilead sciences"" OR ""takeda"" OR ""boehringer ingelheim"" OR ""myokardia"" OR ""amgen"" OR ""applied molecular genetics"" OR ""bayer"" OR ""vertex pharmaceuticals"" OR ""regeneron"" OR ""novo nordisk"" OR ""biogen"" OR ""biogen idec"" OR ""daiichi sankyo"" OR ""astellas pharma"" OR ""asuterasu seiyaku kabushiki-gaisha"" OR ""otsuka"" OR ""otsuka seiyaku kabushiki-gaisha"" OR ""astex pharmaceuticals"" OR ""ucb"" OR ""union chimique belge"" OR ""moderna"" OR ""eisai"" OR ""ezai kabushiki-gaisha"" OR ""ea pharma"" OR ""csl"" OR ""zlb behring"" OR ""jiangsu hengrui medicine"" OR ""teva pharmaceuticals"" OR ""sumitomo dainippon pharma"" OR ""dainippon sumitomo seiyaku kabushiki-gaisha"" OR ""fresenius"" OR ""fresenius se & co. kgaa"" OR ""viatris"" OR ""kyowa kirin"" OR ""kyowa hakko kirin"" OR ""ipsen"" OR ""jazz pharmaceuticals"" OR ""azur pharma"" OR ""sino biopharm"" OR ""bausch health companies"" OR ""valeant pharmaceuticals"" OR ""cspc pharmaceutical group"" OR ""galapagos"" OR ""galapagos genomics"" NOT ""La Roche College"") OR author.affiliation.ror_id_lineage:(""01xdqrp08"" OR ""00by1q217"" OR ""04b2dty93"" OR ""02891sr49"" OR ""03qd7mz70"" OR ""00gtmwv55"" OR ""02f9zrr09"" OR ""04r9x1a08"" OR ""01qat3289"" OR ""01xsqw823"" OR ""02g5p4n58"" OR ""02n6c9837"" OR ""056546b03"" OR ""04hjbmv12"" OR ""00q32j219"" OR ""03g03ge92"" OR ""04hmn8g73"" OR ""00anb1726"" OR ""02f51rf24"" OR ""0435rc536"" OR ""02jqkb192"" OR ""027y26122"" OR ""01cjash87"" OR ""013k5y296"" OR ""01n029866"" OR ""01xm4wg91"" OR ""04vvh7p27"" OR ""044tc0x05"" OR ""04ayvvz32"" OR ""01wfv3m53"" OR ""04sapgw72"" OR ""01v376g59"" OR ""01g1gvr46"" OR ""000wej815"" OR ""00d801g55"" OR ""055mhsv54"" OR ""0086q4c12"" OR ""01zgpn844"" OR ""016mq8947"" OR ""04e4j5d46"")) AND publication_type:""journal article"" AND date_published>=now-10y AND field_of_study: ((""Medicine"" OR ""Internal medicine"" OR ""Pharmacology"") AND (""Gastroenterology"" OR ""Ulcerative colitis"" OR ""Inflammatory bowel disease"" OR ""Crohn's disease""))",AND date_published>=now-10y,"AND field_of_study: ((""Medicine"" OR ""Internal medicine"" OR ""Pharmacology"") AND (""Gastroenterology"" OR ""Ulcerative colitis"" OR ""Inflammatory bowel disease"" OR ""Crohn's disease""))",NA,oa_therapy_area,Pharma,Gastroenterology,2015,777,104,97,118,74,4,397,380
gastroenterology  (primary search + gastroenterology tags) - pharma,"(author.affiliation.name:(""pfizer"" OR ""astrazeneca"" OR ""eli lilly"" OR ""merck"" OR ""emd serono"" OR ""msd"" OR ""merck sharp & dohme"" OR ""bristol myers squibb"" OR ""novartis"" OR ""roche"" OR ""hoffmann-la roche"" OR ""genentech"" OR ""johnson & johnson"" OR ""janssen"" OR ""biosense webster"" OR ""glaxosmithkline"" OR ""gsk"" OR ""abbvie"" OR ""sanofi"" OR ""sanofi-aventis"" OR ""gilead sciences"" OR ""takeda"" OR ""boehringer ingelheim"" OR ""myokardia"" OR ""amgen"" OR ""applied molecular genetics"" OR ""bayer"" OR ""vertex pharmaceuticals"" OR ""regeneron"" OR ""novo nordisk"" OR ""biogen"" OR ""biogen idec"" OR ""daiichi sankyo"" OR ""astellas pharma"" OR ""asuterasu seiyaku kabushiki-gaisha"" OR ""otsuka"" OR ""otsuka seiyaku kabushiki-gaisha"" OR ""astex pharmaceuticals"" OR ""ucb"" OR ""union chimique belge"" OR ""moderna"" OR ""eisai"" OR ""ezai kabushiki-gaisha"" OR ""ea pharma"" OR ""csl"" OR ""zlb behring"" OR ""jiangsu hengrui medicine"" OR ""teva pharmaceuticals"" OR ""sumitomo dainippon pharma"" OR ""dainippon sumitomo seiyaku kabushiki-gaisha"" OR ""fresenius"" OR ""fresenius se & co. kgaa"" OR ""viatris"" OR ""kyowa kirin"" OR ""kyowa hakko kirin"" OR ""ipsen"" OR ""jazz pharmaceuticals"" OR ""azur pharma"" OR ""sino biopharm"" OR ""bausch health companies"" OR ""valeant pharmaceuticals"" OR ""cspc pharmaceutical group"" OR ""galapagos"" OR ""galapagos genomics"" NOT ""La Roche College"") OR author.affiliation.ror_id_lineage:(""01xdqrp08"" OR ""00by1q217"" OR ""04b2dty93"" OR ""02891sr49"" OR ""03qd7mz70"" OR ""00gtmwv55"" OR ""02f9zrr09"" OR ""04r9x1a08"" OR ""01qat3289"" OR ""01xsqw823"" OR ""02g5p4n58"" OR ""02n6c9837"" OR ""056546b03"" OR ""04hjbmv12"" OR ""00q32j219"" OR ""03g03ge92"" OR ""04hmn8g73"" OR ""00anb1726"" OR ""02f51rf24"" OR ""0435rc536"" OR ""02jqkb192"" OR ""027y26122"" OR ""01cjash87"" OR ""013k5y296"" OR ""01n029866"" OR ""01xm4wg91"" OR ""04vvh7p27"" OR ""044tc0x05"" OR ""04ayvvz32"" OR ""01wfv3m53"" OR ""04sapgw72"" OR ""01v376g59"" OR ""01g1gvr46"" OR ""000wej815"" OR ""00d801g55"" OR ""055mhsv54"" OR ""0086q4c12"" OR ""01zgpn844"" OR ""016mq8947"" OR ""04e4j5d46"")) AND publication_type:""journal article"" AND date_published>=now-10y AND field_of_study: ((""Medicine"" OR ""Internal medicine"" OR ""Pharmacology"") AND (""Gastroenterology"" OR ""Ulcerative colitis"" OR ""Inflammatory bowel disease"" OR ""Crohn's disease""))",AND date_published>=now-10y,"AND field_of_study: ((""Medicine"" OR ""Internal medicine"" OR ""Pharmacology"") AND (""Gastroenterology"" OR ""Ulcerative colitis"" OR ""Inflammatory bowel disease"" OR ""Crohn's disease""))",NA,oa_therapy_area,Pharma,Gastroenterology,2016,841,139,84,152,84,4,463,378
gastroenterology  (primary search + gastroenterology tags) - pharma,"(author.affiliation.name:(""pfizer"" OR ""astrazeneca"" OR ""eli lilly"" OR ""merck"" OR ""emd serono"" OR ""msd"" OR ""merck sharp & dohme"" OR ""bristol myers squibb"" OR ""novartis"" OR ""roche"" OR ""hoffmann-la roche"" OR ""genentech"" OR ""johnson & johnson"" OR ""janssen"" OR ""biosense webster"" OR ""glaxosmithkline"" OR ""gsk"" OR ""abbvie"" OR ""sanofi"" OR ""sanofi-aventis"" OR ""gilead sciences"" OR ""takeda"" OR ""boehringer ingelheim"" OR ""myokardia"" OR ""amgen"" OR ""applied molecular genetics"" OR ""bayer"" OR ""vertex pharmaceuticals"" OR ""regeneron"" OR ""novo nordisk"" OR ""biogen"" OR ""biogen idec"" OR ""daiichi sankyo"" OR ""astellas pharma"" OR ""asuterasu seiyaku kabushiki-gaisha"" OR ""otsuka"" OR ""otsuka seiyaku kabushiki-gaisha"" OR ""astex pharmaceuticals"" OR ""ucb"" OR ""union chimique belge"" OR ""moderna"" OR ""eisai"" OR ""ezai kabushiki-gaisha"" OR ""ea pharma"" OR ""csl"" OR ""zlb behring"" OR ""jiangsu hengrui medicine"" OR ""teva pharmaceuticals"" OR ""sumitomo dainippon pharma"" OR ""dainippon sumitomo seiyaku kabushiki-gaisha"" OR ""fresenius"" OR ""fresenius se & co. kgaa"" OR ""viatris"" OR ""kyowa kirin"" OR ""kyowa hakko kirin"" OR ""ipsen"" OR ""jazz pharmaceuticals"" OR ""azur pharma"" OR ""sino biopharm"" OR ""bausch health companies"" OR ""valeant pharmaceuticals"" OR ""cspc pharmaceutical group"" OR ""galapagos"" OR ""galapagos genomics"" NOT ""La Roche College"") OR author.affiliation.ror_id_lineage:(""01xdqrp08"" OR ""00by1q217"" OR ""04b2dty93"" OR ""02891sr49"" OR ""03qd7mz70"" OR ""00gtmwv55"" OR ""02f9zrr09"" OR ""04r9x1a08"" OR ""01qat3289"" OR ""01xsqw823"" OR ""02g5p4n58"" OR ""02n6c9837"" OR ""056546b03"" OR ""04hjbmv12"" OR ""00q32j219"" OR ""03g03ge92"" OR ""04hmn8g73"" OR ""00anb1726"" OR ""02f51rf24"" OR ""0435rc536"" OR ""02jqkb192"" OR ""027y26122"" OR ""01cjash87"" OR ""013k5y296"" OR ""01n029866"" OR ""01xm4wg91"" OR ""04vvh7p27"" OR ""044tc0x05"" OR ""04ayvvz32"" OR ""01wfv3m53"" OR ""04sapgw72"" OR ""01v376g59"" OR ""01g1gvr46"" OR ""000wej815"" OR ""00d801g55"" OR ""055mhsv54"" OR ""0086q4c12"" OR ""01zgpn844"" OR ""016mq8947"" OR ""04e4j5d46"")) AND publication_type:""journal article"" AND date_published>=now-10y AND field_of_study: ((""Medicine"" OR ""Internal medicine"" OR ""Pharmacology"") AND (""Gastroenterology"" OR ""Ulcerative colitis"" OR ""Inflammatory bowel disease"" OR ""Crohn's disease""))",AND date_published>=now-10y,"AND field_of_study: ((""Medicine"" OR ""Internal medicine"" OR ""Pharmacology"") AND (""Gastroenterology"" OR ""Ulcerative colitis"" OR ""Inflammatory bowel disease"" OR ""Crohn's disease""))",NA,oa_therapy_area,Pharma,Gastroenterology,2017,859,144,118,150,140,5,557,302
gastroenterology  (primary search + gastroenterology tags) - pharma,"(author.affiliation.name:(""pfizer"" OR ""astrazeneca"" OR ""eli lilly"" OR ""merck"" OR ""emd serono"" OR ""msd"" OR ""merck sharp & dohme"" OR ""bristol myers squibb"" OR ""novartis"" OR ""roche"" OR ""hoffmann-la roche"" OR ""genentech"" OR ""johnson & johnson"" OR ""janssen"" OR ""biosense webster"" OR ""glaxosmithkline"" OR ""gsk"" OR ""abbvie"" OR ""sanofi"" OR ""sanofi-aventis"" OR ""gilead sciences"" OR ""takeda"" OR ""boehringer ingelheim"" OR ""myokardia"" OR ""amgen"" OR ""applied molecular genetics"" OR ""bayer"" OR ""vertex pharmaceuticals"" OR ""regeneron"" OR ""novo nordisk"" OR ""biogen"" OR ""biogen idec"" OR ""daiichi sankyo"" OR ""astellas pharma"" OR ""asuterasu seiyaku kabushiki-gaisha"" OR ""otsuka"" OR ""otsuka seiyaku kabushiki-gaisha"" OR ""astex pharmaceuticals"" OR ""ucb"" OR ""union chimique belge"" OR ""moderna"" OR ""eisai"" OR ""ezai kabushiki-gaisha"" OR ""ea pharma"" OR ""csl"" OR ""zlb behring"" OR ""jiangsu hengrui medicine"" OR ""teva pharmaceuticals"" OR ""sumitomo dainippon pharma"" OR ""dainippon sumitomo seiyaku kabushiki-gaisha"" OR ""fresenius"" OR ""fresenius se & co. kgaa"" OR ""viatris"" OR ""kyowa kirin"" OR ""kyowa hakko kirin"" OR ""ipsen"" OR ""jazz pharmaceuticals"" OR ""azur pharma"" OR ""sino biopharm"" OR ""bausch health companies"" OR ""valeant pharmaceuticals"" OR ""cspc pharmaceutical group"" OR ""galapagos"" OR ""galapagos genomics"" NOT ""La Roche College"") OR author.affiliation.ror_id_lineage:(""01xdqrp08"" OR ""00by1q217"" OR ""04b2dty93"" OR ""02891sr49"" OR ""03qd7mz70"" OR ""00gtmwv55"" OR ""02f9zrr09"" OR ""04r9x1a08"" OR ""01qat3289"" OR ""01xsqw823"" OR ""02g5p4n58"" OR ""02n6c9837"" OR ""056546b03"" OR ""04hjbmv12"" OR ""00q32j219"" OR ""03g03ge92"" OR ""04hmn8g73"" OR ""00anb1726"" OR ""02f51rf24"" OR ""0435rc536"" OR ""02jqkb192"" OR ""027y26122"" OR ""01cjash87"" OR ""013k5y296"" OR ""01n029866"" OR ""01xm4wg91"" OR ""04vvh7p27"" OR ""044tc0x05"" OR ""04ayvvz32"" OR ""01wfv3m53"" OR ""04sapgw72"" OR ""01v376g59"" OR ""01g1gvr46"" OR ""000wej815"" OR ""00d801g55"" OR ""055mhsv54"" OR ""0086q4c12"" OR ""01zgpn844"" OR ""016mq8947"" OR ""04e4j5d46"")) AND publication_type:""journal article"" AND date_published>=now-10y AND field_of_study: ((""Medicine"" OR ""Internal medicine"" OR ""Pharmacology"") AND (""Gastroenterology"" OR ""Ulcerative colitis"" OR ""Inflammatory bowel disease"" OR ""Crohn's disease""))",AND date_published>=now-10y,"AND field_of_study: ((""Medicine"" OR ""Internal medicine"" OR ""Pharmacology"") AND (""Gastroenterology"" OR ""Ulcerative colitis"" OR ""Inflammatory bowel disease"" OR ""Crohn's disease""))",NA,oa_therapy_area,Pharma,Gastroenterology,2018,1003,226,116,224,172,3,741,262
gastroenterology  (primary search + gastroenterology tags) - pharma,"(author.affiliation.name:(""pfizer"" OR ""astrazeneca"" OR ""eli lilly"" OR ""merck"" OR ""emd serono"" OR ""msd"" OR ""merck sharp & dohme"" OR ""bristol myers squibb"" OR ""novartis"" OR ""roche"" OR ""hoffmann-la roche"" OR ""genentech"" OR ""johnson & johnson"" OR ""janssen"" OR ""biosense webster"" OR ""glaxosmithkline"" OR ""gsk"" OR ""abbvie"" OR ""sanofi"" OR ""sanofi-aventis"" OR ""gilead sciences"" OR ""takeda"" OR ""boehringer ingelheim"" OR ""myokardia"" OR ""amgen"" OR ""applied molecular genetics"" OR ""bayer"" OR ""vertex pharmaceuticals"" OR ""regeneron"" OR ""novo nordisk"" OR ""biogen"" OR ""biogen idec"" OR ""daiichi sankyo"" OR ""astellas pharma"" OR ""asuterasu seiyaku kabushiki-gaisha"" OR ""otsuka"" OR ""otsuka seiyaku kabushiki-gaisha"" OR ""astex pharmaceuticals"" OR ""ucb"" OR ""union chimique belge"" OR ""moderna"" OR ""eisai"" OR ""ezai kabushiki-gaisha"" OR ""ea pharma"" OR ""csl"" OR ""zlb behring"" OR ""jiangsu hengrui medicine"" OR ""teva pharmaceuticals"" OR ""sumitomo dainippon pharma"" OR ""dainippon sumitomo seiyaku kabushiki-gaisha"" OR ""fresenius"" OR ""fresenius se & co. kgaa"" OR ""viatris"" OR ""kyowa kirin"" OR ""kyowa hakko kirin"" OR ""ipsen"" OR ""jazz pharmaceuticals"" OR ""azur pharma"" OR ""sino biopharm"" OR ""bausch health companies"" OR ""valeant pharmaceuticals"" OR ""cspc pharmaceutical group"" OR ""galapagos"" OR ""galapagos genomics"" NOT ""La Roche College"") OR author.affiliation.ror_id_lineage:(""01xdqrp08"" OR ""00by1q217"" OR ""04b2dty93"" OR ""02891sr49"" OR ""03qd7mz70"" OR ""00gtmwv55"" OR ""02f9zrr09"" OR ""04r9x1a08"" OR ""01qat3289"" OR ""01xsqw823"" OR ""02g5p4n58"" OR ""02n6c9837"" OR ""056546b03"" OR ""04hjbmv12"" OR ""00q32j219"" OR ""03g03ge92"" OR ""04hmn8g73"" OR ""00anb1726"" OR ""02f51rf24"" OR ""0435rc536"" OR ""02jqkb192"" OR ""027y26122"" OR ""01cjash87"" OR ""013k5y296"" OR ""01n029866"" OR ""01xm4wg91"" OR ""04vvh7p27"" OR ""044tc0x05"" OR ""04ayvvz32"" OR ""01wfv3m53"" OR ""04sapgw72"" OR ""01v376g59"" OR ""01g1gvr46"" OR ""000wej815"" OR ""00d801g55"" OR ""055mhsv54"" OR ""0086q4c12"" OR ""01zgpn844"" OR ""016mq8947"" OR ""04e4j5d46"")) AND publication_type:""journal article"" AND date_published>=now-10y AND field_of_study: ((""Medicine"" OR ""Internal medicine"" OR ""Pharmacology"") AND (""Gastroenterology"" OR ""Ulcerative colitis"" OR ""Inflammatory bowel disease"" OR ""Crohn's disease""))",AND date_published>=now-10y,"AND field_of_study: ((""Medicine"" OR ""Internal medicine"" OR ""Pharmacology"") AND (""Gastroenterology"" OR ""Ulcerative colitis"" OR ""Inflammatory bowel disease"" OR ""Crohn's disease""))",NA,oa_therapy_area,Pharma,Gastroenterology,2019,997,200,86,262,136,7,691,306
gastroenterology  (primary search + gastroenterology tags) - pharma,"(author.affiliation.name:(""pfizer"" OR ""astrazeneca"" OR ""eli lilly"" OR ""merck"" OR ""emd serono"" OR ""msd"" OR ""merck sharp & dohme"" OR ""bristol myers squibb"" OR ""novartis"" OR ""roche"" OR ""hoffmann-la roche"" OR ""genentech"" OR ""johnson & johnson"" OR ""janssen"" OR ""biosense webster"" OR ""glaxosmithkline"" OR ""gsk"" OR ""abbvie"" OR ""sanofi"" OR ""sanofi-aventis"" OR ""gilead sciences"" OR ""takeda"" OR ""boehringer ingelheim"" OR ""myokardia"" OR ""amgen"" OR ""applied molecular genetics"" OR ""bayer"" OR ""vertex pharmaceuticals"" OR ""regeneron"" OR ""novo nordisk"" OR ""biogen"" OR ""biogen idec"" OR ""daiichi sankyo"" OR ""astellas pharma"" OR ""asuterasu seiyaku kabushiki-gaisha"" OR ""otsuka"" OR ""otsuka seiyaku kabushiki-gaisha"" OR ""astex pharmaceuticals"" OR ""ucb"" OR ""union chimique belge"" OR ""moderna"" OR ""eisai"" OR ""ezai kabushiki-gaisha"" OR ""ea pharma"" OR ""csl"" OR ""zlb behring"" OR ""jiangsu hengrui medicine"" OR ""teva pharmaceuticals"" OR ""sumitomo dainippon pharma"" OR ""dainippon sumitomo seiyaku kabushiki-gaisha"" OR ""fresenius"" OR ""fresenius se & co. kgaa"" OR ""viatris"" OR ""kyowa kirin"" OR ""kyowa hakko kirin"" OR ""ipsen"" OR ""jazz pharmaceuticals"" OR ""azur pharma"" OR ""sino biopharm"" OR ""bausch health companies"" OR ""valeant pharmaceuticals"" OR ""cspc pharmaceutical group"" OR ""galapagos"" OR ""galapagos genomics"" NOT ""La Roche College"") OR author.affiliation.ror_id_lineage:(""01xdqrp08"" OR ""00by1q217"" OR ""04b2dty93"" OR ""02891sr49"" OR ""03qd7mz70"" OR ""00gtmwv55"" OR ""02f9zrr09"" OR ""04r9x1a08"" OR ""01qat3289"" OR ""01xsqw823"" OR ""02g5p4n58"" OR ""02n6c9837"" OR ""056546b03"" OR ""04hjbmv12"" OR ""00q32j219"" OR ""03g03ge92"" OR ""04hmn8g73"" OR ""00anb1726"" OR ""02f51rf24"" OR ""0435rc536"" OR ""02jqkb192"" OR ""027y26122"" OR ""01cjash87"" OR ""013k5y296"" OR ""01n029866"" OR ""01xm4wg91"" OR ""04vvh7p27"" OR ""044tc0x05"" OR ""04ayvvz32"" OR ""01wfv3m53"" OR ""04sapgw72"" OR ""01v376g59"" OR ""01g1gvr46"" OR ""000wej815"" OR ""00d801g55"" OR ""055mhsv54"" OR ""0086q4c12"" OR ""01zgpn844"" OR ""016mq8947"" OR ""04e4j5d46"")) AND publication_type:""journal article"" AND date_published>=now-10y AND field_of_study: ((""Medicine"" OR ""Internal medicine"" OR ""Pharmacology"") AND (""Gastroenterology"" OR ""Ulcerative colitis"" OR ""Inflammatory bowel disease"" OR ""Crohn's disease""))",AND date_published>=now-10y,"AND field_of_study: ((""Medicine"" OR ""Internal medicine"" OR ""Pharmacology"") AND (""Gastroenterology"" OR ""Ulcerative colitis"" OR ""Inflammatory bowel disease"" OR ""Crohn's disease""))",NA,oa_therapy_area,Pharma,Gastroenterology,2020,1081,268,96,280,176,10,830,251
gastroenterology  (primary search + gastroenterology tags) - pharma,"(author.affiliation.name:(""pfizer"" OR ""astrazeneca"" OR ""eli lilly"" OR ""merck"" OR ""emd serono"" OR ""msd"" OR ""merck sharp & dohme"" OR ""bristol myers squibb"" OR ""novartis"" OR ""roche"" OR ""hoffmann-la roche"" OR ""genentech"" OR ""johnson & johnson"" OR ""janssen"" OR ""biosense webster"" OR ""glaxosmithkline"" OR ""gsk"" OR ""abbvie"" OR ""sanofi"" OR ""sanofi-aventis"" OR ""gilead sciences"" OR ""takeda"" OR ""boehringer ingelheim"" OR ""myokardia"" OR ""amgen"" OR ""applied molecular genetics"" OR ""bayer"" OR ""vertex pharmaceuticals"" OR ""regeneron"" OR ""novo nordisk"" OR ""biogen"" OR ""biogen idec"" OR ""daiichi sankyo"" OR ""astellas pharma"" OR ""asuterasu seiyaku kabushiki-gaisha"" OR ""otsuka"" OR ""otsuka seiyaku kabushiki-gaisha"" OR ""astex pharmaceuticals"" OR ""ucb"" OR ""union chimique belge"" OR ""moderna"" OR ""eisai"" OR ""ezai kabushiki-gaisha"" OR ""ea pharma"" OR ""csl"" OR ""zlb behring"" OR ""jiangsu hengrui medicine"" OR ""teva pharmaceuticals"" OR ""sumitomo dainippon pharma"" OR ""dainippon sumitomo seiyaku kabushiki-gaisha"" OR ""fresenius"" OR ""fresenius se & co. kgaa"" OR ""viatris"" OR ""kyowa kirin"" OR ""kyowa hakko kirin"" OR ""ipsen"" OR ""jazz pharmaceuticals"" OR ""azur pharma"" OR ""sino biopharm"" OR ""bausch health companies"" OR ""valeant pharmaceuticals"" OR ""cspc pharmaceutical group"" OR ""galapagos"" OR ""galapagos genomics"" NOT ""La Roche College"") OR author.affiliation.ror_id_lineage:(""01xdqrp08"" OR ""00by1q217"" OR ""04b2dty93"" OR ""02891sr49"" OR ""03qd7mz70"" OR ""00gtmwv55"" OR ""02f9zrr09"" OR ""04r9x1a08"" OR ""01qat3289"" OR ""01xsqw823"" OR ""02g5p4n58"" OR ""02n6c9837"" OR ""056546b03"" OR ""04hjbmv12"" OR ""00q32j219"" OR ""03g03ge92"" OR ""04hmn8g73"" OR ""00anb1726"" OR ""02f51rf24"" OR ""0435rc536"" OR ""02jqkb192"" OR ""027y26122"" OR ""01cjash87"" OR ""013k5y296"" OR ""01n029866"" OR ""01xm4wg91"" OR ""04vvh7p27"" OR ""044tc0x05"" OR ""04ayvvz32"" OR ""01wfv3m53"" OR ""04sapgw72"" OR ""01v376g59"" OR ""01g1gvr46"" OR ""000wej815"" OR ""00d801g55"" OR ""055mhsv54"" OR ""0086q4c12"" OR ""01zgpn844"" OR ""016mq8947"" OR ""04e4j5d46"")) AND publication_type:""journal article"" AND date_published>=now-10y AND field_of_study: ((""Medicine"" OR ""Internal medicine"" OR ""Pharmacology"") AND (""Gastroenterology"" OR ""Ulcerative colitis"" OR ""Inflammatory bowel disease"" OR ""Crohn's disease""))",AND date_published>=now-10y,"AND field_of_study: ((""Medicine"" OR ""Internal medicine"" OR ""Pharmacology"") AND (""Gastroenterology"" OR ""Ulcerative colitis"" OR ""Inflammatory bowel disease"" OR ""Crohn's disease""))",NA,oa_therapy_area,Pharma,Gastroenterology,2021,1176,320,57,342,187,35,941,235
gastroenterology  (primary search + gastroenterology tags) - pharma,"(author.affiliation.name:(""pfizer"" OR ""astrazeneca"" OR ""eli lilly"" OR ""merck"" OR ""emd serono"" OR ""msd"" OR ""merck sharp & dohme"" OR ""bristol myers squibb"" OR ""novartis"" OR ""roche"" OR ""hoffmann-la roche"" OR ""genentech"" OR ""johnson & johnson"" OR ""janssen"" OR ""biosense webster"" OR ""glaxosmithkline"" OR ""gsk"" OR ""abbvie"" OR ""sanofi"" OR ""sanofi-aventis"" OR ""gilead sciences"" OR ""takeda"" OR ""boehringer ingelheim"" OR ""myokardia"" OR ""amgen"" OR ""applied molecular genetics"" OR ""bayer"" OR ""vertex pharmaceuticals"" OR ""regeneron"" OR ""novo nordisk"" OR ""biogen"" OR ""biogen idec"" OR ""daiichi sankyo"" OR ""astellas pharma"" OR ""asuterasu seiyaku kabushiki-gaisha"" OR ""otsuka"" OR ""otsuka seiyaku kabushiki-gaisha"" OR ""astex pharmaceuticals"" OR ""ucb"" OR ""union chimique belge"" OR ""moderna"" OR ""eisai"" OR ""ezai kabushiki-gaisha"" OR ""ea pharma"" OR ""csl"" OR ""zlb behring"" OR ""jiangsu hengrui medicine"" OR ""teva pharmaceuticals"" OR ""sumitomo dainippon pharma"" OR ""dainippon sumitomo seiyaku kabushiki-gaisha"" OR ""fresenius"" OR ""fresenius se & co. kgaa"" OR ""viatris"" OR ""kyowa kirin"" OR ""kyowa hakko kirin"" OR ""ipsen"" OR ""jazz pharmaceuticals"" OR ""azur pharma"" OR ""sino biopharm"" OR ""bausch health companies"" OR ""valeant pharmaceuticals"" OR ""cspc pharmaceutical group"" OR ""galapagos"" OR ""galapagos genomics"" NOT ""La Roche College"") OR author.affiliation.ror_id_lineage:(""01xdqrp08"" OR ""00by1q217"" OR ""04b2dty93"" OR ""02891sr49"" OR ""03qd7mz70"" OR ""00gtmwv55"" OR ""02f9zrr09"" OR ""04r9x1a08"" OR ""01qat3289"" OR ""01xsqw823"" OR ""02g5p4n58"" OR ""02n6c9837"" OR ""056546b03"" OR ""04hjbmv12"" OR ""00q32j219"" OR ""03g03ge92"" OR ""04hmn8g73"" OR ""00anb1726"" OR ""02f51rf24"" OR ""0435rc536"" OR ""02jqkb192"" OR ""027y26122"" OR ""01cjash87"" OR ""013k5y296"" OR ""01n029866"" OR ""01xm4wg91"" OR ""04vvh7p27"" OR ""044tc0x05"" OR ""04ayvvz32"" OR ""01wfv3m53"" OR ""04sapgw72"" OR ""01v376g59"" OR ""01g1gvr46"" OR ""000wej815"" OR ""00d801g55"" OR ""055mhsv54"" OR ""0086q4c12"" OR ""01zgpn844"" OR ""016mq8947"" OR ""04e4j5d46"")) AND publication_type:""journal article"" AND date_published>=now-10y AND field_of_study: ((""Medicine"" OR ""Internal medicine"" OR ""Pharmacology"") AND (""Gastroenterology"" OR ""Ulcerative colitis"" OR ""Inflammatory bowel disease"" OR ""Crohn's disease""))",AND date_published>=now-10y,"AND field_of_study: ((""Medicine"" OR ""Internal medicine"" OR ""Pharmacology"") AND (""Gastroenterology"" OR ""Ulcerative colitis"" OR ""Inflammatory bowel disease"" OR ""Crohn's disease""))",NA,oa_therapy_area,Pharma,Gastroenterology,2022,1568,483,94,351,163,50,1141,427
gastroenterology  (primary search + gastroenterology tags) - pharma,"(author.affiliation.name:(""pfizer"" OR ""astrazeneca"" OR ""eli lilly"" OR ""merck"" OR ""emd serono"" OR ""msd"" OR ""merck sharp & dohme"" OR ""bristol myers squibb"" OR ""novartis"" OR ""roche"" OR ""hoffmann-la roche"" OR ""genentech"" OR ""johnson & johnson"" OR ""janssen"" OR ""biosense webster"" OR ""glaxosmithkline"" OR ""gsk"" OR ""abbvie"" OR ""sanofi"" OR ""sanofi-aventis"" OR ""gilead sciences"" OR ""takeda"" OR ""boehringer ingelheim"" OR ""myokardia"" OR ""amgen"" OR ""applied molecular genetics"" OR ""bayer"" OR ""vertex pharmaceuticals"" OR ""regeneron"" OR ""novo nordisk"" OR ""biogen"" OR ""biogen idec"" OR ""daiichi sankyo"" OR ""astellas pharma"" OR ""asuterasu seiyaku kabushiki-gaisha"" OR ""otsuka"" OR ""otsuka seiyaku kabushiki-gaisha"" OR ""astex pharmaceuticals"" OR ""ucb"" OR ""union chimique belge"" OR ""moderna"" OR ""eisai"" OR ""ezai kabushiki-gaisha"" OR ""ea pharma"" OR ""csl"" OR ""zlb behring"" OR ""jiangsu hengrui medicine"" OR ""teva pharmaceuticals"" OR ""sumitomo dainippon pharma"" OR ""dainippon sumitomo seiyaku kabushiki-gaisha"" OR ""fresenius"" OR ""fresenius se & co. kgaa"" OR ""viatris"" OR ""kyowa kirin"" OR ""kyowa hakko kirin"" OR ""ipsen"" OR ""jazz pharmaceuticals"" OR ""azur pharma"" OR ""sino biopharm"" OR ""bausch health companies"" OR ""valeant pharmaceuticals"" OR ""cspc pharmaceutical group"" OR ""galapagos"" OR ""galapagos genomics"" NOT ""La Roche College"") OR author.affiliation.ror_id_lineage:(""01xdqrp08"" OR ""00by1q217"" OR ""04b2dty93"" OR ""02891sr49"" OR ""03qd7mz70"" OR ""00gtmwv55"" OR ""02f9zrr09"" OR ""04r9x1a08"" OR ""01qat3289"" OR ""01xsqw823"" OR ""02g5p4n58"" OR ""02n6c9837"" OR ""056546b03"" OR ""04hjbmv12"" OR ""00q32j219"" OR ""03g03ge92"" OR ""04hmn8g73"" OR ""00anb1726"" OR ""02f51rf24"" OR ""0435rc536"" OR ""02jqkb192"" OR ""027y26122"" OR ""01cjash87"" OR ""013k5y296"" OR ""01n029866"" OR ""01xm4wg91"" OR ""04vvh7p27"" OR ""044tc0x05"" OR ""04ayvvz32"" OR ""01wfv3m53"" OR ""04sapgw72"" OR ""01v376g59"" OR ""01g1gvr46"" OR ""000wej815"" OR ""00d801g55"" OR ""055mhsv54"" OR ""0086q4c12"" OR ""01zgpn844"" OR ""016mq8947"" OR ""04e4j5d46"")) AND publication_type:""journal article"" AND date_published>=now-10y AND field_of_study: ((""Medicine"" OR ""Internal medicine"" OR ""Pharmacology"") AND (""Gastroenterology"" OR ""Ulcerative colitis"" OR ""Inflammatory bowel disease"" OR ""Crohn's disease""))",AND date_published>=now-10y,"AND field_of_study: ((""Medicine"" OR ""Internal medicine"" OR ""Pharmacology"") AND (""Gastroenterology"" OR ""Ulcerative colitis"" OR ""Inflammatory bowel disease"" OR ""Crohn's disease""))",NA,oa_therapy_area,Pharma,Gastroenterology,2023,716,187,8,139,128,82,544,172
microbiology (inc infections)  (primary search + microbiology tags) - pharma,"(author.affiliation.name:(""pfizer"" OR ""astrazeneca"" OR ""eli lilly"" OR ""merck"" OR ""emd serono"" OR ""msd"" OR ""merck sharp & dohme"" OR ""bristol myers squibb"" OR ""novartis"" OR ""roche"" OR ""hoffmann-la roche"" OR ""genentech"" OR ""johnson & johnson"" OR ""janssen"" OR ""biosense webster"" OR ""glaxosmithkline"" OR ""gsk"" OR ""abbvie"" OR ""sanofi"" OR ""sanofi-aventis"" OR ""gilead sciences"" OR ""takeda"" OR ""boehringer ingelheim"" OR ""myokardia"" OR ""amgen"" OR ""applied molecular genetics"" OR ""bayer"" OR ""vertex pharmaceuticals"" OR ""regeneron"" OR ""novo nordisk"" OR ""biogen"" OR ""biogen idec"" OR ""daiichi sankyo"" OR ""astellas pharma"" OR ""asuterasu seiyaku kabushiki-gaisha"" OR ""otsuka"" OR ""otsuka seiyaku kabushiki-gaisha"" OR ""astex pharmaceuticals"" OR ""ucb"" OR ""union chimique belge"" OR ""moderna"" OR ""eisai"" OR ""ezai kabushiki-gaisha"" OR ""ea pharma"" OR ""csl"" OR ""zlb behring"" OR ""jiangsu hengrui medicine"" OR ""teva pharmaceuticals"" OR ""sumitomo dainippon pharma"" OR ""dainippon sumitomo seiyaku kabushiki-gaisha"" OR ""fresenius"" OR ""fresenius se & co. kgaa"" OR ""viatris"" OR ""kyowa kirin"" OR ""kyowa hakko kirin"" OR ""ipsen"" OR ""jazz pharmaceuticals"" OR ""azur pharma"" OR ""sino biopharm"" OR ""bausch health companies"" OR ""valeant pharmaceuticals"" OR ""cspc pharmaceutical group"" OR ""galapagos"" OR ""galapagos genomics"" NOT ""La Roche College"") OR author.affiliation.ror_id_lineage:(""01xdqrp08"" OR ""00by1q217"" OR ""04b2dty93"" OR ""02891sr49"" OR ""03qd7mz70"" OR ""00gtmwv55"" OR ""02f9zrr09"" OR ""04r9x1a08"" OR ""01qat3289"" OR ""01xsqw823"" OR ""02g5p4n58"" OR ""02n6c9837"" OR ""056546b03"" OR ""04hjbmv12"" OR ""00q32j219"" OR ""03g03ge92"" OR ""04hmn8g73"" OR ""00anb1726"" OR ""02f51rf24"" OR ""0435rc536"" OR ""02jqkb192"" OR ""027y26122"" OR ""01cjash87"" OR ""013k5y296"" OR ""01n029866"" OR ""01xm4wg91"" OR ""04vvh7p27"" OR ""044tc0x05"" OR ""04ayvvz32"" OR ""01wfv3m53"" OR ""04sapgw72"" OR ""01v376g59"" OR ""01g1gvr46"" OR ""000wej815"" OR ""00d801g55"" OR ""055mhsv54"" OR ""0086q4c12"" OR ""01zgpn844"" OR ""016mq8947"" OR ""04e4j5d46"")) AND publication_type:""journal article"" AND date_published>=now-10y AND field_of_study: ((""Medicine"" OR ""Internal medicine"" OR ""Pharmacology"") AND (""Virology"" OR ""Virus"" OR ""Microbiology"" OR ""Infectious disease (medical specialty)"" OR ""Viral load"" OR ""Pneumonia"" OR ""Human immunodeficiency virus (HIV)"" OR ""Hepatitis C virus"" OR ""Hepatitis C"" OR ""Immunization"" OR ""Bacteria"" OR ""Tuberculosis"" OR ""Antibiotic resistance"" OR ""Hepatitis B virus""))",AND date_published>=now-10y,"AND field_of_study: ((""Medicine"" OR ""Internal medicine"" OR ""Pharmacology"") AND (""Virology"" OR ""Virus"" OR ""Microbiology"" OR ""Infectious disease (medical specialty)"" OR ""Viral load"" OR ""Pneumonia"" OR ""Human immunodeficiency virus (HIV)"" OR ""Hepatitis C virus"" OR ""Hepatitis C"" OR ""Immunization"" OR ""Bacteria"" OR ""Tuberculosis"" OR ""Antibiotic resistance"" OR ""Hepatitis B virus""))",NA,oa_therapy_area,Pharma,Microbiology,2013,167,39,23,16,6,1,85,82
microbiology (inc infections)  (primary search + microbiology tags) - pharma,"(author.affiliation.name:(""pfizer"" OR ""astrazeneca"" OR ""eli lilly"" OR ""merck"" OR ""emd serono"" OR ""msd"" OR ""merck sharp & dohme"" OR ""bristol myers squibb"" OR ""novartis"" OR ""roche"" OR ""hoffmann-la roche"" OR ""genentech"" OR ""johnson & johnson"" OR ""janssen"" OR ""biosense webster"" OR ""glaxosmithkline"" OR ""gsk"" OR ""abbvie"" OR ""sanofi"" OR ""sanofi-aventis"" OR ""gilead sciences"" OR ""takeda"" OR ""boehringer ingelheim"" OR ""myokardia"" OR ""amgen"" OR ""applied molecular genetics"" OR ""bayer"" OR ""vertex pharmaceuticals"" OR ""regeneron"" OR ""novo nordisk"" OR ""biogen"" OR ""biogen idec"" OR ""daiichi sankyo"" OR ""astellas pharma"" OR ""asuterasu seiyaku kabushiki-gaisha"" OR ""otsuka"" OR ""otsuka seiyaku kabushiki-gaisha"" OR ""astex pharmaceuticals"" OR ""ucb"" OR ""union chimique belge"" OR ""moderna"" OR ""eisai"" OR ""ezai kabushiki-gaisha"" OR ""ea pharma"" OR ""csl"" OR ""zlb behring"" OR ""jiangsu hengrui medicine"" OR ""teva pharmaceuticals"" OR ""sumitomo dainippon pharma"" OR ""dainippon sumitomo seiyaku kabushiki-gaisha"" OR ""fresenius"" OR ""fresenius se & co. kgaa"" OR ""viatris"" OR ""kyowa kirin"" OR ""kyowa hakko kirin"" OR ""ipsen"" OR ""jazz pharmaceuticals"" OR ""azur pharma"" OR ""sino biopharm"" OR ""bausch health companies"" OR ""valeant pharmaceuticals"" OR ""cspc pharmaceutical group"" OR ""galapagos"" OR ""galapagos genomics"" NOT ""La Roche College"") OR author.affiliation.ror_id_lineage:(""01xdqrp08"" OR ""00by1q217"" OR ""04b2dty93"" OR ""02891sr49"" OR ""03qd7mz70"" OR ""00gtmwv55"" OR ""02f9zrr09"" OR ""04r9x1a08"" OR ""01qat3289"" OR ""01xsqw823"" OR ""02g5p4n58"" OR ""02n6c9837"" OR ""056546b03"" OR ""04hjbmv12"" OR ""00q32j219"" OR ""03g03ge92"" OR ""04hmn8g73"" OR ""00anb1726"" OR ""02f51rf24"" OR ""0435rc536"" OR ""02jqkb192"" OR ""027y26122"" OR ""01cjash87"" OR ""013k5y296"" OR ""01n029866"" OR ""01xm4wg91"" OR ""04vvh7p27"" OR ""044tc0x05"" OR ""04ayvvz32"" OR ""01wfv3m53"" OR ""04sapgw72"" OR ""01v376g59"" OR ""01g1gvr46"" OR ""000wej815"" OR ""00d801g55"" OR ""055mhsv54"" OR ""0086q4c12"" OR ""01zgpn844"" OR ""016mq8947"" OR ""04e4j5d46"")) AND publication_type:""journal article"" AND date_published>=now-10y AND field_of_study: ((""Medicine"" OR ""Internal medicine"" OR ""Pharmacology"") AND (""Virology"" OR ""Virus"" OR ""Microbiology"" OR ""Infectious disease (medical specialty)"" OR ""Viral load"" OR ""Pneumonia"" OR ""Human immunodeficiency virus (HIV)"" OR ""Hepatitis C virus"" OR ""Hepatitis C"" OR ""Immunization"" OR ""Bacteria"" OR ""Tuberculosis"" OR ""Antibiotic resistance"" OR ""Hepatitis B virus""))",AND date_published>=now-10y,"AND field_of_study: ((""Medicine"" OR ""Internal medicine"" OR ""Pharmacology"") AND (""Virology"" OR ""Virus"" OR ""Microbiology"" OR ""Infectious disease (medical specialty)"" OR ""Viral load"" OR ""Pneumonia"" OR ""Human immunodeficiency virus (HIV)"" OR ""Hepatitis C virus"" OR ""Hepatitis C"" OR ""Immunization"" OR ""Bacteria"" OR ""Tuberculosis"" OR ""Antibiotic resistance"" OR ""Hepatitis B virus""))",NA,oa_therapy_area,Pharma,Microbiology,2014,548,160,84,50,26,38,358,190
microbiology (inc infections)  (primary search + microbiology tags) - pharma,"(author.affiliation.name:(""pfizer"" OR ""astrazeneca"" OR ""eli lilly"" OR ""merck"" OR ""emd serono"" OR ""msd"" OR ""merck sharp & dohme"" OR ""bristol myers squibb"" OR ""novartis"" OR ""roche"" OR ""hoffmann-la roche"" OR ""genentech"" OR ""johnson & johnson"" OR ""janssen"" OR ""biosense webster"" OR ""glaxosmithkline"" OR ""gsk"" OR ""abbvie"" OR ""sanofi"" OR ""sanofi-aventis"" OR ""gilead sciences"" OR ""takeda"" OR ""boehringer ingelheim"" OR ""myokardia"" OR ""amgen"" OR ""applied molecular genetics"" OR ""bayer"" OR ""vertex pharmaceuticals"" OR ""regeneron"" OR ""novo nordisk"" OR ""biogen"" OR ""biogen idec"" OR ""daiichi sankyo"" OR ""astellas pharma"" OR ""asuterasu seiyaku kabushiki-gaisha"" OR ""otsuka"" OR ""otsuka seiyaku kabushiki-gaisha"" OR ""astex pharmaceuticals"" OR ""ucb"" OR ""union chimique belge"" OR ""moderna"" OR ""eisai"" OR ""ezai kabushiki-gaisha"" OR ""ea pharma"" OR ""csl"" OR ""zlb behring"" OR ""jiangsu hengrui medicine"" OR ""teva pharmaceuticals"" OR ""sumitomo dainippon pharma"" OR ""dainippon sumitomo seiyaku kabushiki-gaisha"" OR ""fresenius"" OR ""fresenius se & co. kgaa"" OR ""viatris"" OR ""kyowa kirin"" OR ""kyowa hakko kirin"" OR ""ipsen"" OR ""jazz pharmaceuticals"" OR ""azur pharma"" OR ""sino biopharm"" OR ""bausch health companies"" OR ""valeant pharmaceuticals"" OR ""cspc pharmaceutical group"" OR ""galapagos"" OR ""galapagos genomics"" NOT ""La Roche College"") OR author.affiliation.ror_id_lineage:(""01xdqrp08"" OR ""00by1q217"" OR ""04b2dty93"" OR ""02891sr49"" OR ""03qd7mz70"" OR ""00gtmwv55"" OR ""02f9zrr09"" OR ""04r9x1a08"" OR ""01qat3289"" OR ""01xsqw823"" OR ""02g5p4n58"" OR ""02n6c9837"" OR ""056546b03"" OR ""04hjbmv12"" OR ""00q32j219"" OR ""03g03ge92"" OR ""04hmn8g73"" OR ""00anb1726"" OR ""02f51rf24"" OR ""0435rc536"" OR ""02jqkb192"" OR ""027y26122"" OR ""01cjash87"" OR ""013k5y296"" OR ""01n029866"" OR ""01xm4wg91"" OR ""04vvh7p27"" OR ""044tc0x05"" OR ""04ayvvz32"" OR ""01wfv3m53"" OR ""04sapgw72"" OR ""01v376g59"" OR ""01g1gvr46"" OR ""000wej815"" OR ""00d801g55"" OR ""055mhsv54"" OR ""0086q4c12"" OR ""01zgpn844"" OR ""016mq8947"" OR ""04e4j5d46"")) AND publication_type:""journal article"" AND date_published>=now-10y AND field_of_study: ((""Medicine"" OR ""Internal medicine"" OR ""Pharmacology"") AND (""Virology"" OR ""Virus"" OR ""Microbiology"" OR ""Infectious disease (medical specialty)"" OR ""Viral load"" OR ""Pneumonia"" OR ""Human immunodeficiency virus (HIV)"" OR ""Hepatitis C virus"" OR ""Hepatitis C"" OR ""Immunization"" OR ""Bacteria"" OR ""Tuberculosis"" OR ""Antibiotic resistance"" OR ""Hepatitis B virus""))",AND date_published>=now-10y,"AND field_of_study: ((""Medicine"" OR ""Internal medicine"" OR ""Pharmacology"") AND (""Virology"" OR ""Virus"" OR ""Microbiology"" OR ""Infectious disease (medical specialty)"" OR ""Viral load"" OR ""Pneumonia"" OR ""Human immunodeficiency virus (HIV)"" OR ""Hepatitis C virus"" OR ""Hepatitis C"" OR ""Immunization"" OR ""Bacteria"" OR ""Tuberculosis"" OR ""Antibiotic resistance"" OR ""Hepatitis B virus""))",NA,oa_therapy_area,Pharma,Microbiology,2015,458,120,75,67,34,3,299,159
microbiology (inc infections)  (primary search + microbiology tags) - pharma,"(author.affiliation.name:(""pfizer"" OR ""astrazeneca"" OR ""eli lilly"" OR ""merck"" OR ""emd serono"" OR ""msd"" OR ""merck sharp & dohme"" OR ""bristol myers squibb"" OR ""novartis"" OR ""roche"" OR ""hoffmann-la roche"" OR ""genentech"" OR ""johnson & johnson"" OR ""janssen"" OR ""biosense webster"" OR ""glaxosmithkline"" OR ""gsk"" OR ""abbvie"" OR ""sanofi"" OR ""sanofi-aventis"" OR ""gilead sciences"" OR ""takeda"" OR ""boehringer ingelheim"" OR ""myokardia"" OR ""amgen"" OR ""applied molecular genetics"" OR ""bayer"" OR ""vertex pharmaceuticals"" OR ""regeneron"" OR ""novo nordisk"" OR ""biogen"" OR ""biogen idec"" OR ""daiichi sankyo"" OR ""astellas pharma"" OR ""asuterasu seiyaku kabushiki-gaisha"" OR ""otsuka"" OR ""otsuka seiyaku kabushiki-gaisha"" OR ""astex pharmaceuticals"" OR ""ucb"" OR ""union chimique belge"" OR ""moderna"" OR ""eisai"" OR ""ezai kabushiki-gaisha"" OR ""ea pharma"" OR ""csl"" OR ""zlb behring"" OR ""jiangsu hengrui medicine"" OR ""teva pharmaceuticals"" OR ""sumitomo dainippon pharma"" OR ""dainippon sumitomo seiyaku kabushiki-gaisha"" OR ""fresenius"" OR ""fresenius se & co. kgaa"" OR ""viatris"" OR ""kyowa kirin"" OR ""kyowa hakko kirin"" OR ""ipsen"" OR ""jazz pharmaceuticals"" OR ""azur pharma"" OR ""sino biopharm"" OR ""bausch health companies"" OR ""valeant pharmaceuticals"" OR ""cspc pharmaceutical group"" OR ""galapagos"" OR ""galapagos genomics"" NOT ""La Roche College"") OR author.affiliation.ror_id_lineage:(""01xdqrp08"" OR ""00by1q217"" OR ""04b2dty93"" OR ""02891sr49"" OR ""03qd7mz70"" OR ""00gtmwv55"" OR ""02f9zrr09"" OR ""04r9x1a08"" OR ""01qat3289"" OR ""01xsqw823"" OR ""02g5p4n58"" OR ""02n6c9837"" OR ""056546b03"" OR ""04hjbmv12"" OR ""00q32j219"" OR ""03g03ge92"" OR ""04hmn8g73"" OR ""00anb1726"" OR ""02f51rf24"" OR ""0435rc536"" OR ""02jqkb192"" OR ""027y26122"" OR ""01cjash87"" OR ""013k5y296"" OR ""01n029866"" OR ""01xm4wg91"" OR ""04vvh7p27"" OR ""044tc0x05"" OR ""04ayvvz32"" OR ""01wfv3m53"" OR ""04sapgw72"" OR ""01v376g59"" OR ""01g1gvr46"" OR ""000wej815"" OR ""00d801g55"" OR ""055mhsv54"" OR ""0086q4c12"" OR ""01zgpn844"" OR ""016mq8947"" OR ""04e4j5d46"")) AND publication_type:""journal article"" AND date_published>=now-10y AND field_of_study: ((""Medicine"" OR ""Internal medicine"" OR ""Pharmacology"") AND (""Virology"" OR ""Virus"" OR ""Microbiology"" OR ""Infectious disease (medical specialty)"" OR ""Viral load"" OR ""Pneumonia"" OR ""Human immunodeficiency virus (HIV)"" OR ""Hepatitis C virus"" OR ""Hepatitis C"" OR ""Immunization"" OR ""Bacteria"" OR ""Tuberculosis"" OR ""Antibiotic resistance"" OR ""Hepatitis B virus""))",AND date_published>=now-10y,"AND field_of_study: ((""Medicine"" OR ""Internal medicine"" OR ""Pharmacology"") AND (""Virology"" OR ""Virus"" OR ""Microbiology"" OR ""Infectious disease (medical specialty)"" OR ""Viral load"" OR ""Pneumonia"" OR ""Human immunodeficiency virus (HIV)"" OR ""Hepatitis C virus"" OR ""Hepatitis C"" OR ""Immunization"" OR ""Bacteria"" OR ""Tuberculosis"" OR ""Antibiotic resistance"" OR ""Hepatitis B virus""))",NA,oa_therapy_area,Pharma,Microbiology,2016,542,191,71,72,44,2,380,162
microbiology (inc infections)  (primary search + microbiology tags) - pharma,"(author.affiliation.name:(""pfizer"" OR ""astrazeneca"" OR ""eli lilly"" OR ""merck"" OR ""emd serono"" OR ""msd"" OR ""merck sharp & dohme"" OR ""bristol myers squibb"" OR ""novartis"" OR ""roche"" OR ""hoffmann-la roche"" OR ""genentech"" OR ""johnson & johnson"" OR ""janssen"" OR ""biosense webster"" OR ""glaxosmithkline"" OR ""gsk"" OR ""abbvie"" OR ""sanofi"" OR ""sanofi-aventis"" OR ""gilead sciences"" OR ""takeda"" OR ""boehringer ingelheim"" OR ""myokardia"" OR ""amgen"" OR ""applied molecular genetics"" OR ""bayer"" OR ""vertex pharmaceuticals"" OR ""regeneron"" OR ""novo nordisk"" OR ""biogen"" OR ""biogen idec"" OR ""daiichi sankyo"" OR ""astellas pharma"" OR ""asuterasu seiyaku kabushiki-gaisha"" OR ""otsuka"" OR ""otsuka seiyaku kabushiki-gaisha"" OR ""astex pharmaceuticals"" OR ""ucb"" OR ""union chimique belge"" OR ""moderna"" OR ""eisai"" OR ""ezai kabushiki-gaisha"" OR ""ea pharma"" OR ""csl"" OR ""zlb behring"" OR ""jiangsu hengrui medicine"" OR ""teva pharmaceuticals"" OR ""sumitomo dainippon pharma"" OR ""dainippon sumitomo seiyaku kabushiki-gaisha"" OR ""fresenius"" OR ""fresenius se & co. kgaa"" OR ""viatris"" OR ""kyowa kirin"" OR ""kyowa hakko kirin"" OR ""ipsen"" OR ""jazz pharmaceuticals"" OR ""azur pharma"" OR ""sino biopharm"" OR ""bausch health companies"" OR ""valeant pharmaceuticals"" OR ""cspc pharmaceutical group"" OR ""galapagos"" OR ""galapagos genomics"" NOT ""La Roche College"") OR author.affiliation.ror_id_lineage:(""01xdqrp08"" OR ""00by1q217"" OR ""04b2dty93"" OR ""02891sr49"" OR ""03qd7mz70"" OR ""00gtmwv55"" OR ""02f9zrr09"" OR ""04r9x1a08"" OR ""01qat3289"" OR ""01xsqw823"" OR ""02g5p4n58"" OR ""02n6c9837"" OR ""056546b03"" OR ""04hjbmv12"" OR ""00q32j219"" OR ""03g03ge92"" OR ""04hmn8g73"" OR ""00anb1726"" OR ""02f51rf24"" OR ""0435rc536"" OR ""02jqkb192"" OR ""027y26122"" OR ""01cjash87"" OR ""013k5y296"" OR ""01n029866"" OR ""01xm4wg91"" OR ""04vvh7p27"" OR ""044tc0x05"" OR ""04ayvvz32"" OR ""01wfv3m53"" OR ""04sapgw72"" OR ""01v376g59"" OR ""01g1gvr46"" OR ""000wej815"" OR ""00d801g55"" OR ""055mhsv54"" OR ""0086q4c12"" OR ""01zgpn844"" OR ""016mq8947"" OR ""04e4j5d46"")) AND publication_type:""journal article"" AND date_published>=now-10y AND field_of_study: ((""Medicine"" OR ""Internal medicine"" OR ""Pharmacology"") AND (""Virology"" OR ""Virus"" OR ""Microbiology"" OR ""Infectious disease (medical specialty)"" OR ""Viral load"" OR ""Pneumonia"" OR ""Human immunodeficiency virus (HIV)"" OR ""Hepatitis C virus"" OR ""Hepatitis C"" OR ""Immunization"" OR ""Bacteria"" OR ""Tuberculosis"" OR ""Antibiotic resistance"" OR ""Hepatitis B virus""))",AND date_published>=now-10y,"AND field_of_study: ((""Medicine"" OR ""Internal medicine"" OR ""Pharmacology"") AND (""Virology"" OR ""Virus"" OR ""Microbiology"" OR ""Infectious disease (medical specialty)"" OR ""Viral load"" OR ""Pneumonia"" OR ""Human immunodeficiency virus (HIV)"" OR ""Hepatitis C virus"" OR ""Hepatitis C"" OR ""Immunization"" OR ""Bacteria"" OR ""Tuberculosis"" OR ""Antibiotic resistance"" OR ""Hepatitis B virus""))",NA,oa_therapy_area,Pharma,Microbiology,2017,530,198,83,69,32,5,387,143
microbiology (inc infections)  (primary search + microbiology tags) - pharma,"(author.affiliation.name:(""pfizer"" OR ""astrazeneca"" OR ""eli lilly"" OR ""merck"" OR ""emd serono"" OR ""msd"" OR ""merck sharp & dohme"" OR ""bristol myers squibb"" OR ""novartis"" OR ""roche"" OR ""hoffmann-la roche"" OR ""genentech"" OR ""johnson & johnson"" OR ""janssen"" OR ""biosense webster"" OR ""glaxosmithkline"" OR ""gsk"" OR ""abbvie"" OR ""sanofi"" OR ""sanofi-aventis"" OR ""gilead sciences"" OR ""takeda"" OR ""boehringer ingelheim"" OR ""myokardia"" OR ""amgen"" OR ""applied molecular genetics"" OR ""bayer"" OR ""vertex pharmaceuticals"" OR ""regeneron"" OR ""novo nordisk"" OR ""biogen"" OR ""biogen idec"" OR ""daiichi sankyo"" OR ""astellas pharma"" OR ""asuterasu seiyaku kabushiki-gaisha"" OR ""otsuka"" OR ""otsuka seiyaku kabushiki-gaisha"" OR ""astex pharmaceuticals"" OR ""ucb"" OR ""union chimique belge"" OR ""moderna"" OR ""eisai"" OR ""ezai kabushiki-gaisha"" OR ""ea pharma"" OR ""csl"" OR ""zlb behring"" OR ""jiangsu hengrui medicine"" OR ""teva pharmaceuticals"" OR ""sumitomo dainippon pharma"" OR ""dainippon sumitomo seiyaku kabushiki-gaisha"" OR ""fresenius"" OR ""fresenius se & co. kgaa"" OR ""viatris"" OR ""kyowa kirin"" OR ""kyowa hakko kirin"" OR ""ipsen"" OR ""jazz pharmaceuticals"" OR ""azur pharma"" OR ""sino biopharm"" OR ""bausch health companies"" OR ""valeant pharmaceuticals"" OR ""cspc pharmaceutical group"" OR ""galapagos"" OR ""galapagos genomics"" NOT ""La Roche College"") OR author.affiliation.ror_id_lineage:(""01xdqrp08"" OR ""00by1q217"" OR ""04b2dty93"" OR ""02891sr49"" OR ""03qd7mz70"" OR ""00gtmwv55"" OR ""02f9zrr09"" OR ""04r9x1a08"" OR ""01qat3289"" OR ""01xsqw823"" OR ""02g5p4n58"" OR ""02n6c9837"" OR ""056546b03"" OR ""04hjbmv12"" OR ""00q32j219"" OR ""03g03ge92"" OR ""04hmn8g73"" OR ""00anb1726"" OR ""02f51rf24"" OR ""0435rc536"" OR ""02jqkb192"" OR ""027y26122"" OR ""01cjash87"" OR ""013k5y296"" OR ""01n029866"" OR ""01xm4wg91"" OR ""04vvh7p27"" OR ""044tc0x05"" OR ""04ayvvz32"" OR ""01wfv3m53"" OR ""04sapgw72"" OR ""01v376g59"" OR ""01g1gvr46"" OR ""000wej815"" OR ""00d801g55"" OR ""055mhsv54"" OR ""0086q4c12"" OR ""01zgpn844"" OR ""016mq8947"" OR ""04e4j5d46"")) AND publication_type:""journal article"" AND date_published>=now-10y AND field_of_study: ((""Medicine"" OR ""Internal medicine"" OR ""Pharmacology"") AND (""Virology"" OR ""Virus"" OR ""Microbiology"" OR ""Infectious disease (medical specialty)"" OR ""Viral load"" OR ""Pneumonia"" OR ""Human immunodeficiency virus (HIV)"" OR ""Hepatitis C virus"" OR ""Hepatitis C"" OR ""Immunization"" OR ""Bacteria"" OR ""Tuberculosis"" OR ""Antibiotic resistance"" OR ""Hepatitis B virus""))",AND date_published>=now-10y,"AND field_of_study: ((""Medicine"" OR ""Internal medicine"" OR ""Pharmacology"") AND (""Virology"" OR ""Virus"" OR ""Microbiology"" OR ""Infectious disease (medical specialty)"" OR ""Viral load"" OR ""Pneumonia"" OR ""Human immunodeficiency virus (HIV)"" OR ""Hepatitis C virus"" OR ""Hepatitis C"" OR ""Immunization"" OR ""Bacteria"" OR ""Tuberculosis"" OR ""Antibiotic resistance"" OR ""Hepatitis B virus""))",NA,oa_therapy_area,Pharma,Microbiology,2018,500,210,59,81,30,1,381,119
microbiology (inc infections)  (primary search + microbiology tags) - pharma,"(author.affiliation.name:(""pfizer"" OR ""astrazeneca"" OR ""eli lilly"" OR ""merck"" OR ""emd serono"" OR ""msd"" OR ""merck sharp & dohme"" OR ""bristol myers squibb"" OR ""novartis"" OR ""roche"" OR ""hoffmann-la roche"" OR ""genentech"" OR ""johnson & johnson"" OR ""janssen"" OR ""biosense webster"" OR ""glaxosmithkline"" OR ""gsk"" OR ""abbvie"" OR ""sanofi"" OR ""sanofi-aventis"" OR ""gilead sciences"" OR ""takeda"" OR ""boehringer ingelheim"" OR ""myokardia"" OR ""amgen"" OR ""applied molecular genetics"" OR ""bayer"" OR ""vertex pharmaceuticals"" OR ""regeneron"" OR ""novo nordisk"" OR ""biogen"" OR ""biogen idec"" OR ""daiichi sankyo"" OR ""astellas pharma"" OR ""asuterasu seiyaku kabushiki-gaisha"" OR ""otsuka"" OR ""otsuka seiyaku kabushiki-gaisha"" OR ""astex pharmaceuticals"" OR ""ucb"" OR ""union chimique belge"" OR ""moderna"" OR ""eisai"" OR ""ezai kabushiki-gaisha"" OR ""ea pharma"" OR ""csl"" OR ""zlb behring"" OR ""jiangsu hengrui medicine"" OR ""teva pharmaceuticals"" OR ""sumitomo dainippon pharma"" OR ""dainippon sumitomo seiyaku kabushiki-gaisha"" OR ""fresenius"" OR ""fresenius se & co. kgaa"" OR ""viatris"" OR ""kyowa kirin"" OR ""kyowa hakko kirin"" OR ""ipsen"" OR ""jazz pharmaceuticals"" OR ""azur pharma"" OR ""sino biopharm"" OR ""bausch health companies"" OR ""valeant pharmaceuticals"" OR ""cspc pharmaceutical group"" OR ""galapagos"" OR ""galapagos genomics"" NOT ""La Roche College"") OR author.affiliation.ror_id_lineage:(""01xdqrp08"" OR ""00by1q217"" OR ""04b2dty93"" OR ""02891sr49"" OR ""03qd7mz70"" OR ""00gtmwv55"" OR ""02f9zrr09"" OR ""04r9x1a08"" OR ""01qat3289"" OR ""01xsqw823"" OR ""02g5p4n58"" OR ""02n6c9837"" OR ""056546b03"" OR ""04hjbmv12"" OR ""00q32j219"" OR ""03g03ge92"" OR ""04hmn8g73"" OR ""00anb1726"" OR ""02f51rf24"" OR ""0435rc536"" OR ""02jqkb192"" OR ""027y26122"" OR ""01cjash87"" OR ""013k5y296"" OR ""01n029866"" OR ""01xm4wg91"" OR ""04vvh7p27"" OR ""044tc0x05"" OR ""04ayvvz32"" OR ""01wfv3m53"" OR ""04sapgw72"" OR ""01v376g59"" OR ""01g1gvr46"" OR ""000wej815"" OR ""00d801g55"" OR ""055mhsv54"" OR ""0086q4c12"" OR ""01zgpn844"" OR ""016mq8947"" OR ""04e4j5d46"")) AND publication_type:""journal article"" AND date_published>=now-10y AND field_of_study: ((""Medicine"" OR ""Internal medicine"" OR ""Pharmacology"") AND (""Virology"" OR ""Virus"" OR ""Microbiology"" OR ""Infectious disease (medical specialty)"" OR ""Viral load"" OR ""Pneumonia"" OR ""Human immunodeficiency virus (HIV)"" OR ""Hepatitis C virus"" OR ""Hepatitis C"" OR ""Immunization"" OR ""Bacteria"" OR ""Tuberculosis"" OR ""Antibiotic resistance"" OR ""Hepatitis B virus""))",AND date_published>=now-10y,"AND field_of_study: ((""Medicine"" OR ""Internal medicine"" OR ""Pharmacology"") AND (""Virology"" OR ""Virus"" OR ""Microbiology"" OR ""Infectious disease (medical specialty)"" OR ""Viral load"" OR ""Pneumonia"" OR ""Human immunodeficiency virus (HIV)"" OR ""Hepatitis C virus"" OR ""Hepatitis C"" OR ""Immunization"" OR ""Bacteria"" OR ""Tuberculosis"" OR ""Antibiotic resistance"" OR ""Hepatitis B virus""))",NA,oa_therapy_area,Pharma,Microbiology,2019,474,215,47,92,22,2,378,96
microbiology (inc infections)  (primary search + microbiology tags) - pharma,"(author.affiliation.name:(""pfizer"" OR ""astrazeneca"" OR ""eli lilly"" OR ""merck"" OR ""emd serono"" OR ""msd"" OR ""merck sharp & dohme"" OR ""bristol myers squibb"" OR ""novartis"" OR ""roche"" OR ""hoffmann-la roche"" OR ""genentech"" OR ""johnson & johnson"" OR ""janssen"" OR ""biosense webster"" OR ""glaxosmithkline"" OR ""gsk"" OR ""abbvie"" OR ""sanofi"" OR ""sanofi-aventis"" OR ""gilead sciences"" OR ""takeda"" OR ""boehringer ingelheim"" OR ""myokardia"" OR ""amgen"" OR ""applied molecular genetics"" OR ""bayer"" OR ""vertex pharmaceuticals"" OR ""regeneron"" OR ""novo nordisk"" OR ""biogen"" OR ""biogen idec"" OR ""daiichi sankyo"" OR ""astellas pharma"" OR ""asuterasu seiyaku kabushiki-gaisha"" OR ""otsuka"" OR ""otsuka seiyaku kabushiki-gaisha"" OR ""astex pharmaceuticals"" OR ""ucb"" OR ""union chimique belge"" OR ""moderna"" OR ""eisai"" OR ""ezai kabushiki-gaisha"" OR ""ea pharma"" OR ""csl"" OR ""zlb behring"" OR ""jiangsu hengrui medicine"" OR ""teva pharmaceuticals"" OR ""sumitomo dainippon pharma"" OR ""dainippon sumitomo seiyaku kabushiki-gaisha"" OR ""fresenius"" OR ""fresenius se & co. kgaa"" OR ""viatris"" OR ""kyowa kirin"" OR ""kyowa hakko kirin"" OR ""ipsen"" OR ""jazz pharmaceuticals"" OR ""azur pharma"" OR ""sino biopharm"" OR ""bausch health companies"" OR ""valeant pharmaceuticals"" OR ""cspc pharmaceutical group"" OR ""galapagos"" OR ""galapagos genomics"" NOT ""La Roche College"") OR author.affiliation.ror_id_lineage:(""01xdqrp08"" OR ""00by1q217"" OR ""04b2dty93"" OR ""02891sr49"" OR ""03qd7mz70"" OR ""00gtmwv55"" OR ""02f9zrr09"" OR ""04r9x1a08"" OR ""01qat3289"" OR ""01xsqw823"" OR ""02g5p4n58"" OR ""02n6c9837"" OR ""056546b03"" OR ""04hjbmv12"" OR ""00q32j219"" OR ""03g03ge92"" OR ""04hmn8g73"" OR ""00anb1726"" OR ""02f51rf24"" OR ""0435rc536"" OR ""02jqkb192"" OR ""027y26122"" OR ""01cjash87"" OR ""013k5y296"" OR ""01n029866"" OR ""01xm4wg91"" OR ""04vvh7p27"" OR ""044tc0x05"" OR ""04ayvvz32"" OR ""01wfv3m53"" OR ""04sapgw72"" OR ""01v376g59"" OR ""01g1gvr46"" OR ""000wej815"" OR ""00d801g55"" OR ""055mhsv54"" OR ""0086q4c12"" OR ""01zgpn844"" OR ""016mq8947"" OR ""04e4j5d46"")) AND publication_type:""journal article"" AND date_published>=now-10y AND field_of_study: ((""Medicine"" OR ""Internal medicine"" OR ""Pharmacology"") AND (""Virology"" OR ""Virus"" OR ""Microbiology"" OR ""Infectious disease (medical specialty)"" OR ""Viral load"" OR ""Pneumonia"" OR ""Human immunodeficiency virus (HIV)"" OR ""Hepatitis C virus"" OR ""Hepatitis C"" OR ""Immunization"" OR ""Bacteria"" OR ""Tuberculosis"" OR ""Antibiotic resistance"" OR ""Hepatitis B virus""))",AND date_published>=now-10y,"AND field_of_study: ((""Medicine"" OR ""Internal medicine"" OR ""Pharmacology"") AND (""Virology"" OR ""Virus"" OR ""Microbiology"" OR ""Infectious disease (medical specialty)"" OR ""Viral load"" OR ""Pneumonia"" OR ""Human immunodeficiency virus (HIV)"" OR ""Hepatitis C virus"" OR ""Hepatitis C"" OR ""Immunization"" OR ""Bacteria"" OR ""Tuberculosis"" OR ""Antibiotic resistance"" OR ""Hepatitis B virus""))",NA,oa_therapy_area,Pharma,Microbiology,2020,584,251,92,106,39,2,490,94
microbiology (inc infections)  (primary search + microbiology tags) - pharma,"(author.affiliation.name:(""pfizer"" OR ""astrazeneca"" OR ""eli lilly"" OR ""merck"" OR ""emd serono"" OR ""msd"" OR ""merck sharp & dohme"" OR ""bristol myers squibb"" OR ""novartis"" OR ""roche"" OR ""hoffmann-la roche"" OR ""genentech"" OR ""johnson & johnson"" OR ""janssen"" OR ""biosense webster"" OR ""glaxosmithkline"" OR ""gsk"" OR ""abbvie"" OR ""sanofi"" OR ""sanofi-aventis"" OR ""gilead sciences"" OR ""takeda"" OR ""boehringer ingelheim"" OR ""myokardia"" OR ""amgen"" OR ""applied molecular genetics"" OR ""bayer"" OR ""vertex pharmaceuticals"" OR ""regeneron"" OR ""novo nordisk"" OR ""biogen"" OR ""biogen idec"" OR ""daiichi sankyo"" OR ""astellas pharma"" OR ""asuterasu seiyaku kabushiki-gaisha"" OR ""otsuka"" OR ""otsuka seiyaku kabushiki-gaisha"" OR ""astex pharmaceuticals"" OR ""ucb"" OR ""union chimique belge"" OR ""moderna"" OR ""eisai"" OR ""ezai kabushiki-gaisha"" OR ""ea pharma"" OR ""csl"" OR ""zlb behring"" OR ""jiangsu hengrui medicine"" OR ""teva pharmaceuticals"" OR ""sumitomo dainippon pharma"" OR ""dainippon sumitomo seiyaku kabushiki-gaisha"" OR ""fresenius"" OR ""fresenius se & co. kgaa"" OR ""viatris"" OR ""kyowa kirin"" OR ""kyowa hakko kirin"" OR ""ipsen"" OR ""jazz pharmaceuticals"" OR ""azur pharma"" OR ""sino biopharm"" OR ""bausch health companies"" OR ""valeant pharmaceuticals"" OR ""cspc pharmaceutical group"" OR ""galapagos"" OR ""galapagos genomics"" NOT ""La Roche College"") OR author.affiliation.ror_id_lineage:(""01xdqrp08"" OR ""00by1q217"" OR ""04b2dty93"" OR ""02891sr49"" OR ""03qd7mz70"" OR ""00gtmwv55"" OR ""02f9zrr09"" OR ""04r9x1a08"" OR ""01qat3289"" OR ""01xsqw823"" OR ""02g5p4n58"" OR ""02n6c9837"" OR ""056546b03"" OR ""04hjbmv12"" OR ""00q32j219"" OR ""03g03ge92"" OR ""04hmn8g73"" OR ""00anb1726"" OR ""02f51rf24"" OR ""0435rc536"" OR ""02jqkb192"" OR ""027y26122"" OR ""01cjash87"" OR ""013k5y296"" OR ""01n029866"" OR ""01xm4wg91"" OR ""04vvh7p27"" OR ""044tc0x05"" OR ""04ayvvz32"" OR ""01wfv3m53"" OR ""04sapgw72"" OR ""01v376g59"" OR ""01g1gvr46"" OR ""000wej815"" OR ""00d801g55"" OR ""055mhsv54"" OR ""0086q4c12"" OR ""01zgpn844"" OR ""016mq8947"" OR ""04e4j5d46"")) AND publication_type:""journal article"" AND date_published>=now-10y AND field_of_study: ((""Medicine"" OR ""Internal medicine"" OR ""Pharmacology"") AND (""Virology"" OR ""Virus"" OR ""Microbiology"" OR ""Infectious disease (medical specialty)"" OR ""Viral load"" OR ""Pneumonia"" OR ""Human immunodeficiency virus (HIV)"" OR ""Hepatitis C virus"" OR ""Hepatitis C"" OR ""Immunization"" OR ""Bacteria"" OR ""Tuberculosis"" OR ""Antibiotic resistance"" OR ""Hepatitis B virus""))",AND date_published>=now-10y,"AND field_of_study: ((""Medicine"" OR ""Internal medicine"" OR ""Pharmacology"") AND (""Virology"" OR ""Virus"" OR ""Microbiology"" OR ""Infectious disease (medical specialty)"" OR ""Viral load"" OR ""Pneumonia"" OR ""Human immunodeficiency virus (HIV)"" OR ""Hepatitis C virus"" OR ""Hepatitis C"" OR ""Immunization"" OR ""Bacteria"" OR ""Tuberculosis"" OR ""Antibiotic resistance"" OR ""Hepatitis B virus""))",NA,oa_therapy_area,Pharma,Microbiology,2021,764,408,70,166,28,5,677,87
microbiology (inc infections)  (primary search + microbiology tags) - pharma,"(author.affiliation.name:(""pfizer"" OR ""astrazeneca"" OR ""eli lilly"" OR ""merck"" OR ""emd serono"" OR ""msd"" OR ""merck sharp & dohme"" OR ""bristol myers squibb"" OR ""novartis"" OR ""roche"" OR ""hoffmann-la roche"" OR ""genentech"" OR ""johnson & johnson"" OR ""janssen"" OR ""biosense webster"" OR ""glaxosmithkline"" OR ""gsk"" OR ""abbvie"" OR ""sanofi"" OR ""sanofi-aventis"" OR ""gilead sciences"" OR ""takeda"" OR ""boehringer ingelheim"" OR ""myokardia"" OR ""amgen"" OR ""applied molecular genetics"" OR ""bayer"" OR ""vertex pharmaceuticals"" OR ""regeneron"" OR ""novo nordisk"" OR ""biogen"" OR ""biogen idec"" OR ""daiichi sankyo"" OR ""astellas pharma"" OR ""asuterasu seiyaku kabushiki-gaisha"" OR ""otsuka"" OR ""otsuka seiyaku kabushiki-gaisha"" OR ""astex pharmaceuticals"" OR ""ucb"" OR ""union chimique belge"" OR ""moderna"" OR ""eisai"" OR ""ezai kabushiki-gaisha"" OR ""ea pharma"" OR ""csl"" OR ""zlb behring"" OR ""jiangsu hengrui medicine"" OR ""teva pharmaceuticals"" OR ""sumitomo dainippon pharma"" OR ""dainippon sumitomo seiyaku kabushiki-gaisha"" OR ""fresenius"" OR ""fresenius se & co. kgaa"" OR ""viatris"" OR ""kyowa kirin"" OR ""kyowa hakko kirin"" OR ""ipsen"" OR ""jazz pharmaceuticals"" OR ""azur pharma"" OR ""sino biopharm"" OR ""bausch health companies"" OR ""valeant pharmaceuticals"" OR ""cspc pharmaceutical group"" OR ""galapagos"" OR ""galapagos genomics"" NOT ""La Roche College"") OR author.affiliation.ror_id_lineage:(""01xdqrp08"" OR ""00by1q217"" OR ""04b2dty93"" OR ""02891sr49"" OR ""03qd7mz70"" OR ""00gtmwv55"" OR ""02f9zrr09"" OR ""04r9x1a08"" OR ""01qat3289"" OR ""01xsqw823"" OR ""02g5p4n58"" OR ""02n6c9837"" OR ""056546b03"" OR ""04hjbmv12"" OR ""00q32j219"" OR ""03g03ge92"" OR ""04hmn8g73"" OR ""00anb1726"" OR ""02f51rf24"" OR ""0435rc536"" OR ""02jqkb192"" OR ""027y26122"" OR ""01cjash87"" OR ""013k5y296"" OR ""01n029866"" OR ""01xm4wg91"" OR ""04vvh7p27"" OR ""044tc0x05"" OR ""04ayvvz32"" OR ""01wfv3m53"" OR ""04sapgw72"" OR ""01v376g59"" OR ""01g1gvr46"" OR ""000wej815"" OR ""00d801g55"" OR ""055mhsv54"" OR ""0086q4c12"" OR ""01zgpn844"" OR ""016mq8947"" OR ""04e4j5d46"")) AND publication_type:""journal article"" AND date_published>=now-10y AND field_of_study: ((""Medicine"" OR ""Internal medicine"" OR ""Pharmacology"") AND (""Virology"" OR ""Virus"" OR ""Microbiology"" OR ""Infectious disease (medical specialty)"" OR ""Viral load"" OR ""Pneumonia"" OR ""Human immunodeficiency virus (HIV)"" OR ""Hepatitis C virus"" OR ""Hepatitis C"" OR ""Immunization"" OR ""Bacteria"" OR ""Tuberculosis"" OR ""Antibiotic resistance"" OR ""Hepatitis B virus""))",AND date_published>=now-10y,"AND field_of_study: ((""Medicine"" OR ""Internal medicine"" OR ""Pharmacology"") AND (""Virology"" OR ""Virus"" OR ""Microbiology"" OR ""Infectious disease (medical specialty)"" OR ""Viral load"" OR ""Pneumonia"" OR ""Human immunodeficiency virus (HIV)"" OR ""Hepatitis C virus"" OR ""Hepatitis C"" OR ""Immunization"" OR ""Bacteria"" OR ""Tuberculosis"" OR ""Antibiotic resistance"" OR ""Hepatitis B virus""))",NA,oa_therapy_area,Pharma,Microbiology,2022,1575,877,115,270,77,25,1364,211
microbiology (inc infections)  (primary search + microbiology tags) - pharma,"(author.affiliation.name:(""pfizer"" OR ""astrazeneca"" OR ""eli lilly"" OR ""merck"" OR ""emd serono"" OR ""msd"" OR ""merck sharp & dohme"" OR ""bristol myers squibb"" OR ""novartis"" OR ""roche"" OR ""hoffmann-la roche"" OR ""genentech"" OR ""johnson & johnson"" OR ""janssen"" OR ""biosense webster"" OR ""glaxosmithkline"" OR ""gsk"" OR ""abbvie"" OR ""sanofi"" OR ""sanofi-aventis"" OR ""gilead sciences"" OR ""takeda"" OR ""boehringer ingelheim"" OR ""myokardia"" OR ""amgen"" OR ""applied molecular genetics"" OR ""bayer"" OR ""vertex pharmaceuticals"" OR ""regeneron"" OR ""novo nordisk"" OR ""biogen"" OR ""biogen idec"" OR ""daiichi sankyo"" OR ""astellas pharma"" OR ""asuterasu seiyaku kabushiki-gaisha"" OR ""otsuka"" OR ""otsuka seiyaku kabushiki-gaisha"" OR ""astex pharmaceuticals"" OR ""ucb"" OR ""union chimique belge"" OR ""moderna"" OR ""eisai"" OR ""ezai kabushiki-gaisha"" OR ""ea pharma"" OR ""csl"" OR ""zlb behring"" OR ""jiangsu hengrui medicine"" OR ""teva pharmaceuticals"" OR ""sumitomo dainippon pharma"" OR ""dainippon sumitomo seiyaku kabushiki-gaisha"" OR ""fresenius"" OR ""fresenius se & co. kgaa"" OR ""viatris"" OR ""kyowa kirin"" OR ""kyowa hakko kirin"" OR ""ipsen"" OR ""jazz pharmaceuticals"" OR ""azur pharma"" OR ""sino biopharm"" OR ""bausch health companies"" OR ""valeant pharmaceuticals"" OR ""cspc pharmaceutical group"" OR ""galapagos"" OR ""galapagos genomics"" NOT ""La Roche College"") OR author.affiliation.ror_id_lineage:(""01xdqrp08"" OR ""00by1q217"" OR ""04b2dty93"" OR ""02891sr49"" OR ""03qd7mz70"" OR ""00gtmwv55"" OR ""02f9zrr09"" OR ""04r9x1a08"" OR ""01qat3289"" OR ""01xsqw823"" OR ""02g5p4n58"" OR ""02n6c9837"" OR ""056546b03"" OR ""04hjbmv12"" OR ""00q32j219"" OR ""03g03ge92"" OR ""04hmn8g73"" OR ""00anb1726"" OR ""02f51rf24"" OR ""0435rc536"" OR ""02jqkb192"" OR ""027y26122"" OR ""01cjash87"" OR ""013k5y296"" OR ""01n029866"" OR ""01xm4wg91"" OR ""04vvh7p27"" OR ""044tc0x05"" OR ""04ayvvz32"" OR ""01wfv3m53"" OR ""04sapgw72"" OR ""01v376g59"" OR ""01g1gvr46"" OR ""000wej815"" OR ""00d801g55"" OR ""055mhsv54"" OR ""0086q4c12"" OR ""01zgpn844"" OR ""016mq8947"" OR ""04e4j5d46"")) AND publication_type:""journal article"" AND date_published>=now-10y AND field_of_study: ((""Medicine"" OR ""Internal medicine"" OR ""Pharmacology"") AND (""Virology"" OR ""Virus"" OR ""Microbiology"" OR ""Infectious disease (medical specialty)"" OR ""Viral load"" OR ""Pneumonia"" OR ""Human immunodeficiency virus (HIV)"" OR ""Hepatitis C virus"" OR ""Hepatitis C"" OR ""Immunization"" OR ""Bacteria"" OR ""Tuberculosis"" OR ""Antibiotic resistance"" OR ""Hepatitis B virus""))",AND date_published>=now-10y,"AND field_of_study: ((""Medicine"" OR ""Internal medicine"" OR ""Pharmacology"") AND (""Virology"" OR ""Virus"" OR ""Microbiology"" OR ""Infectious disease (medical specialty)"" OR ""Viral load"" OR ""Pneumonia"" OR ""Human immunodeficiency virus (HIV)"" OR ""Hepatitis C virus"" OR ""Hepatitis C"" OR ""Immunization"" OR ""Bacteria"" OR ""Tuberculosis"" OR ""Antibiotic resistance"" OR ""Hepatitis B virus""))",NA,oa_therapy_area,Pharma,Microbiology,2023,586,325,19,85,16,41,486,100
psychiatry (primary search + psychiatry tags) - pharma,"(author.affiliation.name:(""pfizer"" OR ""astrazeneca"" OR ""eli lilly"" OR ""merck"" OR ""emd serono"" OR ""msd"" OR ""merck sharp & dohme"" OR ""bristol myers squibb"" OR ""novartis"" OR ""roche"" OR ""hoffmann-la roche"" OR ""genentech"" OR ""johnson & johnson"" OR ""janssen"" OR ""biosense webster"" OR ""glaxosmithkline"" OR ""gsk"" OR ""abbvie"" OR ""sanofi"" OR ""sanofi-aventis"" OR ""gilead sciences"" OR ""takeda"" OR ""boehringer ingelheim"" OR ""myokardia"" OR ""amgen"" OR ""applied molecular genetics"" OR ""bayer"" OR ""vertex pharmaceuticals"" OR ""regeneron"" OR ""novo nordisk"" OR ""biogen"" OR ""biogen idec"" OR ""daiichi sankyo"" OR ""astellas pharma"" OR ""asuterasu seiyaku kabushiki-gaisha"" OR ""otsuka"" OR ""otsuka seiyaku kabushiki-gaisha"" OR ""astex pharmaceuticals"" OR ""ucb"" OR ""union chimique belge"" OR ""moderna"" OR ""eisai"" OR ""ezai kabushiki-gaisha"" OR ""ea pharma"" OR ""csl"" OR ""zlb behring"" OR ""jiangsu hengrui medicine"" OR ""teva pharmaceuticals"" OR ""sumitomo dainippon pharma"" OR ""dainippon sumitomo seiyaku kabushiki-gaisha"" OR ""fresenius"" OR ""fresenius se & co. kgaa"" OR ""viatris"" OR ""kyowa kirin"" OR ""kyowa hakko kirin"" OR ""ipsen"" OR ""jazz pharmaceuticals"" OR ""azur pharma"" OR ""sino biopharm"" OR ""bausch health companies"" OR ""valeant pharmaceuticals"" OR ""cspc pharmaceutical group"" OR ""galapagos"" OR ""galapagos genomics"" NOT ""La Roche College"") OR author.affiliation.ror_id_lineage:(""01xdqrp08"" OR ""00by1q217"" OR ""04b2dty93"" OR ""02891sr49"" OR ""03qd7mz70"" OR ""00gtmwv55"" OR ""02f9zrr09"" OR ""04r9x1a08"" OR ""01qat3289"" OR ""01xsqw823"" OR ""02g5p4n58"" OR ""02n6c9837"" OR ""056546b03"" OR ""04hjbmv12"" OR ""00q32j219"" OR ""03g03ge92"" OR ""04hmn8g73"" OR ""00anb1726"" OR ""02f51rf24"" OR ""0435rc536"" OR ""02jqkb192"" OR ""027y26122"" OR ""01cjash87"" OR ""013k5y296"" OR ""01n029866"" OR ""01xm4wg91"" OR ""04vvh7p27"" OR ""044tc0x05"" OR ""04ayvvz32"" OR ""01wfv3m53"" OR ""04sapgw72"" OR ""01v376g59"" OR ""01g1gvr46"" OR ""000wej815"" OR ""00d801g55"" OR ""055mhsv54"" OR ""0086q4c12"" OR ""01zgpn844"" OR ""016mq8947"" OR ""04e4j5d46"")) AND publication_type:""journal article"" AND date_published>=now-10y AND field_of_study: ((""Medicine"" OR ""Internal medicine"" OR ""Pharmacology"") AND (""Psychiatry"" OR ""Psychology"" OR ""Psychological intervention"" OR ""Dementia"" OR ""Clinical psychology"" OR ""Anxiety"" OR ""Major depressive disorder"" OR ""Schizophrenia"" OR ""Alzheimer's disease""))",AND date_published>=now-10y,"AND field_of_study: ((""Medicine"" OR ""Internal medicine"" OR ""Pharmacology"") AND (""Psychiatry"" OR ""Psychology"" OR ""Psychological intervention"" OR ""Dementia"" OR ""Clinical psychology"" OR ""Anxiety"" OR ""Major depressive disorder"" OR ""Schizophrenia"" OR ""Alzheimer's disease""))",NA,oa_therapy_area,Pharma,Psychiatry,2013,148,46,21,7,4,3,81,67
psychiatry (primary search + psychiatry tags) - pharma,"(author.affiliation.name:(""pfizer"" OR ""astrazeneca"" OR ""eli lilly"" OR ""merck"" OR ""emd serono"" OR ""msd"" OR ""merck sharp & dohme"" OR ""bristol myers squibb"" OR ""novartis"" OR ""roche"" OR ""hoffmann-la roche"" OR ""genentech"" OR ""johnson & johnson"" OR ""janssen"" OR ""biosense webster"" OR ""glaxosmithkline"" OR ""gsk"" OR ""abbvie"" OR ""sanofi"" OR ""sanofi-aventis"" OR ""gilead sciences"" OR ""takeda"" OR ""boehringer ingelheim"" OR ""myokardia"" OR ""amgen"" OR ""applied molecular genetics"" OR ""bayer"" OR ""vertex pharmaceuticals"" OR ""regeneron"" OR ""novo nordisk"" OR ""biogen"" OR ""biogen idec"" OR ""daiichi sankyo"" OR ""astellas pharma"" OR ""asuterasu seiyaku kabushiki-gaisha"" OR ""otsuka"" OR ""otsuka seiyaku kabushiki-gaisha"" OR ""astex pharmaceuticals"" OR ""ucb"" OR ""union chimique belge"" OR ""moderna"" OR ""eisai"" OR ""ezai kabushiki-gaisha"" OR ""ea pharma"" OR ""csl"" OR ""zlb behring"" OR ""jiangsu hengrui medicine"" OR ""teva pharmaceuticals"" OR ""sumitomo dainippon pharma"" OR ""dainippon sumitomo seiyaku kabushiki-gaisha"" OR ""fresenius"" OR ""fresenius se & co. kgaa"" OR ""viatris"" OR ""kyowa kirin"" OR ""kyowa hakko kirin"" OR ""ipsen"" OR ""jazz pharmaceuticals"" OR ""azur pharma"" OR ""sino biopharm"" OR ""bausch health companies"" OR ""valeant pharmaceuticals"" OR ""cspc pharmaceutical group"" OR ""galapagos"" OR ""galapagos genomics"" NOT ""La Roche College"") OR author.affiliation.ror_id_lineage:(""01xdqrp08"" OR ""00by1q217"" OR ""04b2dty93"" OR ""02891sr49"" OR ""03qd7mz70"" OR ""00gtmwv55"" OR ""02f9zrr09"" OR ""04r9x1a08"" OR ""01qat3289"" OR ""01xsqw823"" OR ""02g5p4n58"" OR ""02n6c9837"" OR ""056546b03"" OR ""04hjbmv12"" OR ""00q32j219"" OR ""03g03ge92"" OR ""04hmn8g73"" OR ""00anb1726"" OR ""02f51rf24"" OR ""0435rc536"" OR ""02jqkb192"" OR ""027y26122"" OR ""01cjash87"" OR ""013k5y296"" OR ""01n029866"" OR ""01xm4wg91"" OR ""04vvh7p27"" OR ""044tc0x05"" OR ""04ayvvz32"" OR ""01wfv3m53"" OR ""04sapgw72"" OR ""01v376g59"" OR ""01g1gvr46"" OR ""000wej815"" OR ""00d801g55"" OR ""055mhsv54"" OR ""0086q4c12"" OR ""01zgpn844"" OR ""016mq8947"" OR ""04e4j5d46"")) AND publication_type:""journal article"" AND date_published>=now-10y AND field_of_study: ((""Medicine"" OR ""Internal medicine"" OR ""Pharmacology"") AND (""Psychiatry"" OR ""Psychology"" OR ""Psychological intervention"" OR ""Dementia"" OR ""Clinical psychology"" OR ""Anxiety"" OR ""Major depressive disorder"" OR ""Schizophrenia"" OR ""Alzheimer's disease""))",AND date_published>=now-10y,"AND field_of_study: ((""Medicine"" OR ""Internal medicine"" OR ""Pharmacology"") AND (""Psychiatry"" OR ""Psychology"" OR ""Psychological intervention"" OR ""Dementia"" OR ""Clinical psychology"" OR ""Anxiety"" OR ""Major depressive disorder"" OR ""Schizophrenia"" OR ""Alzheimer's disease""))",NA,oa_therapy_area,Pharma,Psychiatry,2014,392,98,58,40,19,25,240,152
psychiatry (primary search + psychiatry tags) - pharma,"(author.affiliation.name:(""pfizer"" OR ""astrazeneca"" OR ""eli lilly"" OR ""merck"" OR ""emd serono"" OR ""msd"" OR ""merck sharp & dohme"" OR ""bristol myers squibb"" OR ""novartis"" OR ""roche"" OR ""hoffmann-la roche"" OR ""genentech"" OR ""johnson & johnson"" OR ""janssen"" OR ""biosense webster"" OR ""glaxosmithkline"" OR ""gsk"" OR ""abbvie"" OR ""sanofi"" OR ""sanofi-aventis"" OR ""gilead sciences"" OR ""takeda"" OR ""boehringer ingelheim"" OR ""myokardia"" OR ""amgen"" OR ""applied molecular genetics"" OR ""bayer"" OR ""vertex pharmaceuticals"" OR ""regeneron"" OR ""novo nordisk"" OR ""biogen"" OR ""biogen idec"" OR ""daiichi sankyo"" OR ""astellas pharma"" OR ""asuterasu seiyaku kabushiki-gaisha"" OR ""otsuka"" OR ""otsuka seiyaku kabushiki-gaisha"" OR ""astex pharmaceuticals"" OR ""ucb"" OR ""union chimique belge"" OR ""moderna"" OR ""eisai"" OR ""ezai kabushiki-gaisha"" OR ""ea pharma"" OR ""csl"" OR ""zlb behring"" OR ""jiangsu hengrui medicine"" OR ""teva pharmaceuticals"" OR ""sumitomo dainippon pharma"" OR ""dainippon sumitomo seiyaku kabushiki-gaisha"" OR ""fresenius"" OR ""fresenius se & co. kgaa"" OR ""viatris"" OR ""kyowa kirin"" OR ""kyowa hakko kirin"" OR ""ipsen"" OR ""jazz pharmaceuticals"" OR ""azur pharma"" OR ""sino biopharm"" OR ""bausch health companies"" OR ""valeant pharmaceuticals"" OR ""cspc pharmaceutical group"" OR ""galapagos"" OR ""galapagos genomics"" NOT ""La Roche College"") OR author.affiliation.ror_id_lineage:(""01xdqrp08"" OR ""00by1q217"" OR ""04b2dty93"" OR ""02891sr49"" OR ""03qd7mz70"" OR ""00gtmwv55"" OR ""02f9zrr09"" OR ""04r9x1a08"" OR ""01qat3289"" OR ""01xsqw823"" OR ""02g5p4n58"" OR ""02n6c9837"" OR ""056546b03"" OR ""04hjbmv12"" OR ""00q32j219"" OR ""03g03ge92"" OR ""04hmn8g73"" OR ""00anb1726"" OR ""02f51rf24"" OR ""0435rc536"" OR ""02jqkb192"" OR ""027y26122"" OR ""01cjash87"" OR ""013k5y296"" OR ""01n029866"" OR ""01xm4wg91"" OR ""04vvh7p27"" OR ""044tc0x05"" OR ""04ayvvz32"" OR ""01wfv3m53"" OR ""04sapgw72"" OR ""01v376g59"" OR ""01g1gvr46"" OR ""000wej815"" OR ""00d801g55"" OR ""055mhsv54"" OR ""0086q4c12"" OR ""01zgpn844"" OR ""016mq8947"" OR ""04e4j5d46"")) AND publication_type:""journal article"" AND date_published>=now-10y AND field_of_study: ((""Medicine"" OR ""Internal medicine"" OR ""Pharmacology"") AND (""Psychiatry"" OR ""Psychology"" OR ""Psychological intervention"" OR ""Dementia"" OR ""Clinical psychology"" OR ""Anxiety"" OR ""Major depressive disorder"" OR ""Schizophrenia"" OR ""Alzheimer's disease""))",AND date_published>=now-10y,"AND field_of_study: ((""Medicine"" OR ""Internal medicine"" OR ""Pharmacology"") AND (""Psychiatry"" OR ""Psychology"" OR ""Psychological intervention"" OR ""Dementia"" OR ""Clinical psychology"" OR ""Anxiety"" OR ""Major depressive disorder"" OR ""Schizophrenia"" OR ""Alzheimer's disease""))",NA,oa_therapy_area,Pharma,Psychiatry,2015,421,123,62,54,20,5,264,157
psychiatry (primary search + psychiatry tags) - pharma,"(author.affiliation.name:(""pfizer"" OR ""astrazeneca"" OR ""eli lilly"" OR ""merck"" OR ""emd serono"" OR ""msd"" OR ""merck sharp & dohme"" OR ""bristol myers squibb"" OR ""novartis"" OR ""roche"" OR ""hoffmann-la roche"" OR ""genentech"" OR ""johnson & johnson"" OR ""janssen"" OR ""biosense webster"" OR ""glaxosmithkline"" OR ""gsk"" OR ""abbvie"" OR ""sanofi"" OR ""sanofi-aventis"" OR ""gilead sciences"" OR ""takeda"" OR ""boehringer ingelheim"" OR ""myokardia"" OR ""amgen"" OR ""applied molecular genetics"" OR ""bayer"" OR ""vertex pharmaceuticals"" OR ""regeneron"" OR ""novo nordisk"" OR ""biogen"" OR ""biogen idec"" OR ""daiichi sankyo"" OR ""astellas pharma"" OR ""asuterasu seiyaku kabushiki-gaisha"" OR ""otsuka"" OR ""otsuka seiyaku kabushiki-gaisha"" OR ""astex pharmaceuticals"" OR ""ucb"" OR ""union chimique belge"" OR ""moderna"" OR ""eisai"" OR ""ezai kabushiki-gaisha"" OR ""ea pharma"" OR ""csl"" OR ""zlb behring"" OR ""jiangsu hengrui medicine"" OR ""teva pharmaceuticals"" OR ""sumitomo dainippon pharma"" OR ""dainippon sumitomo seiyaku kabushiki-gaisha"" OR ""fresenius"" OR ""fresenius se & co. kgaa"" OR ""viatris"" OR ""kyowa kirin"" OR ""kyowa hakko kirin"" OR ""ipsen"" OR ""jazz pharmaceuticals"" OR ""azur pharma"" OR ""sino biopharm"" OR ""bausch health companies"" OR ""valeant pharmaceuticals"" OR ""cspc pharmaceutical group"" OR ""galapagos"" OR ""galapagos genomics"" NOT ""La Roche College"") OR author.affiliation.ror_id_lineage:(""01xdqrp08"" OR ""00by1q217"" OR ""04b2dty93"" OR ""02891sr49"" OR ""03qd7mz70"" OR ""00gtmwv55"" OR ""02f9zrr09"" OR ""04r9x1a08"" OR ""01qat3289"" OR ""01xsqw823"" OR ""02g5p4n58"" OR ""02n6c9837"" OR ""056546b03"" OR ""04hjbmv12"" OR ""00q32j219"" OR ""03g03ge92"" OR ""04hmn8g73"" OR ""00anb1726"" OR ""02f51rf24"" OR ""0435rc536"" OR ""02jqkb192"" OR ""027y26122"" OR ""01cjash87"" OR ""013k5y296"" OR ""01n029866"" OR ""01xm4wg91"" OR ""04vvh7p27"" OR ""044tc0x05"" OR ""04ayvvz32"" OR ""01wfv3m53"" OR ""04sapgw72"" OR ""01v376g59"" OR ""01g1gvr46"" OR ""000wej815"" OR ""00d801g55"" OR ""055mhsv54"" OR ""0086q4c12"" OR ""01zgpn844"" OR ""016mq8947"" OR ""04e4j5d46"")) AND publication_type:""journal article"" AND date_published>=now-10y AND field_of_study: ((""Medicine"" OR ""Internal medicine"" OR ""Pharmacology"") AND (""Psychiatry"" OR ""Psychology"" OR ""Psychological intervention"" OR ""Dementia"" OR ""Clinical psychology"" OR ""Anxiety"" OR ""Major depressive disorder"" OR ""Schizophrenia"" OR ""Alzheimer's disease""))",AND date_published>=now-10y,"AND field_of_study: ((""Medicine"" OR ""Internal medicine"" OR ""Pharmacology"") AND (""Psychiatry"" OR ""Psychology"" OR ""Psychological intervention"" OR ""Dementia"" OR ""Clinical psychology"" OR ""Anxiety"" OR ""Major depressive disorder"" OR ""Schizophrenia"" OR ""Alzheimer's disease""))",NA,oa_therapy_area,Pharma,Psychiatry,2016,422,133,69,49,19,3,273,149
psychiatry (primary search + psychiatry tags) - pharma,"(author.affiliation.name:(""pfizer"" OR ""astrazeneca"" OR ""eli lilly"" OR ""merck"" OR ""emd serono"" OR ""msd"" OR ""merck sharp & dohme"" OR ""bristol myers squibb"" OR ""novartis"" OR ""roche"" OR ""hoffmann-la roche"" OR ""genentech"" OR ""johnson & johnson"" OR ""janssen"" OR ""biosense webster"" OR ""glaxosmithkline"" OR ""gsk"" OR ""abbvie"" OR ""sanofi"" OR ""sanofi-aventis"" OR ""gilead sciences"" OR ""takeda"" OR ""boehringer ingelheim"" OR ""myokardia"" OR ""amgen"" OR ""applied molecular genetics"" OR ""bayer"" OR ""vertex pharmaceuticals"" OR ""regeneron"" OR ""novo nordisk"" OR ""biogen"" OR ""biogen idec"" OR ""daiichi sankyo"" OR ""astellas pharma"" OR ""asuterasu seiyaku kabushiki-gaisha"" OR ""otsuka"" OR ""otsuka seiyaku kabushiki-gaisha"" OR ""astex pharmaceuticals"" OR ""ucb"" OR ""union chimique belge"" OR ""moderna"" OR ""eisai"" OR ""ezai kabushiki-gaisha"" OR ""ea pharma"" OR ""csl"" OR ""zlb behring"" OR ""jiangsu hengrui medicine"" OR ""teva pharmaceuticals"" OR ""sumitomo dainippon pharma"" OR ""dainippon sumitomo seiyaku kabushiki-gaisha"" OR ""fresenius"" OR ""fresenius se & co. kgaa"" OR ""viatris"" OR ""kyowa kirin"" OR ""kyowa hakko kirin"" OR ""ipsen"" OR ""jazz pharmaceuticals"" OR ""azur pharma"" OR ""sino biopharm"" OR ""bausch health companies"" OR ""valeant pharmaceuticals"" OR ""cspc pharmaceutical group"" OR ""galapagos"" OR ""galapagos genomics"" NOT ""La Roche College"") OR author.affiliation.ror_id_lineage:(""01xdqrp08"" OR ""00by1q217"" OR ""04b2dty93"" OR ""02891sr49"" OR ""03qd7mz70"" OR ""00gtmwv55"" OR ""02f9zrr09"" OR ""04r9x1a08"" OR ""01qat3289"" OR ""01xsqw823"" OR ""02g5p4n58"" OR ""02n6c9837"" OR ""056546b03"" OR ""04hjbmv12"" OR ""00q32j219"" OR ""03g03ge92"" OR ""04hmn8g73"" OR ""00anb1726"" OR ""02f51rf24"" OR ""0435rc536"" OR ""02jqkb192"" OR ""027y26122"" OR ""01cjash87"" OR ""013k5y296"" OR ""01n029866"" OR ""01xm4wg91"" OR ""04vvh7p27"" OR ""044tc0x05"" OR ""04ayvvz32"" OR ""01wfv3m53"" OR ""04sapgw72"" OR ""01v376g59"" OR ""01g1gvr46"" OR ""000wej815"" OR ""00d801g55"" OR ""055mhsv54"" OR ""0086q4c12"" OR ""01zgpn844"" OR ""016mq8947"" OR ""04e4j5d46"")) AND publication_type:""journal article"" AND date_published>=now-10y AND field_of_study: ((""Medicine"" OR ""Internal medicine"" OR ""Pharmacology"") AND (""Psychiatry"" OR ""Psychology"" OR ""Psychological intervention"" OR ""Dementia"" OR ""Clinical psychology"" OR ""Anxiety"" OR ""Major depressive disorder"" OR ""Schizophrenia"" OR ""Alzheimer's disease""))",AND date_published>=now-10y,"AND field_of_study: ((""Medicine"" OR ""Internal medicine"" OR ""Pharmacology"") AND (""Psychiatry"" OR ""Psychology"" OR ""Psychological intervention"" OR ""Dementia"" OR ""Clinical psychology"" OR ""Anxiety"" OR ""Major depressive disorder"" OR ""Schizophrenia"" OR ""Alzheimer's disease""))",NA,oa_therapy_area,Pharma,Psychiatry,2017,435,142,74,47,30,10,303,132
psychiatry (primary search + psychiatry tags) - pharma,"(author.affiliation.name:(""pfizer"" OR ""astrazeneca"" OR ""eli lilly"" OR ""merck"" OR ""emd serono"" OR ""msd"" OR ""merck sharp & dohme"" OR ""bristol myers squibb"" OR ""novartis"" OR ""roche"" OR ""hoffmann-la roche"" OR ""genentech"" OR ""johnson & johnson"" OR ""janssen"" OR ""biosense webster"" OR ""glaxosmithkline"" OR ""gsk"" OR ""abbvie"" OR ""sanofi"" OR ""sanofi-aventis"" OR ""gilead sciences"" OR ""takeda"" OR ""boehringer ingelheim"" OR ""myokardia"" OR ""amgen"" OR ""applied molecular genetics"" OR ""bayer"" OR ""vertex pharmaceuticals"" OR ""regeneron"" OR ""novo nordisk"" OR ""biogen"" OR ""biogen idec"" OR ""daiichi sankyo"" OR ""astellas pharma"" OR ""asuterasu seiyaku kabushiki-gaisha"" OR ""otsuka"" OR ""otsuka seiyaku kabushiki-gaisha"" OR ""astex pharmaceuticals"" OR ""ucb"" OR ""union chimique belge"" OR ""moderna"" OR ""eisai"" OR ""ezai kabushiki-gaisha"" OR ""ea pharma"" OR ""csl"" OR ""zlb behring"" OR ""jiangsu hengrui medicine"" OR ""teva pharmaceuticals"" OR ""sumitomo dainippon pharma"" OR ""dainippon sumitomo seiyaku kabushiki-gaisha"" OR ""fresenius"" OR ""fresenius se & co. kgaa"" OR ""viatris"" OR ""kyowa kirin"" OR ""kyowa hakko kirin"" OR ""ipsen"" OR ""jazz pharmaceuticals"" OR ""azur pharma"" OR ""sino biopharm"" OR ""bausch health companies"" OR ""valeant pharmaceuticals"" OR ""cspc pharmaceutical group"" OR ""galapagos"" OR ""galapagos genomics"" NOT ""La Roche College"") OR author.affiliation.ror_id_lineage:(""01xdqrp08"" OR ""00by1q217"" OR ""04b2dty93"" OR ""02891sr49"" OR ""03qd7mz70"" OR ""00gtmwv55"" OR ""02f9zrr09"" OR ""04r9x1a08"" OR ""01qat3289"" OR ""01xsqw823"" OR ""02g5p4n58"" OR ""02n6c9837"" OR ""056546b03"" OR ""04hjbmv12"" OR ""00q32j219"" OR ""03g03ge92"" OR ""04hmn8g73"" OR ""00anb1726"" OR ""02f51rf24"" OR ""0435rc536"" OR ""02jqkb192"" OR ""027y26122"" OR ""01cjash87"" OR ""013k5y296"" OR ""01n029866"" OR ""01xm4wg91"" OR ""04vvh7p27"" OR ""044tc0x05"" OR ""04ayvvz32"" OR ""01wfv3m53"" OR ""04sapgw72"" OR ""01v376g59"" OR ""01g1gvr46"" OR ""000wej815"" OR ""00d801g55"" OR ""055mhsv54"" OR ""0086q4c12"" OR ""01zgpn844"" OR ""016mq8947"" OR ""04e4j5d46"")) AND publication_type:""journal article"" AND date_published>=now-10y AND field_of_study: ((""Medicine"" OR ""Internal medicine"" OR ""Pharmacology"") AND (""Psychiatry"" OR ""Psychology"" OR ""Psychological intervention"" OR ""Dementia"" OR ""Clinical psychology"" OR ""Anxiety"" OR ""Major depressive disorder"" OR ""Schizophrenia"" OR ""Alzheimer's disease""))",AND date_published>=now-10y,"AND field_of_study: ((""Medicine"" OR ""Internal medicine"" OR ""Pharmacology"") AND (""Psychiatry"" OR ""Psychology"" OR ""Psychological intervention"" OR ""Dementia"" OR ""Clinical psychology"" OR ""Anxiety"" OR ""Major depressive disorder"" OR ""Schizophrenia"" OR ""Alzheimer's disease""))",NA,oa_therapy_area,Pharma,Psychiatry,2018,359,119,61,51,41,2,274,85
psychiatry (primary search + psychiatry tags) - pharma,"(author.affiliation.name:(""pfizer"" OR ""astrazeneca"" OR ""eli lilly"" OR ""merck"" OR ""emd serono"" OR ""msd"" OR ""merck sharp & dohme"" OR ""bristol myers squibb"" OR ""novartis"" OR ""roche"" OR ""hoffmann-la roche"" OR ""genentech"" OR ""johnson & johnson"" OR ""janssen"" OR ""biosense webster"" OR ""glaxosmithkline"" OR ""gsk"" OR ""abbvie"" OR ""sanofi"" OR ""sanofi-aventis"" OR ""gilead sciences"" OR ""takeda"" OR ""boehringer ingelheim"" OR ""myokardia"" OR ""amgen"" OR ""applied molecular genetics"" OR ""bayer"" OR ""vertex pharmaceuticals"" OR ""regeneron"" OR ""novo nordisk"" OR ""biogen"" OR ""biogen idec"" OR ""daiichi sankyo"" OR ""astellas pharma"" OR ""asuterasu seiyaku kabushiki-gaisha"" OR ""otsuka"" OR ""otsuka seiyaku kabushiki-gaisha"" OR ""astex pharmaceuticals"" OR ""ucb"" OR ""union chimique belge"" OR ""moderna"" OR ""eisai"" OR ""ezai kabushiki-gaisha"" OR ""ea pharma"" OR ""csl"" OR ""zlb behring"" OR ""jiangsu hengrui medicine"" OR ""teva pharmaceuticals"" OR ""sumitomo dainippon pharma"" OR ""dainippon sumitomo seiyaku kabushiki-gaisha"" OR ""fresenius"" OR ""fresenius se & co. kgaa"" OR ""viatris"" OR ""kyowa kirin"" OR ""kyowa hakko kirin"" OR ""ipsen"" OR ""jazz pharmaceuticals"" OR ""azur pharma"" OR ""sino biopharm"" OR ""bausch health companies"" OR ""valeant pharmaceuticals"" OR ""cspc pharmaceutical group"" OR ""galapagos"" OR ""galapagos genomics"" NOT ""La Roche College"") OR author.affiliation.ror_id_lineage:(""01xdqrp08"" OR ""00by1q217"" OR ""04b2dty93"" OR ""02891sr49"" OR ""03qd7mz70"" OR ""00gtmwv55"" OR ""02f9zrr09"" OR ""04r9x1a08"" OR ""01qat3289"" OR ""01xsqw823"" OR ""02g5p4n58"" OR ""02n6c9837"" OR ""056546b03"" OR ""04hjbmv12"" OR ""00q32j219"" OR ""03g03ge92"" OR ""04hmn8g73"" OR ""00anb1726"" OR ""02f51rf24"" OR ""0435rc536"" OR ""02jqkb192"" OR ""027y26122"" OR ""01cjash87"" OR ""013k5y296"" OR ""01n029866"" OR ""01xm4wg91"" OR ""04vvh7p27"" OR ""044tc0x05"" OR ""04ayvvz32"" OR ""01wfv3m53"" OR ""04sapgw72"" OR ""01v376g59"" OR ""01g1gvr46"" OR ""000wej815"" OR ""00d801g55"" OR ""055mhsv54"" OR ""0086q4c12"" OR ""01zgpn844"" OR ""016mq8947"" OR ""04e4j5d46"")) AND publication_type:""journal article"" AND date_published>=now-10y AND field_of_study: ((""Medicine"" OR ""Internal medicine"" OR ""Pharmacology"") AND (""Psychiatry"" OR ""Psychology"" OR ""Psychological intervention"" OR ""Dementia"" OR ""Clinical psychology"" OR ""Anxiety"" OR ""Major depressive disorder"" OR ""Schizophrenia"" OR ""Alzheimer's disease""))",AND date_published>=now-10y,"AND field_of_study: ((""Medicine"" OR ""Internal medicine"" OR ""Pharmacology"") AND (""Psychiatry"" OR ""Psychology"" OR ""Psychological intervention"" OR ""Dementia"" OR ""Clinical psychology"" OR ""Anxiety"" OR ""Major depressive disorder"" OR ""Schizophrenia"" OR ""Alzheimer's disease""))",NA,oa_therapy_area,Pharma,Psychiatry,2019,417,150,50,85,34,5,324,93
psychiatry (primary search + psychiatry tags) - pharma,"(author.affiliation.name:(""pfizer"" OR ""astrazeneca"" OR ""eli lilly"" OR ""merck"" OR ""emd serono"" OR ""msd"" OR ""merck sharp & dohme"" OR ""bristol myers squibb"" OR ""novartis"" OR ""roche"" OR ""hoffmann-la roche"" OR ""genentech"" OR ""johnson & johnson"" OR ""janssen"" OR ""biosense webster"" OR ""glaxosmithkline"" OR ""gsk"" OR ""abbvie"" OR ""sanofi"" OR ""sanofi-aventis"" OR ""gilead sciences"" OR ""takeda"" OR ""boehringer ingelheim"" OR ""myokardia"" OR ""amgen"" OR ""applied molecular genetics"" OR ""bayer"" OR ""vertex pharmaceuticals"" OR ""regeneron"" OR ""novo nordisk"" OR ""biogen"" OR ""biogen idec"" OR ""daiichi sankyo"" OR ""astellas pharma"" OR ""asuterasu seiyaku kabushiki-gaisha"" OR ""otsuka"" OR ""otsuka seiyaku kabushiki-gaisha"" OR ""astex pharmaceuticals"" OR ""ucb"" OR ""union chimique belge"" OR ""moderna"" OR ""eisai"" OR ""ezai kabushiki-gaisha"" OR ""ea pharma"" OR ""csl"" OR ""zlb behring"" OR ""jiangsu hengrui medicine"" OR ""teva pharmaceuticals"" OR ""sumitomo dainippon pharma"" OR ""dainippon sumitomo seiyaku kabushiki-gaisha"" OR ""fresenius"" OR ""fresenius se & co. kgaa"" OR ""viatris"" OR ""kyowa kirin"" OR ""kyowa hakko kirin"" OR ""ipsen"" OR ""jazz pharmaceuticals"" OR ""azur pharma"" OR ""sino biopharm"" OR ""bausch health companies"" OR ""valeant pharmaceuticals"" OR ""cspc pharmaceutical group"" OR ""galapagos"" OR ""galapagos genomics"" NOT ""La Roche College"") OR author.affiliation.ror_id_lineage:(""01xdqrp08"" OR ""00by1q217"" OR ""04b2dty93"" OR ""02891sr49"" OR ""03qd7mz70"" OR ""00gtmwv55"" OR ""02f9zrr09"" OR ""04r9x1a08"" OR ""01qat3289"" OR ""01xsqw823"" OR ""02g5p4n58"" OR ""02n6c9837"" OR ""056546b03"" OR ""04hjbmv12"" OR ""00q32j219"" OR ""03g03ge92"" OR ""04hmn8g73"" OR ""00anb1726"" OR ""02f51rf24"" OR ""0435rc536"" OR ""02jqkb192"" OR ""027y26122"" OR ""01cjash87"" OR ""013k5y296"" OR ""01n029866"" OR ""01xm4wg91"" OR ""04vvh7p27"" OR ""044tc0x05"" OR ""04ayvvz32"" OR ""01wfv3m53"" OR ""04sapgw72"" OR ""01v376g59"" OR ""01g1gvr46"" OR ""000wej815"" OR ""00d801g55"" OR ""055mhsv54"" OR ""0086q4c12"" OR ""01zgpn844"" OR ""016mq8947"" OR ""04e4j5d46"")) AND publication_type:""journal article"" AND date_published>=now-10y AND field_of_study: ((""Medicine"" OR ""Internal medicine"" OR ""Pharmacology"") AND (""Psychiatry"" OR ""Psychology"" OR ""Psychological intervention"" OR ""Dementia"" OR ""Clinical psychology"" OR ""Anxiety"" OR ""Major depressive disorder"" OR ""Schizophrenia"" OR ""Alzheimer's disease""))",AND date_published>=now-10y,"AND field_of_study: ((""Medicine"" OR ""Internal medicine"" OR ""Pharmacology"") AND (""Psychiatry"" OR ""Psychology"" OR ""Psychological intervention"" OR ""Dementia"" OR ""Clinical psychology"" OR ""Anxiety"" OR ""Major depressive disorder"" OR ""Schizophrenia"" OR ""Alzheimer's disease""))",NA,oa_therapy_area,Pharma,Psychiatry,2020,442,174,30,103,59,4,370,72
psychiatry (primary search + psychiatry tags) - pharma,"(author.affiliation.name:(""pfizer"" OR ""astrazeneca"" OR ""eli lilly"" OR ""merck"" OR ""emd serono"" OR ""msd"" OR ""merck sharp & dohme"" OR ""bristol myers squibb"" OR ""novartis"" OR ""roche"" OR ""hoffmann-la roche"" OR ""genentech"" OR ""johnson & johnson"" OR ""janssen"" OR ""biosense webster"" OR ""glaxosmithkline"" OR ""gsk"" OR ""abbvie"" OR ""sanofi"" OR ""sanofi-aventis"" OR ""gilead sciences"" OR ""takeda"" OR ""boehringer ingelheim"" OR ""myokardia"" OR ""amgen"" OR ""applied molecular genetics"" OR ""bayer"" OR ""vertex pharmaceuticals"" OR ""regeneron"" OR ""novo nordisk"" OR ""biogen"" OR ""biogen idec"" OR ""daiichi sankyo"" OR ""astellas pharma"" OR ""asuterasu seiyaku kabushiki-gaisha"" OR ""otsuka"" OR ""otsuka seiyaku kabushiki-gaisha"" OR ""astex pharmaceuticals"" OR ""ucb"" OR ""union chimique belge"" OR ""moderna"" OR ""eisai"" OR ""ezai kabushiki-gaisha"" OR ""ea pharma"" OR ""csl"" OR ""zlb behring"" OR ""jiangsu hengrui medicine"" OR ""teva pharmaceuticals"" OR ""sumitomo dainippon pharma"" OR ""dainippon sumitomo seiyaku kabushiki-gaisha"" OR ""fresenius"" OR ""fresenius se & co. kgaa"" OR ""viatris"" OR ""kyowa kirin"" OR ""kyowa hakko kirin"" OR ""ipsen"" OR ""jazz pharmaceuticals"" OR ""azur pharma"" OR ""sino biopharm"" OR ""bausch health companies"" OR ""valeant pharmaceuticals"" OR ""cspc pharmaceutical group"" OR ""galapagos"" OR ""galapagos genomics"" NOT ""La Roche College"") OR author.affiliation.ror_id_lineage:(""01xdqrp08"" OR ""00by1q217"" OR ""04b2dty93"" OR ""02891sr49"" OR ""03qd7mz70"" OR ""00gtmwv55"" OR ""02f9zrr09"" OR ""04r9x1a08"" OR ""01qat3289"" OR ""01xsqw823"" OR ""02g5p4n58"" OR ""02n6c9837"" OR ""056546b03"" OR ""04hjbmv12"" OR ""00q32j219"" OR ""03g03ge92"" OR ""04hmn8g73"" OR ""00anb1726"" OR ""02f51rf24"" OR ""0435rc536"" OR ""02jqkb192"" OR ""027y26122"" OR ""01cjash87"" OR ""013k5y296"" OR ""01n029866"" OR ""01xm4wg91"" OR ""04vvh7p27"" OR ""044tc0x05"" OR ""04ayvvz32"" OR ""01wfv3m53"" OR ""04sapgw72"" OR ""01v376g59"" OR ""01g1gvr46"" OR ""000wej815"" OR ""00d801g55"" OR ""055mhsv54"" OR ""0086q4c12"" OR ""01zgpn844"" OR ""016mq8947"" OR ""04e4j5d46"")) AND publication_type:""journal article"" AND date_published>=now-10y AND field_of_study: ((""Medicine"" OR ""Internal medicine"" OR ""Pharmacology"") AND (""Psychiatry"" OR ""Psychology"" OR ""Psychological intervention"" OR ""Dementia"" OR ""Clinical psychology"" OR ""Anxiety"" OR ""Major depressive disorder"" OR ""Schizophrenia"" OR ""Alzheimer's disease""))",AND date_published>=now-10y,"AND field_of_study: ((""Medicine"" OR ""Internal medicine"" OR ""Pharmacology"") AND (""Psychiatry"" OR ""Psychology"" OR ""Psychological intervention"" OR ""Dementia"" OR ""Clinical psychology"" OR ""Anxiety"" OR ""Major depressive disorder"" OR ""Schizophrenia"" OR ""Alzheimer's disease""))",NA,oa_therapy_area,Pharma,Psychiatry,2021,665,251,29,171,94,25,570,95
psychiatry (primary search + psychiatry tags) - pharma,"(author.affiliation.name:(""pfizer"" OR ""astrazeneca"" OR ""eli lilly"" OR ""merck"" OR ""emd serono"" OR ""msd"" OR ""merck sharp & dohme"" OR ""bristol myers squibb"" OR ""novartis"" OR ""roche"" OR ""hoffmann-la roche"" OR ""genentech"" OR ""johnson & johnson"" OR ""janssen"" OR ""biosense webster"" OR ""glaxosmithkline"" OR ""gsk"" OR ""abbvie"" OR ""sanofi"" OR ""sanofi-aventis"" OR ""gilead sciences"" OR ""takeda"" OR ""boehringer ingelheim"" OR ""myokardia"" OR ""amgen"" OR ""applied molecular genetics"" OR ""bayer"" OR ""vertex pharmaceuticals"" OR ""regeneron"" OR ""novo nordisk"" OR ""biogen"" OR ""biogen idec"" OR ""daiichi sankyo"" OR ""astellas pharma"" OR ""asuterasu seiyaku kabushiki-gaisha"" OR ""otsuka"" OR ""otsuka seiyaku kabushiki-gaisha"" OR ""astex pharmaceuticals"" OR ""ucb"" OR ""union chimique belge"" OR ""moderna"" OR ""eisai"" OR ""ezai kabushiki-gaisha"" OR ""ea pharma"" OR ""csl"" OR ""zlb behring"" OR ""jiangsu hengrui medicine"" OR ""teva pharmaceuticals"" OR ""sumitomo dainippon pharma"" OR ""dainippon sumitomo seiyaku kabushiki-gaisha"" OR ""fresenius"" OR ""fresenius se & co. kgaa"" OR ""viatris"" OR ""kyowa kirin"" OR ""kyowa hakko kirin"" OR ""ipsen"" OR ""jazz pharmaceuticals"" OR ""azur pharma"" OR ""sino biopharm"" OR ""bausch health companies"" OR ""valeant pharmaceuticals"" OR ""cspc pharmaceutical group"" OR ""galapagos"" OR ""galapagos genomics"" NOT ""La Roche College"") OR author.affiliation.ror_id_lineage:(""01xdqrp08"" OR ""00by1q217"" OR ""04b2dty93"" OR ""02891sr49"" OR ""03qd7mz70"" OR ""00gtmwv55"" OR ""02f9zrr09"" OR ""04r9x1a08"" OR ""01qat3289"" OR ""01xsqw823"" OR ""02g5p4n58"" OR ""02n6c9837"" OR ""056546b03"" OR ""04hjbmv12"" OR ""00q32j219"" OR ""03g03ge92"" OR ""04hmn8g73"" OR ""00anb1726"" OR ""02f51rf24"" OR ""0435rc536"" OR ""02jqkb192"" OR ""027y26122"" OR ""01cjash87"" OR ""013k5y296"" OR ""01n029866"" OR ""01xm4wg91"" OR ""04vvh7p27"" OR ""044tc0x05"" OR ""04ayvvz32"" OR ""01wfv3m53"" OR ""04sapgw72"" OR ""01v376g59"" OR ""01g1gvr46"" OR ""000wej815"" OR ""00d801g55"" OR ""055mhsv54"" OR ""0086q4c12"" OR ""01zgpn844"" OR ""016mq8947"" OR ""04e4j5d46"")) AND publication_type:""journal article"" AND date_published>=now-10y AND field_of_study: ((""Medicine"" OR ""Internal medicine"" OR ""Pharmacology"") AND (""Psychiatry"" OR ""Psychology"" OR ""Psychological intervention"" OR ""Dementia"" OR ""Clinical psychology"" OR ""Anxiety"" OR ""Major depressive disorder"" OR ""Schizophrenia"" OR ""Alzheimer's disease""))",AND date_published>=now-10y,"AND field_of_study: ((""Medicine"" OR ""Internal medicine"" OR ""Pharmacology"") AND (""Psychiatry"" OR ""Psychology"" OR ""Psychological intervention"" OR ""Dementia"" OR ""Clinical psychology"" OR ""Anxiety"" OR ""Major depressive disorder"" OR ""Schizophrenia"" OR ""Alzheimer's disease""))",NA,oa_therapy_area,Pharma,Psychiatry,2022,1810,804,101,337,94,48,1384,426
psychiatry (primary search + psychiatry tags) - pharma,"(author.affiliation.name:(""pfizer"" OR ""astrazeneca"" OR ""eli lilly"" OR ""merck"" OR ""emd serono"" OR ""msd"" OR ""merck sharp & dohme"" OR ""bristol myers squibb"" OR ""novartis"" OR ""roche"" OR ""hoffmann-la roche"" OR ""genentech"" OR ""johnson & johnson"" OR ""janssen"" OR ""biosense webster"" OR ""glaxosmithkline"" OR ""gsk"" OR ""abbvie"" OR ""sanofi"" OR ""sanofi-aventis"" OR ""gilead sciences"" OR ""takeda"" OR ""boehringer ingelheim"" OR ""myokardia"" OR ""amgen"" OR ""applied molecular genetics"" OR ""bayer"" OR ""vertex pharmaceuticals"" OR ""regeneron"" OR ""novo nordisk"" OR ""biogen"" OR ""biogen idec"" OR ""daiichi sankyo"" OR ""astellas pharma"" OR ""asuterasu seiyaku kabushiki-gaisha"" OR ""otsuka"" OR ""otsuka seiyaku kabushiki-gaisha"" OR ""astex pharmaceuticals"" OR ""ucb"" OR ""union chimique belge"" OR ""moderna"" OR ""eisai"" OR ""ezai kabushiki-gaisha"" OR ""ea pharma"" OR ""csl"" OR ""zlb behring"" OR ""jiangsu hengrui medicine"" OR ""teva pharmaceuticals"" OR ""sumitomo dainippon pharma"" OR ""dainippon sumitomo seiyaku kabushiki-gaisha"" OR ""fresenius"" OR ""fresenius se & co. kgaa"" OR ""viatris"" OR ""kyowa kirin"" OR ""kyowa hakko kirin"" OR ""ipsen"" OR ""jazz pharmaceuticals"" OR ""azur pharma"" OR ""sino biopharm"" OR ""bausch health companies"" OR ""valeant pharmaceuticals"" OR ""cspc pharmaceutical group"" OR ""galapagos"" OR ""galapagos genomics"" NOT ""La Roche College"") OR author.affiliation.ror_id_lineage:(""01xdqrp08"" OR ""00by1q217"" OR ""04b2dty93"" OR ""02891sr49"" OR ""03qd7mz70"" OR ""00gtmwv55"" OR ""02f9zrr09"" OR ""04r9x1a08"" OR ""01qat3289"" OR ""01xsqw823"" OR ""02g5p4n58"" OR ""02n6c9837"" OR ""056546b03"" OR ""04hjbmv12"" OR ""00q32j219"" OR ""03g03ge92"" OR ""04hmn8g73"" OR ""00anb1726"" OR ""02f51rf24"" OR ""0435rc536"" OR ""02jqkb192"" OR ""027y26122"" OR ""01cjash87"" OR ""013k5y296"" OR ""01n029866"" OR ""01xm4wg91"" OR ""04vvh7p27"" OR ""044tc0x05"" OR ""04ayvvz32"" OR ""01wfv3m53"" OR ""04sapgw72"" OR ""01v376g59"" OR ""01g1gvr46"" OR ""000wej815"" OR ""00d801g55"" OR ""055mhsv54"" OR ""0086q4c12"" OR ""01zgpn844"" OR ""016mq8947"" OR ""04e4j5d46"")) AND publication_type:""journal article"" AND date_published>=now-10y AND field_of_study: ((""Medicine"" OR ""Internal medicine"" OR ""Pharmacology"") AND (""Psychiatry"" OR ""Psychology"" OR ""Psychological intervention"" OR ""Dementia"" OR ""Clinical psychology"" OR ""Anxiety"" OR ""Major depressive disorder"" OR ""Schizophrenia"" OR ""Alzheimer's disease""))",AND date_published>=now-10y,"AND field_of_study: ((""Medicine"" OR ""Internal medicine"" OR ""Pharmacology"") AND (""Psychiatry"" OR ""Psychology"" OR ""Psychological intervention"" OR ""Dementia"" OR ""Clinical psychology"" OR ""Anxiety"" OR ""Major depressive disorder"" OR ""Schizophrenia"" OR ""Alzheimer's disease""))",NA,oa_therapy_area,Pharma,Psychiatry,2023,741,334,15,122,49,84,604,137
respiratory (primary search + respiratory tags) - pharma,"(author.affiliation.name:(""pfizer"" OR ""astrazeneca"" OR ""eli lilly"" OR ""merck"" OR ""emd serono"" OR ""msd"" OR ""merck sharp & dohme"" OR ""bristol myers squibb"" OR ""novartis"" OR ""roche"" OR ""hoffmann-la roche"" OR ""genentech"" OR ""johnson & johnson"" OR ""janssen"" OR ""biosense webster"" OR ""glaxosmithkline"" OR ""gsk"" OR ""abbvie"" OR ""sanofi"" OR ""sanofi-aventis"" OR ""gilead sciences"" OR ""takeda"" OR ""boehringer ingelheim"" OR ""myokardia"" OR ""amgen"" OR ""applied molecular genetics"" OR ""bayer"" OR ""vertex pharmaceuticals"" OR ""regeneron"" OR ""novo nordisk"" OR ""biogen"" OR ""biogen idec"" OR ""daiichi sankyo"" OR ""astellas pharma"" OR ""asuterasu seiyaku kabushiki-gaisha"" OR ""otsuka"" OR ""otsuka seiyaku kabushiki-gaisha"" OR ""astex pharmaceuticals"" OR ""ucb"" OR ""union chimique belge"" OR ""moderna"" OR ""eisai"" OR ""ezai kabushiki-gaisha"" OR ""ea pharma"" OR ""csl"" OR ""zlb behring"" OR ""jiangsu hengrui medicine"" OR ""teva pharmaceuticals"" OR ""sumitomo dainippon pharma"" OR ""dainippon sumitomo seiyaku kabushiki-gaisha"" OR ""fresenius"" OR ""fresenius se & co. kgaa"" OR ""viatris"" OR ""kyowa kirin"" OR ""kyowa hakko kirin"" OR ""ipsen"" OR ""jazz pharmaceuticals"" OR ""azur pharma"" OR ""sino biopharm"" OR ""bausch health companies"" OR ""valeant pharmaceuticals"" OR ""cspc pharmaceutical group"" OR ""galapagos"" OR ""galapagos genomics"" NOT ""La Roche College"") OR author.affiliation.ror_id_lineage:(""01xdqrp08"" OR ""00by1q217"" OR ""04b2dty93"" OR ""02891sr49"" OR ""03qd7mz70"" OR ""00gtmwv55"" OR ""02f9zrr09"" OR ""04r9x1a08"" OR ""01qat3289"" OR ""01xsqw823"" OR ""02g5p4n58"" OR ""02n6c9837"" OR ""056546b03"" OR ""04hjbmv12"" OR ""00q32j219"" OR ""03g03ge92"" OR ""04hmn8g73"" OR ""00anb1726"" OR ""02f51rf24"" OR ""0435rc536"" OR ""02jqkb192"" OR ""027y26122"" OR ""01cjash87"" OR ""013k5y296"" OR ""01n029866"" OR ""01xm4wg91"" OR ""04vvh7p27"" OR ""044tc0x05"" OR ""04ayvvz32"" OR ""01wfv3m53"" OR ""04sapgw72"" OR ""01v376g59"" OR ""01g1gvr46"" OR ""000wej815"" OR ""00d801g55"" OR ""055mhsv54"" OR ""0086q4c12"" OR ""01zgpn844"" OR ""016mq8947"" OR ""04e4j5d46"")) AND publication_type:""journal article"" AND date_published>=now-10y AND field_of_study: ((""Medicine"" OR ""Internal medicine"" OR ""Pharmacology"") AND (""COPD"" OR ""Asthma"" OR ""Lung"" OR ""Idiopathic pulmonary fibrosis"" OR ""Respiratory system"" OR ""Spirometry"" OR ""Pulmonary disease"" OR ""Respiratory tract infections""))",AND date_published>=now-10y,"AND field_of_study: ((""Medicine"" OR ""Internal medicine"" OR ""Pharmacology"") AND (""COPD"" OR ""Asthma"" OR ""Lung"" OR ""Idiopathic pulmonary fibrosis"" OR ""Respiratory system"" OR ""Spirometry"" OR ""Pulmonary disease"" OR ""Respiratory tract infections""))",NA,oa_therapy_area,Pharma,Respiratory,2013,275,41,41,15,10,4,111,164
respiratory (primary search + respiratory tags) - pharma,"(author.affiliation.name:(""pfizer"" OR ""astrazeneca"" OR ""eli lilly"" OR ""merck"" OR ""emd serono"" OR ""msd"" OR ""merck sharp & dohme"" OR ""bristol myers squibb"" OR ""novartis"" OR ""roche"" OR ""hoffmann-la roche"" OR ""genentech"" OR ""johnson & johnson"" OR ""janssen"" OR ""biosense webster"" OR ""glaxosmithkline"" OR ""gsk"" OR ""abbvie"" OR ""sanofi"" OR ""sanofi-aventis"" OR ""gilead sciences"" OR ""takeda"" OR ""boehringer ingelheim"" OR ""myokardia"" OR ""amgen"" OR ""applied molecular genetics"" OR ""bayer"" OR ""vertex pharmaceuticals"" OR ""regeneron"" OR ""novo nordisk"" OR ""biogen"" OR ""biogen idec"" OR ""daiichi sankyo"" OR ""astellas pharma"" OR ""asuterasu seiyaku kabushiki-gaisha"" OR ""otsuka"" OR ""otsuka seiyaku kabushiki-gaisha"" OR ""astex pharmaceuticals"" OR ""ucb"" OR ""union chimique belge"" OR ""moderna"" OR ""eisai"" OR ""ezai kabushiki-gaisha"" OR ""ea pharma"" OR ""csl"" OR ""zlb behring"" OR ""jiangsu hengrui medicine"" OR ""teva pharmaceuticals"" OR ""sumitomo dainippon pharma"" OR ""dainippon sumitomo seiyaku kabushiki-gaisha"" OR ""fresenius"" OR ""fresenius se & co. kgaa"" OR ""viatris"" OR ""kyowa kirin"" OR ""kyowa hakko kirin"" OR ""ipsen"" OR ""jazz pharmaceuticals"" OR ""azur pharma"" OR ""sino biopharm"" OR ""bausch health companies"" OR ""valeant pharmaceuticals"" OR ""cspc pharmaceutical group"" OR ""galapagos"" OR ""galapagos genomics"" NOT ""La Roche College"") OR author.affiliation.ror_id_lineage:(""01xdqrp08"" OR ""00by1q217"" OR ""04b2dty93"" OR ""02891sr49"" OR ""03qd7mz70"" OR ""00gtmwv55"" OR ""02f9zrr09"" OR ""04r9x1a08"" OR ""01qat3289"" OR ""01xsqw823"" OR ""02g5p4n58"" OR ""02n6c9837"" OR ""056546b03"" OR ""04hjbmv12"" OR ""00q32j219"" OR ""03g03ge92"" OR ""04hmn8g73"" OR ""00anb1726"" OR ""02f51rf24"" OR ""0435rc536"" OR ""02jqkb192"" OR ""027y26122"" OR ""01cjash87"" OR ""013k5y296"" OR ""01n029866"" OR ""01xm4wg91"" OR ""04vvh7p27"" OR ""044tc0x05"" OR ""04ayvvz32"" OR ""01wfv3m53"" OR ""04sapgw72"" OR ""01v376g59"" OR ""01g1gvr46"" OR ""000wej815"" OR ""00d801g55"" OR ""055mhsv54"" OR ""0086q4c12"" OR ""01zgpn844"" OR ""016mq8947"" OR ""04e4j5d46"")) AND publication_type:""journal article"" AND date_published>=now-10y AND field_of_study: ((""Medicine"" OR ""Internal medicine"" OR ""Pharmacology"") AND (""COPD"" OR ""Asthma"" OR ""Lung"" OR ""Idiopathic pulmonary fibrosis"" OR ""Respiratory system"" OR ""Spirometry"" OR ""Pulmonary disease"" OR ""Respiratory tract infections""))",AND date_published>=now-10y,"AND field_of_study: ((""Medicine"" OR ""Internal medicine"" OR ""Pharmacology"") AND (""COPD"" OR ""Asthma"" OR ""Lung"" OR ""Idiopathic pulmonary fibrosis"" OR ""Respiratory system"" OR ""Spirometry"" OR ""Pulmonary disease"" OR ""Respiratory tract infections""))",NA,oa_therapy_area,Pharma,Respiratory,2014,498,123,64,34,15,33,269,229
respiratory (primary search + respiratory tags) - pharma,"(author.affiliation.name:(""pfizer"" OR ""astrazeneca"" OR ""eli lilly"" OR ""merck"" OR ""emd serono"" OR ""msd"" OR ""merck sharp & dohme"" OR ""bristol myers squibb"" OR ""novartis"" OR ""roche"" OR ""hoffmann-la roche"" OR ""genentech"" OR ""johnson & johnson"" OR ""janssen"" OR ""biosense webster"" OR ""glaxosmithkline"" OR ""gsk"" OR ""abbvie"" OR ""sanofi"" OR ""sanofi-aventis"" OR ""gilead sciences"" OR ""takeda"" OR ""boehringer ingelheim"" OR ""myokardia"" OR ""amgen"" OR ""applied molecular genetics"" OR ""bayer"" OR ""vertex pharmaceuticals"" OR ""regeneron"" OR ""novo nordisk"" OR ""biogen"" OR ""biogen idec"" OR ""daiichi sankyo"" OR ""astellas pharma"" OR ""asuterasu seiyaku kabushiki-gaisha"" OR ""otsuka"" OR ""otsuka seiyaku kabushiki-gaisha"" OR ""astex pharmaceuticals"" OR ""ucb"" OR ""union chimique belge"" OR ""moderna"" OR ""eisai"" OR ""ezai kabushiki-gaisha"" OR ""ea pharma"" OR ""csl"" OR ""zlb behring"" OR ""jiangsu hengrui medicine"" OR ""teva pharmaceuticals"" OR ""sumitomo dainippon pharma"" OR ""dainippon sumitomo seiyaku kabushiki-gaisha"" OR ""fresenius"" OR ""fresenius se & co. kgaa"" OR ""viatris"" OR ""kyowa kirin"" OR ""kyowa hakko kirin"" OR ""ipsen"" OR ""jazz pharmaceuticals"" OR ""azur pharma"" OR ""sino biopharm"" OR ""bausch health companies"" OR ""valeant pharmaceuticals"" OR ""cspc pharmaceutical group"" OR ""galapagos"" OR ""galapagos genomics"" NOT ""La Roche College"") OR author.affiliation.ror_id_lineage:(""01xdqrp08"" OR ""00by1q217"" OR ""04b2dty93"" OR ""02891sr49"" OR ""03qd7mz70"" OR ""00gtmwv55"" OR ""02f9zrr09"" OR ""04r9x1a08"" OR ""01qat3289"" OR ""01xsqw823"" OR ""02g5p4n58"" OR ""02n6c9837"" OR ""056546b03"" OR ""04hjbmv12"" OR ""00q32j219"" OR ""03g03ge92"" OR ""04hmn8g73"" OR ""00anb1726"" OR ""02f51rf24"" OR ""0435rc536"" OR ""02jqkb192"" OR ""027y26122"" OR ""01cjash87"" OR ""013k5y296"" OR ""01n029866"" OR ""01xm4wg91"" OR ""04vvh7p27"" OR ""044tc0x05"" OR ""04ayvvz32"" OR ""01wfv3m53"" OR ""04sapgw72"" OR ""01v376g59"" OR ""01g1gvr46"" OR ""000wej815"" OR ""00d801g55"" OR ""055mhsv54"" OR ""0086q4c12"" OR ""01zgpn844"" OR ""016mq8947"" OR ""04e4j5d46"")) AND publication_type:""journal article"" AND date_published>=now-10y AND field_of_study: ((""Medicine"" OR ""Internal medicine"" OR ""Pharmacology"") AND (""COPD"" OR ""Asthma"" OR ""Lung"" OR ""Idiopathic pulmonary fibrosis"" OR ""Respiratory system"" OR ""Spirometry"" OR ""Pulmonary disease"" OR ""Respiratory tract infections""))",AND date_published>=now-10y,"AND field_of_study: ((""Medicine"" OR ""Internal medicine"" OR ""Pharmacology"") AND (""COPD"" OR ""Asthma"" OR ""Lung"" OR ""Idiopathic pulmonary fibrosis"" OR ""Respiratory system"" OR ""Spirometry"" OR ""Pulmonary disease"" OR ""Respiratory tract infections""))",NA,oa_therapy_area,Pharma,Respiratory,2015,504,125,48,45,50,10,278,226
respiratory (primary search + respiratory tags) - pharma,"(author.affiliation.name:(""pfizer"" OR ""astrazeneca"" OR ""eli lilly"" OR ""merck"" OR ""emd serono"" OR ""msd"" OR ""merck sharp & dohme"" OR ""bristol myers squibb"" OR ""novartis"" OR ""roche"" OR ""hoffmann-la roche"" OR ""genentech"" OR ""johnson & johnson"" OR ""janssen"" OR ""biosense webster"" OR ""glaxosmithkline"" OR ""gsk"" OR ""abbvie"" OR ""sanofi"" OR ""sanofi-aventis"" OR ""gilead sciences"" OR ""takeda"" OR ""boehringer ingelheim"" OR ""myokardia"" OR ""amgen"" OR ""applied molecular genetics"" OR ""bayer"" OR ""vertex pharmaceuticals"" OR ""regeneron"" OR ""novo nordisk"" OR ""biogen"" OR ""biogen idec"" OR ""daiichi sankyo"" OR ""astellas pharma"" OR ""asuterasu seiyaku kabushiki-gaisha"" OR ""otsuka"" OR ""otsuka seiyaku kabushiki-gaisha"" OR ""astex pharmaceuticals"" OR ""ucb"" OR ""union chimique belge"" OR ""moderna"" OR ""eisai"" OR ""ezai kabushiki-gaisha"" OR ""ea pharma"" OR ""csl"" OR ""zlb behring"" OR ""jiangsu hengrui medicine"" OR ""teva pharmaceuticals"" OR ""sumitomo dainippon pharma"" OR ""dainippon sumitomo seiyaku kabushiki-gaisha"" OR ""fresenius"" OR ""fresenius se & co. kgaa"" OR ""viatris"" OR ""kyowa kirin"" OR ""kyowa hakko kirin"" OR ""ipsen"" OR ""jazz pharmaceuticals"" OR ""azur pharma"" OR ""sino biopharm"" OR ""bausch health companies"" OR ""valeant pharmaceuticals"" OR ""cspc pharmaceutical group"" OR ""galapagos"" OR ""galapagos genomics"" NOT ""La Roche College"") OR author.affiliation.ror_id_lineage:(""01xdqrp08"" OR ""00by1q217"" OR ""04b2dty93"" OR ""02891sr49"" OR ""03qd7mz70"" OR ""00gtmwv55"" OR ""02f9zrr09"" OR ""04r9x1a08"" OR ""01qat3289"" OR ""01xsqw823"" OR ""02g5p4n58"" OR ""02n6c9837"" OR ""056546b03"" OR ""04hjbmv12"" OR ""00q32j219"" OR ""03g03ge92"" OR ""04hmn8g73"" OR ""00anb1726"" OR ""02f51rf24"" OR ""0435rc536"" OR ""02jqkb192"" OR ""027y26122"" OR ""01cjash87"" OR ""013k5y296"" OR ""01n029866"" OR ""01xm4wg91"" OR ""04vvh7p27"" OR ""044tc0x05"" OR ""04ayvvz32"" OR ""01wfv3m53"" OR ""04sapgw72"" OR ""01v376g59"" OR ""01g1gvr46"" OR ""000wej815"" OR ""00d801g55"" OR ""055mhsv54"" OR ""0086q4c12"" OR ""01zgpn844"" OR ""016mq8947"" OR ""04e4j5d46"")) AND publication_type:""journal article"" AND date_published>=now-10y AND field_of_study: ((""Medicine"" OR ""Internal medicine"" OR ""Pharmacology"") AND (""COPD"" OR ""Asthma"" OR ""Lung"" OR ""Idiopathic pulmonary fibrosis"" OR ""Respiratory system"" OR ""Spirometry"" OR ""Pulmonary disease"" OR ""Respiratory tract infections""))",AND date_published>=now-10y,"AND field_of_study: ((""Medicine"" OR ""Internal medicine"" OR ""Pharmacology"") AND (""COPD"" OR ""Asthma"" OR ""Lung"" OR ""Idiopathic pulmonary fibrosis"" OR ""Respiratory system"" OR ""Spirometry"" OR ""Pulmonary disease"" OR ""Respiratory tract infections""))",NA,oa_therapy_area,Pharma,Respiratory,2016,648,179,67,59,76,8,389,259
respiratory (primary search + respiratory tags) - pharma,"(author.affiliation.name:(""pfizer"" OR ""astrazeneca"" OR ""eli lilly"" OR ""merck"" OR ""emd serono"" OR ""msd"" OR ""merck sharp & dohme"" OR ""bristol myers squibb"" OR ""novartis"" OR ""roche"" OR ""hoffmann-la roche"" OR ""genentech"" OR ""johnson & johnson"" OR ""janssen"" OR ""biosense webster"" OR ""glaxosmithkline"" OR ""gsk"" OR ""abbvie"" OR ""sanofi"" OR ""sanofi-aventis"" OR ""gilead sciences"" OR ""takeda"" OR ""boehringer ingelheim"" OR ""myokardia"" OR ""amgen"" OR ""applied molecular genetics"" OR ""bayer"" OR ""vertex pharmaceuticals"" OR ""regeneron"" OR ""novo nordisk"" OR ""biogen"" OR ""biogen idec"" OR ""daiichi sankyo"" OR ""astellas pharma"" OR ""asuterasu seiyaku kabushiki-gaisha"" OR ""otsuka"" OR ""otsuka seiyaku kabushiki-gaisha"" OR ""astex pharmaceuticals"" OR ""ucb"" OR ""union chimique belge"" OR ""moderna"" OR ""eisai"" OR ""ezai kabushiki-gaisha"" OR ""ea pharma"" OR ""csl"" OR ""zlb behring"" OR ""jiangsu hengrui medicine"" OR ""teva pharmaceuticals"" OR ""sumitomo dainippon pharma"" OR ""dainippon sumitomo seiyaku kabushiki-gaisha"" OR ""fresenius"" OR ""fresenius se & co. kgaa"" OR ""viatris"" OR ""kyowa kirin"" OR ""kyowa hakko kirin"" OR ""ipsen"" OR ""jazz pharmaceuticals"" OR ""azur pharma"" OR ""sino biopharm"" OR ""bausch health companies"" OR ""valeant pharmaceuticals"" OR ""cspc pharmaceutical group"" OR ""galapagos"" OR ""galapagos genomics"" NOT ""La Roche College"") OR author.affiliation.ror_id_lineage:(""01xdqrp08"" OR ""00by1q217"" OR ""04b2dty93"" OR ""02891sr49"" OR ""03qd7mz70"" OR ""00gtmwv55"" OR ""02f9zrr09"" OR ""04r9x1a08"" OR ""01qat3289"" OR ""01xsqw823"" OR ""02g5p4n58"" OR ""02n6c9837"" OR ""056546b03"" OR ""04hjbmv12"" OR ""00q32j219"" OR ""03g03ge92"" OR ""04hmn8g73"" OR ""00anb1726"" OR ""02f51rf24"" OR ""0435rc536"" OR ""02jqkb192"" OR ""027y26122"" OR ""01cjash87"" OR ""013k5y296"" OR ""01n029866"" OR ""01xm4wg91"" OR ""04vvh7p27"" OR ""044tc0x05"" OR ""04ayvvz32"" OR ""01wfv3m53"" OR ""04sapgw72"" OR ""01v376g59"" OR ""01g1gvr46"" OR ""000wej815"" OR ""00d801g55"" OR ""055mhsv54"" OR ""0086q4c12"" OR ""01zgpn844"" OR ""016mq8947"" OR ""04e4j5d46"")) AND publication_type:""journal article"" AND date_published>=now-10y AND field_of_study: ((""Medicine"" OR ""Internal medicine"" OR ""Pharmacology"") AND (""COPD"" OR ""Asthma"" OR ""Lung"" OR ""Idiopathic pulmonary fibrosis"" OR ""Respiratory system"" OR ""Spirometry"" OR ""Pulmonary disease"" OR ""Respiratory tract infections""))",AND date_published>=now-10y,"AND field_of_study: ((""Medicine"" OR ""Internal medicine"" OR ""Pharmacology"") AND (""COPD"" OR ""Asthma"" OR ""Lung"" OR ""Idiopathic pulmonary fibrosis"" OR ""Respiratory system"" OR ""Spirometry"" OR ""Pulmonary disease"" OR ""Respiratory tract infections""))",NA,oa_therapy_area,Pharma,Respiratory,2017,606,177,79,67,51,16,390,216
respiratory (primary search + respiratory tags) - pharma,"(author.affiliation.name:(""pfizer"" OR ""astrazeneca"" OR ""eli lilly"" OR ""merck"" OR ""emd serono"" OR ""msd"" OR ""merck sharp & dohme"" OR ""bristol myers squibb"" OR ""novartis"" OR ""roche"" OR ""hoffmann-la roche"" OR ""genentech"" OR ""johnson & johnson"" OR ""janssen"" OR ""biosense webster"" OR ""glaxosmithkline"" OR ""gsk"" OR ""abbvie"" OR ""sanofi"" OR ""sanofi-aventis"" OR ""gilead sciences"" OR ""takeda"" OR ""boehringer ingelheim"" OR ""myokardia"" OR ""amgen"" OR ""applied molecular genetics"" OR ""bayer"" OR ""vertex pharmaceuticals"" OR ""regeneron"" OR ""novo nordisk"" OR ""biogen"" OR ""biogen idec"" OR ""daiichi sankyo"" OR ""astellas pharma"" OR ""asuterasu seiyaku kabushiki-gaisha"" OR ""otsuka"" OR ""otsuka seiyaku kabushiki-gaisha"" OR ""astex pharmaceuticals"" OR ""ucb"" OR ""union chimique belge"" OR ""moderna"" OR ""eisai"" OR ""ezai kabushiki-gaisha"" OR ""ea pharma"" OR ""csl"" OR ""zlb behring"" OR ""jiangsu hengrui medicine"" OR ""teva pharmaceuticals"" OR ""sumitomo dainippon pharma"" OR ""dainippon sumitomo seiyaku kabushiki-gaisha"" OR ""fresenius"" OR ""fresenius se & co. kgaa"" OR ""viatris"" OR ""kyowa kirin"" OR ""kyowa hakko kirin"" OR ""ipsen"" OR ""jazz pharmaceuticals"" OR ""azur pharma"" OR ""sino biopharm"" OR ""bausch health companies"" OR ""valeant pharmaceuticals"" OR ""cspc pharmaceutical group"" OR ""galapagos"" OR ""galapagos genomics"" NOT ""La Roche College"") OR author.affiliation.ror_id_lineage:(""01xdqrp08"" OR ""00by1q217"" OR ""04b2dty93"" OR ""02891sr49"" OR ""03qd7mz70"" OR ""00gtmwv55"" OR ""02f9zrr09"" OR ""04r9x1a08"" OR ""01qat3289"" OR ""01xsqw823"" OR ""02g5p4n58"" OR ""02n6c9837"" OR ""056546b03"" OR ""04hjbmv12"" OR ""00q32j219"" OR ""03g03ge92"" OR ""04hmn8g73"" OR ""00anb1726"" OR ""02f51rf24"" OR ""0435rc536"" OR ""02jqkb192"" OR ""027y26122"" OR ""01cjash87"" OR ""013k5y296"" OR ""01n029866"" OR ""01xm4wg91"" OR ""04vvh7p27"" OR ""044tc0x05"" OR ""04ayvvz32"" OR ""01wfv3m53"" OR ""04sapgw72"" OR ""01v376g59"" OR ""01g1gvr46"" OR ""000wej815"" OR ""00d801g55"" OR ""055mhsv54"" OR ""0086q4c12"" OR ""01zgpn844"" OR ""016mq8947"" OR ""04e4j5d46"")) AND publication_type:""journal article"" AND date_published>=now-10y AND field_of_study: ((""Medicine"" OR ""Internal medicine"" OR ""Pharmacology"") AND (""COPD"" OR ""Asthma"" OR ""Lung"" OR ""Idiopathic pulmonary fibrosis"" OR ""Respiratory system"" OR ""Spirometry"" OR ""Pulmonary disease"" OR ""Respiratory tract infections""))",AND date_published>=now-10y,"AND field_of_study: ((""Medicine"" OR ""Internal medicine"" OR ""Pharmacology"") AND (""COPD"" OR ""Asthma"" OR ""Lung"" OR ""Idiopathic pulmonary fibrosis"" OR ""Respiratory system"" OR ""Spirometry"" OR ""Pulmonary disease"" OR ""Respiratory tract infections""))",NA,oa_therapy_area,Pharma,Respiratory,2018,610,206,66,71,29,9,381,229
respiratory (primary search + respiratory tags) - pharma,"(author.affiliation.name:(""pfizer"" OR ""astrazeneca"" OR ""eli lilly"" OR ""merck"" OR ""emd serono"" OR ""msd"" OR ""merck sharp & dohme"" OR ""bristol myers squibb"" OR ""novartis"" OR ""roche"" OR ""hoffmann-la roche"" OR ""genentech"" OR ""johnson & johnson"" OR ""janssen"" OR ""biosense webster"" OR ""glaxosmithkline"" OR ""gsk"" OR ""abbvie"" OR ""sanofi"" OR ""sanofi-aventis"" OR ""gilead sciences"" OR ""takeda"" OR ""boehringer ingelheim"" OR ""myokardia"" OR ""amgen"" OR ""applied molecular genetics"" OR ""bayer"" OR ""vertex pharmaceuticals"" OR ""regeneron"" OR ""novo nordisk"" OR ""biogen"" OR ""biogen idec"" OR ""daiichi sankyo"" OR ""astellas pharma"" OR ""asuterasu seiyaku kabushiki-gaisha"" OR ""otsuka"" OR ""otsuka seiyaku kabushiki-gaisha"" OR ""astex pharmaceuticals"" OR ""ucb"" OR ""union chimique belge"" OR ""moderna"" OR ""eisai"" OR ""ezai kabushiki-gaisha"" OR ""ea pharma"" OR ""csl"" OR ""zlb behring"" OR ""jiangsu hengrui medicine"" OR ""teva pharmaceuticals"" OR ""sumitomo dainippon pharma"" OR ""dainippon sumitomo seiyaku kabushiki-gaisha"" OR ""fresenius"" OR ""fresenius se & co. kgaa"" OR ""viatris"" OR ""kyowa kirin"" OR ""kyowa hakko kirin"" OR ""ipsen"" OR ""jazz pharmaceuticals"" OR ""azur pharma"" OR ""sino biopharm"" OR ""bausch health companies"" OR ""valeant pharmaceuticals"" OR ""cspc pharmaceutical group"" OR ""galapagos"" OR ""galapagos genomics"" NOT ""La Roche College"") OR author.affiliation.ror_id_lineage:(""01xdqrp08"" OR ""00by1q217"" OR ""04b2dty93"" OR ""02891sr49"" OR ""03qd7mz70"" OR ""00gtmwv55"" OR ""02f9zrr09"" OR ""04r9x1a08"" OR ""01qat3289"" OR ""01xsqw823"" OR ""02g5p4n58"" OR ""02n6c9837"" OR ""056546b03"" OR ""04hjbmv12"" OR ""00q32j219"" OR ""03g03ge92"" OR ""04hmn8g73"" OR ""00anb1726"" OR ""02f51rf24"" OR ""0435rc536"" OR ""02jqkb192"" OR ""027y26122"" OR ""01cjash87"" OR ""013k5y296"" OR ""01n029866"" OR ""01xm4wg91"" OR ""04vvh7p27"" OR ""044tc0x05"" OR ""04ayvvz32"" OR ""01wfv3m53"" OR ""04sapgw72"" OR ""01v376g59"" OR ""01g1gvr46"" OR ""000wej815"" OR ""00d801g55"" OR ""055mhsv54"" OR ""0086q4c12"" OR ""01zgpn844"" OR ""016mq8947"" OR ""04e4j5d46"")) AND publication_type:""journal article"" AND date_published>=now-10y AND field_of_study: ((""Medicine"" OR ""Internal medicine"" OR ""Pharmacology"") AND (""COPD"" OR ""Asthma"" OR ""Lung"" OR ""Idiopathic pulmonary fibrosis"" OR ""Respiratory system"" OR ""Spirometry"" OR ""Pulmonary disease"" OR ""Respiratory tract infections""))",AND date_published>=now-10y,"AND field_of_study: ((""Medicine"" OR ""Internal medicine"" OR ""Pharmacology"") AND (""COPD"" OR ""Asthma"" OR ""Lung"" OR ""Idiopathic pulmonary fibrosis"" OR ""Respiratory system"" OR ""Spirometry"" OR ""Pulmonary disease"" OR ""Respiratory tract infections""))",NA,oa_therapy_area,Pharma,Respiratory,2019,624,203,46,109,13,16,387,237
respiratory (primary search + respiratory tags) - pharma,"(author.affiliation.name:(""pfizer"" OR ""astrazeneca"" OR ""eli lilly"" OR ""merck"" OR ""emd serono"" OR ""msd"" OR ""merck sharp & dohme"" OR ""bristol myers squibb"" OR ""novartis"" OR ""roche"" OR ""hoffmann-la roche"" OR ""genentech"" OR ""johnson & johnson"" OR ""janssen"" OR ""biosense webster"" OR ""glaxosmithkline"" OR ""gsk"" OR ""abbvie"" OR ""sanofi"" OR ""sanofi-aventis"" OR ""gilead sciences"" OR ""takeda"" OR ""boehringer ingelheim"" OR ""myokardia"" OR ""amgen"" OR ""applied molecular genetics"" OR ""bayer"" OR ""vertex pharmaceuticals"" OR ""regeneron"" OR ""novo nordisk"" OR ""biogen"" OR ""biogen idec"" OR ""daiichi sankyo"" OR ""astellas pharma"" OR ""asuterasu seiyaku kabushiki-gaisha"" OR ""otsuka"" OR ""otsuka seiyaku kabushiki-gaisha"" OR ""astex pharmaceuticals"" OR ""ucb"" OR ""union chimique belge"" OR ""moderna"" OR ""eisai"" OR ""ezai kabushiki-gaisha"" OR ""ea pharma"" OR ""csl"" OR ""zlb behring"" OR ""jiangsu hengrui medicine"" OR ""teva pharmaceuticals"" OR ""sumitomo dainippon pharma"" OR ""dainippon sumitomo seiyaku kabushiki-gaisha"" OR ""fresenius"" OR ""fresenius se & co. kgaa"" OR ""viatris"" OR ""kyowa kirin"" OR ""kyowa hakko kirin"" OR ""ipsen"" OR ""jazz pharmaceuticals"" OR ""azur pharma"" OR ""sino biopharm"" OR ""bausch health companies"" OR ""valeant pharmaceuticals"" OR ""cspc pharmaceutical group"" OR ""galapagos"" OR ""galapagos genomics"" NOT ""La Roche College"") OR author.affiliation.ror_id_lineage:(""01xdqrp08"" OR ""00by1q217"" OR ""04b2dty93"" OR ""02891sr49"" OR ""03qd7mz70"" OR ""00gtmwv55"" OR ""02f9zrr09"" OR ""04r9x1a08"" OR ""01qat3289"" OR ""01xsqw823"" OR ""02g5p4n58"" OR ""02n6c9837"" OR ""056546b03"" OR ""04hjbmv12"" OR ""00q32j219"" OR ""03g03ge92"" OR ""04hmn8g73"" OR ""00anb1726"" OR ""02f51rf24"" OR ""0435rc536"" OR ""02jqkb192"" OR ""027y26122"" OR ""01cjash87"" OR ""013k5y296"" OR ""01n029866"" OR ""01xm4wg91"" OR ""04vvh7p27"" OR ""044tc0x05"" OR ""04ayvvz32"" OR ""01wfv3m53"" OR ""04sapgw72"" OR ""01v376g59"" OR ""01g1gvr46"" OR ""000wej815"" OR ""00d801g55"" OR ""055mhsv54"" OR ""0086q4c12"" OR ""01zgpn844"" OR ""016mq8947"" OR ""04e4j5d46"")) AND publication_type:""journal article"" AND date_published>=now-10y AND field_of_study: ((""Medicine"" OR ""Internal medicine"" OR ""Pharmacology"") AND (""COPD"" OR ""Asthma"" OR ""Lung"" OR ""Idiopathic pulmonary fibrosis"" OR ""Respiratory system"" OR ""Spirometry"" OR ""Pulmonary disease"" OR ""Respiratory tract infections""))",AND date_published>=now-10y,"AND field_of_study: ((""Medicine"" OR ""Internal medicine"" OR ""Pharmacology"") AND (""COPD"" OR ""Asthma"" OR ""Lung"" OR ""Idiopathic pulmonary fibrosis"" OR ""Respiratory system"" OR ""Spirometry"" OR ""Pulmonary disease"" OR ""Respiratory tract infections""))",NA,oa_therapy_area,Pharma,Respiratory,2020,629,237,56,117,25,4,439,190
respiratory (primary search + respiratory tags) - pharma,"(author.affiliation.name:(""pfizer"" OR ""astrazeneca"" OR ""eli lilly"" OR ""merck"" OR ""emd serono"" OR ""msd"" OR ""merck sharp & dohme"" OR ""bristol myers squibb"" OR ""novartis"" OR ""roche"" OR ""hoffmann-la roche"" OR ""genentech"" OR ""johnson & johnson"" OR ""janssen"" OR ""biosense webster"" OR ""glaxosmithkline"" OR ""gsk"" OR ""abbvie"" OR ""sanofi"" OR ""sanofi-aventis"" OR ""gilead sciences"" OR ""takeda"" OR ""boehringer ingelheim"" OR ""myokardia"" OR ""amgen"" OR ""applied molecular genetics"" OR ""bayer"" OR ""vertex pharmaceuticals"" OR ""regeneron"" OR ""novo nordisk"" OR ""biogen"" OR ""biogen idec"" OR ""daiichi sankyo"" OR ""astellas pharma"" OR ""asuterasu seiyaku kabushiki-gaisha"" OR ""otsuka"" OR ""otsuka seiyaku kabushiki-gaisha"" OR ""astex pharmaceuticals"" OR ""ucb"" OR ""union chimique belge"" OR ""moderna"" OR ""eisai"" OR ""ezai kabushiki-gaisha"" OR ""ea pharma"" OR ""csl"" OR ""zlb behring"" OR ""jiangsu hengrui medicine"" OR ""teva pharmaceuticals"" OR ""sumitomo dainippon pharma"" OR ""dainippon sumitomo seiyaku kabushiki-gaisha"" OR ""fresenius"" OR ""fresenius se & co. kgaa"" OR ""viatris"" OR ""kyowa kirin"" OR ""kyowa hakko kirin"" OR ""ipsen"" OR ""jazz pharmaceuticals"" OR ""azur pharma"" OR ""sino biopharm"" OR ""bausch health companies"" OR ""valeant pharmaceuticals"" OR ""cspc pharmaceutical group"" OR ""galapagos"" OR ""galapagos genomics"" NOT ""La Roche College"") OR author.affiliation.ror_id_lineage:(""01xdqrp08"" OR ""00by1q217"" OR ""04b2dty93"" OR ""02891sr49"" OR ""03qd7mz70"" OR ""00gtmwv55"" OR ""02f9zrr09"" OR ""04r9x1a08"" OR ""01qat3289"" OR ""01xsqw823"" OR ""02g5p4n58"" OR ""02n6c9837"" OR ""056546b03"" OR ""04hjbmv12"" OR ""00q32j219"" OR ""03g03ge92"" OR ""04hmn8g73"" OR ""00anb1726"" OR ""02f51rf24"" OR ""0435rc536"" OR ""02jqkb192"" OR ""027y26122"" OR ""01cjash87"" OR ""013k5y296"" OR ""01n029866"" OR ""01xm4wg91"" OR ""04vvh7p27"" OR ""044tc0x05"" OR ""04ayvvz32"" OR ""01wfv3m53"" OR ""04sapgw72"" OR ""01v376g59"" OR ""01g1gvr46"" OR ""000wej815"" OR ""00d801g55"" OR ""055mhsv54"" OR ""0086q4c12"" OR ""01zgpn844"" OR ""016mq8947"" OR ""04e4j5d46"")) AND publication_type:""journal article"" AND date_published>=now-10y AND field_of_study: ((""Medicine"" OR ""Internal medicine"" OR ""Pharmacology"") AND (""COPD"" OR ""Asthma"" OR ""Lung"" OR ""Idiopathic pulmonary fibrosis"" OR ""Respiratory system"" OR ""Spirometry"" OR ""Pulmonary disease"" OR ""Respiratory tract infections""))",AND date_published>=now-10y,"AND field_of_study: ((""Medicine"" OR ""Internal medicine"" OR ""Pharmacology"") AND (""COPD"" OR ""Asthma"" OR ""Lung"" OR ""Idiopathic pulmonary fibrosis"" OR ""Respiratory system"" OR ""Spirometry"" OR ""Pulmonary disease"" OR ""Respiratory tract infections""))",NA,oa_therapy_area,Pharma,Respiratory,2021,599,279,28,142,18,10,477,122
respiratory (primary search + respiratory tags) - pharma,"(author.affiliation.name:(""pfizer"" OR ""astrazeneca"" OR ""eli lilly"" OR ""merck"" OR ""emd serono"" OR ""msd"" OR ""merck sharp & dohme"" OR ""bristol myers squibb"" OR ""novartis"" OR ""roche"" OR ""hoffmann-la roche"" OR ""genentech"" OR ""johnson & johnson"" OR ""janssen"" OR ""biosense webster"" OR ""glaxosmithkline"" OR ""gsk"" OR ""abbvie"" OR ""sanofi"" OR ""sanofi-aventis"" OR ""gilead sciences"" OR ""takeda"" OR ""boehringer ingelheim"" OR ""myokardia"" OR ""amgen"" OR ""applied molecular genetics"" OR ""bayer"" OR ""vertex pharmaceuticals"" OR ""regeneron"" OR ""novo nordisk"" OR ""biogen"" OR ""biogen idec"" OR ""daiichi sankyo"" OR ""astellas pharma"" OR ""asuterasu seiyaku kabushiki-gaisha"" OR ""otsuka"" OR ""otsuka seiyaku kabushiki-gaisha"" OR ""astex pharmaceuticals"" OR ""ucb"" OR ""union chimique belge"" OR ""moderna"" OR ""eisai"" OR ""ezai kabushiki-gaisha"" OR ""ea pharma"" OR ""csl"" OR ""zlb behring"" OR ""jiangsu hengrui medicine"" OR ""teva pharmaceuticals"" OR ""sumitomo dainippon pharma"" OR ""dainippon sumitomo seiyaku kabushiki-gaisha"" OR ""fresenius"" OR ""fresenius se & co. kgaa"" OR ""viatris"" OR ""kyowa kirin"" OR ""kyowa hakko kirin"" OR ""ipsen"" OR ""jazz pharmaceuticals"" OR ""azur pharma"" OR ""sino biopharm"" OR ""bausch health companies"" OR ""valeant pharmaceuticals"" OR ""cspc pharmaceutical group"" OR ""galapagos"" OR ""galapagos genomics"" NOT ""La Roche College"") OR author.affiliation.ror_id_lineage:(""01xdqrp08"" OR ""00by1q217"" OR ""04b2dty93"" OR ""02891sr49"" OR ""03qd7mz70"" OR ""00gtmwv55"" OR ""02f9zrr09"" OR ""04r9x1a08"" OR ""01qat3289"" OR ""01xsqw823"" OR ""02g5p4n58"" OR ""02n6c9837"" OR ""056546b03"" OR ""04hjbmv12"" OR ""00q32j219"" OR ""03g03ge92"" OR ""04hmn8g73"" OR ""00anb1726"" OR ""02f51rf24"" OR ""0435rc536"" OR ""02jqkb192"" OR ""027y26122"" OR ""01cjash87"" OR ""013k5y296"" OR ""01n029866"" OR ""01xm4wg91"" OR ""04vvh7p27"" OR ""044tc0x05"" OR ""04ayvvz32"" OR ""01wfv3m53"" OR ""04sapgw72"" OR ""01v376g59"" OR ""01g1gvr46"" OR ""000wej815"" OR ""00d801g55"" OR ""055mhsv54"" OR ""0086q4c12"" OR ""01zgpn844"" OR ""016mq8947"" OR ""04e4j5d46"")) AND publication_type:""journal article"" AND date_published>=now-10y AND field_of_study: ((""Medicine"" OR ""Internal medicine"" OR ""Pharmacology"") AND (""COPD"" OR ""Asthma"" OR ""Lung"" OR ""Idiopathic pulmonary fibrosis"" OR ""Respiratory system"" OR ""Spirometry"" OR ""Pulmonary disease"" OR ""Respiratory tract infections""))",AND date_published>=now-10y,"AND field_of_study: ((""Medicine"" OR ""Internal medicine"" OR ""Pharmacology"") AND (""COPD"" OR ""Asthma"" OR ""Lung"" OR ""Idiopathic pulmonary fibrosis"" OR ""Respiratory system"" OR ""Spirometry"" OR ""Pulmonary disease"" OR ""Respiratory tract infections""))",NA,oa_therapy_area,Pharma,Respiratory,2022,679,348,46,168,20,10,592,87
respiratory (primary search + respiratory tags) - pharma,"(author.affiliation.name:(""pfizer"" OR ""astrazeneca"" OR ""eli lilly"" OR ""merck"" OR ""emd serono"" OR ""msd"" OR ""merck sharp & dohme"" OR ""bristol myers squibb"" OR ""novartis"" OR ""roche"" OR ""hoffmann-la roche"" OR ""genentech"" OR ""johnson & johnson"" OR ""janssen"" OR ""biosense webster"" OR ""glaxosmithkline"" OR ""gsk"" OR ""abbvie"" OR ""sanofi"" OR ""sanofi-aventis"" OR ""gilead sciences"" OR ""takeda"" OR ""boehringer ingelheim"" OR ""myokardia"" OR ""amgen"" OR ""applied molecular genetics"" OR ""bayer"" OR ""vertex pharmaceuticals"" OR ""regeneron"" OR ""novo nordisk"" OR ""biogen"" OR ""biogen idec"" OR ""daiichi sankyo"" OR ""astellas pharma"" OR ""asuterasu seiyaku kabushiki-gaisha"" OR ""otsuka"" OR ""otsuka seiyaku kabushiki-gaisha"" OR ""astex pharmaceuticals"" OR ""ucb"" OR ""union chimique belge"" OR ""moderna"" OR ""eisai"" OR ""ezai kabushiki-gaisha"" OR ""ea pharma"" OR ""csl"" OR ""zlb behring"" OR ""jiangsu hengrui medicine"" OR ""teva pharmaceuticals"" OR ""sumitomo dainippon pharma"" OR ""dainippon sumitomo seiyaku kabushiki-gaisha"" OR ""fresenius"" OR ""fresenius se & co. kgaa"" OR ""viatris"" OR ""kyowa kirin"" OR ""kyowa hakko kirin"" OR ""ipsen"" OR ""jazz pharmaceuticals"" OR ""azur pharma"" OR ""sino biopharm"" OR ""bausch health companies"" OR ""valeant pharmaceuticals"" OR ""cspc pharmaceutical group"" OR ""galapagos"" OR ""galapagos genomics"" NOT ""La Roche College"") OR author.affiliation.ror_id_lineage:(""01xdqrp08"" OR ""00by1q217"" OR ""04b2dty93"" OR ""02891sr49"" OR ""03qd7mz70"" OR ""00gtmwv55"" OR ""02f9zrr09"" OR ""04r9x1a08"" OR ""01qat3289"" OR ""01xsqw823"" OR ""02g5p4n58"" OR ""02n6c9837"" OR ""056546b03"" OR ""04hjbmv12"" OR ""00q32j219"" OR ""03g03ge92"" OR ""04hmn8g73"" OR ""00anb1726"" OR ""02f51rf24"" OR ""0435rc536"" OR ""02jqkb192"" OR ""027y26122"" OR ""01cjash87"" OR ""013k5y296"" OR ""01n029866"" OR ""01xm4wg91"" OR ""04vvh7p27"" OR ""044tc0x05"" OR ""04ayvvz32"" OR ""01wfv3m53"" OR ""04sapgw72"" OR ""01v376g59"" OR ""01g1gvr46"" OR ""000wej815"" OR ""00d801g55"" OR ""055mhsv54"" OR ""0086q4c12"" OR ""01zgpn844"" OR ""016mq8947"" OR ""04e4j5d46"")) AND publication_type:""journal article"" AND date_published>=now-10y AND field_of_study: ((""Medicine"" OR ""Internal medicine"" OR ""Pharmacology"") AND (""COPD"" OR ""Asthma"" OR ""Lung"" OR ""Idiopathic pulmonary fibrosis"" OR ""Respiratory system"" OR ""Spirometry"" OR ""Pulmonary disease"" OR ""Respiratory tract infections""))",AND date_published>=now-10y,"AND field_of_study: ((""Medicine"" OR ""Internal medicine"" OR ""Pharmacology"") AND (""COPD"" OR ""Asthma"" OR ""Lung"" OR ""Idiopathic pulmonary fibrosis"" OR ""Respiratory system"" OR ""Spirometry"" OR ""Pulmonary disease"" OR ""Respiratory tract infections""))",NA,oa_therapy_area,Pharma,Respiratory,2023,249,128,5,38,3,26,200,49
genitourinary disorders (including nephrology)  (primary search + genitourinary tags) - pharma,"(author.affiliation.name:(""pfizer"" OR ""astrazeneca"" OR ""eli lilly"" OR ""merck"" OR ""emd serono"" OR ""msd"" OR ""merck sharp & dohme"" OR ""bristol myers squibb"" OR ""novartis"" OR ""roche"" OR ""hoffmann-la roche"" OR ""genentech"" OR ""johnson & johnson"" OR ""janssen"" OR ""biosense webster"" OR ""glaxosmithkline"" OR ""gsk"" OR ""abbvie"" OR ""sanofi"" OR ""sanofi-aventis"" OR ""gilead sciences"" OR ""takeda"" OR ""boehringer ingelheim"" OR ""myokardia"" OR ""amgen"" OR ""applied molecular genetics"" OR ""bayer"" OR ""vertex pharmaceuticals"" OR ""regeneron"" OR ""novo nordisk"" OR ""biogen"" OR ""biogen idec"" OR ""daiichi sankyo"" OR ""astellas pharma"" OR ""asuterasu seiyaku kabushiki-gaisha"" OR ""otsuka"" OR ""otsuka seiyaku kabushiki-gaisha"" OR ""astex pharmaceuticals"" OR ""ucb"" OR ""union chimique belge"" OR ""moderna"" OR ""eisai"" OR ""ezai kabushiki-gaisha"" OR ""ea pharma"" OR ""csl"" OR ""zlb behring"" OR ""jiangsu hengrui medicine"" OR ""teva pharmaceuticals"" OR ""sumitomo dainippon pharma"" OR ""dainippon sumitomo seiyaku kabushiki-gaisha"" OR ""fresenius"" OR ""fresenius se & co. kgaa"" OR ""viatris"" OR ""kyowa kirin"" OR ""kyowa hakko kirin"" OR ""ipsen"" OR ""jazz pharmaceuticals"" OR ""azur pharma"" OR ""sino biopharm"" OR ""bausch health companies"" OR ""valeant pharmaceuticals"" OR ""cspc pharmaceutical group"" OR ""galapagos"" OR ""galapagos genomics"" NOT ""La Roche College"") OR author.affiliation.ror_id_lineage:(""01xdqrp08"" OR ""00by1q217"" OR ""04b2dty93"" OR ""02891sr49"" OR ""03qd7mz70"" OR ""00gtmwv55"" OR ""02f9zrr09"" OR ""04r9x1a08"" OR ""01qat3289"" OR ""01xsqw823"" OR ""02g5p4n58"" OR ""02n6c9837"" OR ""056546b03"" OR ""04hjbmv12"" OR ""00q32j219"" OR ""03g03ge92"" OR ""04hmn8g73"" OR ""00anb1726"" OR ""02f51rf24"" OR ""0435rc536"" OR ""02jqkb192"" OR ""027y26122"" OR ""01cjash87"" OR ""013k5y296"" OR ""01n029866"" OR ""01xm4wg91"" OR ""04vvh7p27"" OR ""044tc0x05"" OR ""04ayvvz32"" OR ""01wfv3m53"" OR ""04sapgw72"" OR ""01v376g59"" OR ""01g1gvr46"" OR ""000wej815"" OR ""00d801g55"" OR ""055mhsv54"" OR ""0086q4c12"" OR ""01zgpn844"" OR ""016mq8947"" OR ""04e4j5d46"")) AND publication_type:""journal article"" AND date_published>=now-10y AND field_of_study: ((""Medicine"" OR ""Internal medicine"" OR ""Pharmacology"") AND (""Urology"" OR ""Renal function"" OR ""Kidney disease"" OR ""Kidney"" OR ""Urinary system"" OR ""Urine"" OR ""End stage renal disease"" OR ""Acute kidney injury""))",AND date_published>=now-10y,"AND field_of_study: ((""Medicine"" OR ""Internal medicine"" OR ""Pharmacology"") AND (""Urology"" OR ""Renal function"" OR ""Kidney disease"" OR ""Kidney"" OR ""Urinary system"" OR ""Urine"" OR ""End stage renal disease"" OR ""Acute kidney injury""))",NA,oa_therapy_area,Pharma,Genitourinary disorders,2013,179,23,18,21,19,3,84,95
genitourinary disorders (including nephrology)  (primary search + genitourinary tags) - pharma,"(author.affiliation.name:(""pfizer"" OR ""astrazeneca"" OR ""eli lilly"" OR ""merck"" OR ""emd serono"" OR ""msd"" OR ""merck sharp & dohme"" OR ""bristol myers squibb"" OR ""novartis"" OR ""roche"" OR ""hoffmann-la roche"" OR ""genentech"" OR ""johnson & johnson"" OR ""janssen"" OR ""biosense webster"" OR ""glaxosmithkline"" OR ""gsk"" OR ""abbvie"" OR ""sanofi"" OR ""sanofi-aventis"" OR ""gilead sciences"" OR ""takeda"" OR ""boehringer ingelheim"" OR ""myokardia"" OR ""amgen"" OR ""applied molecular genetics"" OR ""bayer"" OR ""vertex pharmaceuticals"" OR ""regeneron"" OR ""novo nordisk"" OR ""biogen"" OR ""biogen idec"" OR ""daiichi sankyo"" OR ""astellas pharma"" OR ""asuterasu seiyaku kabushiki-gaisha"" OR ""otsuka"" OR ""otsuka seiyaku kabushiki-gaisha"" OR ""astex pharmaceuticals"" OR ""ucb"" OR ""union chimique belge"" OR ""moderna"" OR ""eisai"" OR ""ezai kabushiki-gaisha"" OR ""ea pharma"" OR ""csl"" OR ""zlb behring"" OR ""jiangsu hengrui medicine"" OR ""teva pharmaceuticals"" OR ""sumitomo dainippon pharma"" OR ""dainippon sumitomo seiyaku kabushiki-gaisha"" OR ""fresenius"" OR ""fresenius se & co. kgaa"" OR ""viatris"" OR ""kyowa kirin"" OR ""kyowa hakko kirin"" OR ""ipsen"" OR ""jazz pharmaceuticals"" OR ""azur pharma"" OR ""sino biopharm"" OR ""bausch health companies"" OR ""valeant pharmaceuticals"" OR ""cspc pharmaceutical group"" OR ""galapagos"" OR ""galapagos genomics"" NOT ""La Roche College"") OR author.affiliation.ror_id_lineage:(""01xdqrp08"" OR ""00by1q217"" OR ""04b2dty93"" OR ""02891sr49"" OR ""03qd7mz70"" OR ""00gtmwv55"" OR ""02f9zrr09"" OR ""04r9x1a08"" OR ""01qat3289"" OR ""01xsqw823"" OR ""02g5p4n58"" OR ""02n6c9837"" OR ""056546b03"" OR ""04hjbmv12"" OR ""00q32j219"" OR ""03g03ge92"" OR ""04hmn8g73"" OR ""00anb1726"" OR ""02f51rf24"" OR ""0435rc536"" OR ""02jqkb192"" OR ""027y26122"" OR ""01cjash87"" OR ""013k5y296"" OR ""01n029866"" OR ""01xm4wg91"" OR ""04vvh7p27"" OR ""044tc0x05"" OR ""04ayvvz32"" OR ""01wfv3m53"" OR ""04sapgw72"" OR ""01v376g59"" OR ""01g1gvr46"" OR ""000wej815"" OR ""00d801g55"" OR ""055mhsv54"" OR ""0086q4c12"" OR ""01zgpn844"" OR ""016mq8947"" OR ""04e4j5d46"")) AND publication_type:""journal article"" AND date_published>=now-10y AND field_of_study: ((""Medicine"" OR ""Internal medicine"" OR ""Pharmacology"") AND (""Urology"" OR ""Renal function"" OR ""Kidney disease"" OR ""Kidney"" OR ""Urinary system"" OR ""Urine"" OR ""End stage renal disease"" OR ""Acute kidney injury""))",AND date_published>=now-10y,"AND field_of_study: ((""Medicine"" OR ""Internal medicine"" OR ""Pharmacology"") AND (""Urology"" OR ""Renal function"" OR ""Kidney disease"" OR ""Kidney"" OR ""Urinary system"" OR ""Urine"" OR ""End stage renal disease"" OR ""Acute kidney injury""))",NA,oa_therapy_area,Pharma,Genitourinary disorders,2014,465,81,53,39,42,19,234,231
genitourinary disorders (including nephrology)  (primary search + genitourinary tags) - pharma,"(author.affiliation.name:(""pfizer"" OR ""astrazeneca"" OR ""eli lilly"" OR ""merck"" OR ""emd serono"" OR ""msd"" OR ""merck sharp & dohme"" OR ""bristol myers squibb"" OR ""novartis"" OR ""roche"" OR ""hoffmann-la roche"" OR ""genentech"" OR ""johnson & johnson"" OR ""janssen"" OR ""biosense webster"" OR ""glaxosmithkline"" OR ""gsk"" OR ""abbvie"" OR ""sanofi"" OR ""sanofi-aventis"" OR ""gilead sciences"" OR ""takeda"" OR ""boehringer ingelheim"" OR ""myokardia"" OR ""amgen"" OR ""applied molecular genetics"" OR ""bayer"" OR ""vertex pharmaceuticals"" OR ""regeneron"" OR ""novo nordisk"" OR ""biogen"" OR ""biogen idec"" OR ""daiichi sankyo"" OR ""astellas pharma"" OR ""asuterasu seiyaku kabushiki-gaisha"" OR ""otsuka"" OR ""otsuka seiyaku kabushiki-gaisha"" OR ""astex pharmaceuticals"" OR ""ucb"" OR ""union chimique belge"" OR ""moderna"" OR ""eisai"" OR ""ezai kabushiki-gaisha"" OR ""ea pharma"" OR ""csl"" OR ""zlb behring"" OR ""jiangsu hengrui medicine"" OR ""teva pharmaceuticals"" OR ""sumitomo dainippon pharma"" OR ""dainippon sumitomo seiyaku kabushiki-gaisha"" OR ""fresenius"" OR ""fresenius se & co. kgaa"" OR ""viatris"" OR ""kyowa kirin"" OR ""kyowa hakko kirin"" OR ""ipsen"" OR ""jazz pharmaceuticals"" OR ""azur pharma"" OR ""sino biopharm"" OR ""bausch health companies"" OR ""valeant pharmaceuticals"" OR ""cspc pharmaceutical group"" OR ""galapagos"" OR ""galapagos genomics"" NOT ""La Roche College"") OR author.affiliation.ror_id_lineage:(""01xdqrp08"" OR ""00by1q217"" OR ""04b2dty93"" OR ""02891sr49"" OR ""03qd7mz70"" OR ""00gtmwv55"" OR ""02f9zrr09"" OR ""04r9x1a08"" OR ""01qat3289"" OR ""01xsqw823"" OR ""02g5p4n58"" OR ""02n6c9837"" OR ""056546b03"" OR ""04hjbmv12"" OR ""00q32j219"" OR ""03g03ge92"" OR ""04hmn8g73"" OR ""00anb1726"" OR ""02f51rf24"" OR ""0435rc536"" OR ""02jqkb192"" OR ""027y26122"" OR ""01cjash87"" OR ""013k5y296"" OR ""01n029866"" OR ""01xm4wg91"" OR ""04vvh7p27"" OR ""044tc0x05"" OR ""04ayvvz32"" OR ""01wfv3m53"" OR ""04sapgw72"" OR ""01v376g59"" OR ""01g1gvr46"" OR ""000wej815"" OR ""00d801g55"" OR ""055mhsv54"" OR ""0086q4c12"" OR ""01zgpn844"" OR ""016mq8947"" OR ""04e4j5d46"")) AND publication_type:""journal article"" AND date_published>=now-10y AND field_of_study: ((""Medicine"" OR ""Internal medicine"" OR ""Pharmacology"") AND (""Urology"" OR ""Renal function"" OR ""Kidney disease"" OR ""Kidney"" OR ""Urinary system"" OR ""Urine"" OR ""End stage renal disease"" OR ""Acute kidney injury""))",AND date_published>=now-10y,"AND field_of_study: ((""Medicine"" OR ""Internal medicine"" OR ""Pharmacology"") AND (""Urology"" OR ""Renal function"" OR ""Kidney disease"" OR ""Kidney"" OR ""Urinary system"" OR ""Urine"" OR ""End stage renal disease"" OR ""Acute kidney injury""))",NA,oa_therapy_area,Pharma,Genitourinary disorders,2015,464,87,67,58,51,5,268,196
genitourinary disorders (including nephrology)  (primary search + genitourinary tags) - pharma,"(author.affiliation.name:(""pfizer"" OR ""astrazeneca"" OR ""eli lilly"" OR ""merck"" OR ""emd serono"" OR ""msd"" OR ""merck sharp & dohme"" OR ""bristol myers squibb"" OR ""novartis"" OR ""roche"" OR ""hoffmann-la roche"" OR ""genentech"" OR ""johnson & johnson"" OR ""janssen"" OR ""biosense webster"" OR ""glaxosmithkline"" OR ""gsk"" OR ""abbvie"" OR ""sanofi"" OR ""sanofi-aventis"" OR ""gilead sciences"" OR ""takeda"" OR ""boehringer ingelheim"" OR ""myokardia"" OR ""amgen"" OR ""applied molecular genetics"" OR ""bayer"" OR ""vertex pharmaceuticals"" OR ""regeneron"" OR ""novo nordisk"" OR ""biogen"" OR ""biogen idec"" OR ""daiichi sankyo"" OR ""astellas pharma"" OR ""asuterasu seiyaku kabushiki-gaisha"" OR ""otsuka"" OR ""otsuka seiyaku kabushiki-gaisha"" OR ""astex pharmaceuticals"" OR ""ucb"" OR ""union chimique belge"" OR ""moderna"" OR ""eisai"" OR ""ezai kabushiki-gaisha"" OR ""ea pharma"" OR ""csl"" OR ""zlb behring"" OR ""jiangsu hengrui medicine"" OR ""teva pharmaceuticals"" OR ""sumitomo dainippon pharma"" OR ""dainippon sumitomo seiyaku kabushiki-gaisha"" OR ""fresenius"" OR ""fresenius se & co. kgaa"" OR ""viatris"" OR ""kyowa kirin"" OR ""kyowa hakko kirin"" OR ""ipsen"" OR ""jazz pharmaceuticals"" OR ""azur pharma"" OR ""sino biopharm"" OR ""bausch health companies"" OR ""valeant pharmaceuticals"" OR ""cspc pharmaceutical group"" OR ""galapagos"" OR ""galapagos genomics"" NOT ""La Roche College"") OR author.affiliation.ror_id_lineage:(""01xdqrp08"" OR ""00by1q217"" OR ""04b2dty93"" OR ""02891sr49"" OR ""03qd7mz70"" OR ""00gtmwv55"" OR ""02f9zrr09"" OR ""04r9x1a08"" OR ""01qat3289"" OR ""01xsqw823"" OR ""02g5p4n58"" OR ""02n6c9837"" OR ""056546b03"" OR ""04hjbmv12"" OR ""00q32j219"" OR ""03g03ge92"" OR ""04hmn8g73"" OR ""00anb1726"" OR ""02f51rf24"" OR ""0435rc536"" OR ""02jqkb192"" OR ""027y26122"" OR ""01cjash87"" OR ""013k5y296"" OR ""01n029866"" OR ""01xm4wg91"" OR ""04vvh7p27"" OR ""044tc0x05"" OR ""04ayvvz32"" OR ""01wfv3m53"" OR ""04sapgw72"" OR ""01v376g59"" OR ""01g1gvr46"" OR ""000wej815"" OR ""00d801g55"" OR ""055mhsv54"" OR ""0086q4c12"" OR ""01zgpn844"" OR ""016mq8947"" OR ""04e4j5d46"")) AND publication_type:""journal article"" AND date_published>=now-10y AND field_of_study: ((""Medicine"" OR ""Internal medicine"" OR ""Pharmacology"") AND (""Urology"" OR ""Renal function"" OR ""Kidney disease"" OR ""Kidney"" OR ""Urinary system"" OR ""Urine"" OR ""End stage renal disease"" OR ""Acute kidney injury""))",AND date_published>=now-10y,"AND field_of_study: ((""Medicine"" OR ""Internal medicine"" OR ""Pharmacology"") AND (""Urology"" OR ""Renal function"" OR ""Kidney disease"" OR ""Kidney"" OR ""Urinary system"" OR ""Urine"" OR ""End stage renal disease"" OR ""Acute kidney injury""))",NA,oa_therapy_area,Pharma,Genitourinary disorders,2016,500,106,71,77,47,4,305,195
genitourinary disorders (including nephrology)  (primary search + genitourinary tags) - pharma,"(author.affiliation.name:(""pfizer"" OR ""astrazeneca"" OR ""eli lilly"" OR ""merck"" OR ""emd serono"" OR ""msd"" OR ""merck sharp & dohme"" OR ""bristol myers squibb"" OR ""novartis"" OR ""roche"" OR ""hoffmann-la roche"" OR ""genentech"" OR ""johnson & johnson"" OR ""janssen"" OR ""biosense webster"" OR ""glaxosmithkline"" OR ""gsk"" OR ""abbvie"" OR ""sanofi"" OR ""sanofi-aventis"" OR ""gilead sciences"" OR ""takeda"" OR ""boehringer ingelheim"" OR ""myokardia"" OR ""amgen"" OR ""applied molecular genetics"" OR ""bayer"" OR ""vertex pharmaceuticals"" OR ""regeneron"" OR ""novo nordisk"" OR ""biogen"" OR ""biogen idec"" OR ""daiichi sankyo"" OR ""astellas pharma"" OR ""asuterasu seiyaku kabushiki-gaisha"" OR ""otsuka"" OR ""otsuka seiyaku kabushiki-gaisha"" OR ""astex pharmaceuticals"" OR ""ucb"" OR ""union chimique belge"" OR ""moderna"" OR ""eisai"" OR ""ezai kabushiki-gaisha"" OR ""ea pharma"" OR ""csl"" OR ""zlb behring"" OR ""jiangsu hengrui medicine"" OR ""teva pharmaceuticals"" OR ""sumitomo dainippon pharma"" OR ""dainippon sumitomo seiyaku kabushiki-gaisha"" OR ""fresenius"" OR ""fresenius se & co. kgaa"" OR ""viatris"" OR ""kyowa kirin"" OR ""kyowa hakko kirin"" OR ""ipsen"" OR ""jazz pharmaceuticals"" OR ""azur pharma"" OR ""sino biopharm"" OR ""bausch health companies"" OR ""valeant pharmaceuticals"" OR ""cspc pharmaceutical group"" OR ""galapagos"" OR ""galapagos genomics"" NOT ""La Roche College"") OR author.affiliation.ror_id_lineage:(""01xdqrp08"" OR ""00by1q217"" OR ""04b2dty93"" OR ""02891sr49"" OR ""03qd7mz70"" OR ""00gtmwv55"" OR ""02f9zrr09"" OR ""04r9x1a08"" OR ""01qat3289"" OR ""01xsqw823"" OR ""02g5p4n58"" OR ""02n6c9837"" OR ""056546b03"" OR ""04hjbmv12"" OR ""00q32j219"" OR ""03g03ge92"" OR ""04hmn8g73"" OR ""00anb1726"" OR ""02f51rf24"" OR ""0435rc536"" OR ""02jqkb192"" OR ""027y26122"" OR ""01cjash87"" OR ""013k5y296"" OR ""01n029866"" OR ""01xm4wg91"" OR ""04vvh7p27"" OR ""044tc0x05"" OR ""04ayvvz32"" OR ""01wfv3m53"" OR ""04sapgw72"" OR ""01v376g59"" OR ""01g1gvr46"" OR ""000wej815"" OR ""00d801g55"" OR ""055mhsv54"" OR ""0086q4c12"" OR ""01zgpn844"" OR ""016mq8947"" OR ""04e4j5d46"")) AND publication_type:""journal article"" AND date_published>=now-10y AND field_of_study: ((""Medicine"" OR ""Internal medicine"" OR ""Pharmacology"") AND (""Urology"" OR ""Renal function"" OR ""Kidney disease"" OR ""Kidney"" OR ""Urinary system"" OR ""Urine"" OR ""End stage renal disease"" OR ""Acute kidney injury""))",AND date_published>=now-10y,"AND field_of_study: ((""Medicine"" OR ""Internal medicine"" OR ""Pharmacology"") AND (""Urology"" OR ""Renal function"" OR ""Kidney disease"" OR ""Kidney"" OR ""Urinary system"" OR ""Urine"" OR ""End stage renal disease"" OR ""Acute kidney injury""))",NA,oa_therapy_area,Pharma,Genitourinary disorders,2017,489,101,83,78,49,7,318,171
genitourinary disorders (including nephrology)  (primary search + genitourinary tags) - pharma,"(author.affiliation.name:(""pfizer"" OR ""astrazeneca"" OR ""eli lilly"" OR ""merck"" OR ""emd serono"" OR ""msd"" OR ""merck sharp & dohme"" OR ""bristol myers squibb"" OR ""novartis"" OR ""roche"" OR ""hoffmann-la roche"" OR ""genentech"" OR ""johnson & johnson"" OR ""janssen"" OR ""biosense webster"" OR ""glaxosmithkline"" OR ""gsk"" OR ""abbvie"" OR ""sanofi"" OR ""sanofi-aventis"" OR ""gilead sciences"" OR ""takeda"" OR ""boehringer ingelheim"" OR ""myokardia"" OR ""amgen"" OR ""applied molecular genetics"" OR ""bayer"" OR ""vertex pharmaceuticals"" OR ""regeneron"" OR ""novo nordisk"" OR ""biogen"" OR ""biogen idec"" OR ""daiichi sankyo"" OR ""astellas pharma"" OR ""asuterasu seiyaku kabushiki-gaisha"" OR ""otsuka"" OR ""otsuka seiyaku kabushiki-gaisha"" OR ""astex pharmaceuticals"" OR ""ucb"" OR ""union chimique belge"" OR ""moderna"" OR ""eisai"" OR ""ezai kabushiki-gaisha"" OR ""ea pharma"" OR ""csl"" OR ""zlb behring"" OR ""jiangsu hengrui medicine"" OR ""teva pharmaceuticals"" OR ""sumitomo dainippon pharma"" OR ""dainippon sumitomo seiyaku kabushiki-gaisha"" OR ""fresenius"" OR ""fresenius se & co. kgaa"" OR ""viatris"" OR ""kyowa kirin"" OR ""kyowa hakko kirin"" OR ""ipsen"" OR ""jazz pharmaceuticals"" OR ""azur pharma"" OR ""sino biopharm"" OR ""bausch health companies"" OR ""valeant pharmaceuticals"" OR ""cspc pharmaceutical group"" OR ""galapagos"" OR ""galapagos genomics"" NOT ""La Roche College"") OR author.affiliation.ror_id_lineage:(""01xdqrp08"" OR ""00by1q217"" OR ""04b2dty93"" OR ""02891sr49"" OR ""03qd7mz70"" OR ""00gtmwv55"" OR ""02f9zrr09"" OR ""04r9x1a08"" OR ""01qat3289"" OR ""01xsqw823"" OR ""02g5p4n58"" OR ""02n6c9837"" OR ""056546b03"" OR ""04hjbmv12"" OR ""00q32j219"" OR ""03g03ge92"" OR ""04hmn8g73"" OR ""00anb1726"" OR ""02f51rf24"" OR ""0435rc536"" OR ""02jqkb192"" OR ""027y26122"" OR ""01cjash87"" OR ""013k5y296"" OR ""01n029866"" OR ""01xm4wg91"" OR ""04vvh7p27"" OR ""044tc0x05"" OR ""04ayvvz32"" OR ""01wfv3m53"" OR ""04sapgw72"" OR ""01v376g59"" OR ""01g1gvr46"" OR ""000wej815"" OR ""00d801g55"" OR ""055mhsv54"" OR ""0086q4c12"" OR ""01zgpn844"" OR ""016mq8947"" OR ""04e4j5d46"")) AND publication_type:""journal article"" AND date_published>=now-10y AND field_of_study: ((""Medicine"" OR ""Internal medicine"" OR ""Pharmacology"") AND (""Urology"" OR ""Renal function"" OR ""Kidney disease"" OR ""Kidney"" OR ""Urinary system"" OR ""Urine"" OR ""End stage renal disease"" OR ""Acute kidney injury""))",AND date_published>=now-10y,"AND field_of_study: ((""Medicine"" OR ""Internal medicine"" OR ""Pharmacology"") AND (""Urology"" OR ""Renal function"" OR ""Kidney disease"" OR ""Kidney"" OR ""Urinary system"" OR ""Urine"" OR ""End stage renal disease"" OR ""Acute kidney injury""))",NA,oa_therapy_area,Pharma,Genitourinary disorders,2018,516,116,76,112,66,2,372,144
genitourinary disorders (including nephrology)  (primary search + genitourinary tags) - pharma,"(author.affiliation.name:(""pfizer"" OR ""astrazeneca"" OR ""eli lilly"" OR ""merck"" OR ""emd serono"" OR ""msd"" OR ""merck sharp & dohme"" OR ""bristol myers squibb"" OR ""novartis"" OR ""roche"" OR ""hoffmann-la roche"" OR ""genentech"" OR ""johnson & johnson"" OR ""janssen"" OR ""biosense webster"" OR ""glaxosmithkline"" OR ""gsk"" OR ""abbvie"" OR ""sanofi"" OR ""sanofi-aventis"" OR ""gilead sciences"" OR ""takeda"" OR ""boehringer ingelheim"" OR ""myokardia"" OR ""amgen"" OR ""applied molecular genetics"" OR ""bayer"" OR ""vertex pharmaceuticals"" OR ""regeneron"" OR ""novo nordisk"" OR ""biogen"" OR ""biogen idec"" OR ""daiichi sankyo"" OR ""astellas pharma"" OR ""asuterasu seiyaku kabushiki-gaisha"" OR ""otsuka"" OR ""otsuka seiyaku kabushiki-gaisha"" OR ""astex pharmaceuticals"" OR ""ucb"" OR ""union chimique belge"" OR ""moderna"" OR ""eisai"" OR ""ezai kabushiki-gaisha"" OR ""ea pharma"" OR ""csl"" OR ""zlb behring"" OR ""jiangsu hengrui medicine"" OR ""teva pharmaceuticals"" OR ""sumitomo dainippon pharma"" OR ""dainippon sumitomo seiyaku kabushiki-gaisha"" OR ""fresenius"" OR ""fresenius se & co. kgaa"" OR ""viatris"" OR ""kyowa kirin"" OR ""kyowa hakko kirin"" OR ""ipsen"" OR ""jazz pharmaceuticals"" OR ""azur pharma"" OR ""sino biopharm"" OR ""bausch health companies"" OR ""valeant pharmaceuticals"" OR ""cspc pharmaceutical group"" OR ""galapagos"" OR ""galapagos genomics"" NOT ""La Roche College"") OR author.affiliation.ror_id_lineage:(""01xdqrp08"" OR ""00by1q217"" OR ""04b2dty93"" OR ""02891sr49"" OR ""03qd7mz70"" OR ""00gtmwv55"" OR ""02f9zrr09"" OR ""04r9x1a08"" OR ""01qat3289"" OR ""01xsqw823"" OR ""02g5p4n58"" OR ""02n6c9837"" OR ""056546b03"" OR ""04hjbmv12"" OR ""00q32j219"" OR ""03g03ge92"" OR ""04hmn8g73"" OR ""00anb1726"" OR ""02f51rf24"" OR ""0435rc536"" OR ""02jqkb192"" OR ""027y26122"" OR ""01cjash87"" OR ""013k5y296"" OR ""01n029866"" OR ""01xm4wg91"" OR ""04vvh7p27"" OR ""044tc0x05"" OR ""04ayvvz32"" OR ""01wfv3m53"" OR ""04sapgw72"" OR ""01v376g59"" OR ""01g1gvr46"" OR ""000wej815"" OR ""00d801g55"" OR ""055mhsv54"" OR ""0086q4c12"" OR ""01zgpn844"" OR ""016mq8947"" OR ""04e4j5d46"")) AND publication_type:""journal article"" AND date_published>=now-10y AND field_of_study: ((""Medicine"" OR ""Internal medicine"" OR ""Pharmacology"") AND (""Urology"" OR ""Renal function"" OR ""Kidney disease"" OR ""Kidney"" OR ""Urinary system"" OR ""Urine"" OR ""End stage renal disease"" OR ""Acute kidney injury""))",AND date_published>=now-10y,"AND field_of_study: ((""Medicine"" OR ""Internal medicine"" OR ""Pharmacology"") AND (""Urology"" OR ""Renal function"" OR ""Kidney disease"" OR ""Kidney"" OR ""Urinary system"" OR ""Urine"" OR ""End stage renal disease"" OR ""Acute kidney injury""))",NA,oa_therapy_area,Pharma,Genitourinary disorders,2019,530,152,57,130,44,3,386,144
genitourinary disorders (including nephrology)  (primary search + genitourinary tags) - pharma,"(author.affiliation.name:(""pfizer"" OR ""astrazeneca"" OR ""eli lilly"" OR ""merck"" OR ""emd serono"" OR ""msd"" OR ""merck sharp & dohme"" OR ""bristol myers squibb"" OR ""novartis"" OR ""roche"" OR ""hoffmann-la roche"" OR ""genentech"" OR ""johnson & johnson"" OR ""janssen"" OR ""biosense webster"" OR ""glaxosmithkline"" OR ""gsk"" OR ""abbvie"" OR ""sanofi"" OR ""sanofi-aventis"" OR ""gilead sciences"" OR ""takeda"" OR ""boehringer ingelheim"" OR ""myokardia"" OR ""amgen"" OR ""applied molecular genetics"" OR ""bayer"" OR ""vertex pharmaceuticals"" OR ""regeneron"" OR ""novo nordisk"" OR ""biogen"" OR ""biogen idec"" OR ""daiichi sankyo"" OR ""astellas pharma"" OR ""asuterasu seiyaku kabushiki-gaisha"" OR ""otsuka"" OR ""otsuka seiyaku kabushiki-gaisha"" OR ""astex pharmaceuticals"" OR ""ucb"" OR ""union chimique belge"" OR ""moderna"" OR ""eisai"" OR ""ezai kabushiki-gaisha"" OR ""ea pharma"" OR ""csl"" OR ""zlb behring"" OR ""jiangsu hengrui medicine"" OR ""teva pharmaceuticals"" OR ""sumitomo dainippon pharma"" OR ""dainippon sumitomo seiyaku kabushiki-gaisha"" OR ""fresenius"" OR ""fresenius se & co. kgaa"" OR ""viatris"" OR ""kyowa kirin"" OR ""kyowa hakko kirin"" OR ""ipsen"" OR ""jazz pharmaceuticals"" OR ""azur pharma"" OR ""sino biopharm"" OR ""bausch health companies"" OR ""valeant pharmaceuticals"" OR ""cspc pharmaceutical group"" OR ""galapagos"" OR ""galapagos genomics"" NOT ""La Roche College"") OR author.affiliation.ror_id_lineage:(""01xdqrp08"" OR ""00by1q217"" OR ""04b2dty93"" OR ""02891sr49"" OR ""03qd7mz70"" OR ""00gtmwv55"" OR ""02f9zrr09"" OR ""04r9x1a08"" OR ""01qat3289"" OR ""01xsqw823"" OR ""02g5p4n58"" OR ""02n6c9837"" OR ""056546b03"" OR ""04hjbmv12"" OR ""00q32j219"" OR ""03g03ge92"" OR ""04hmn8g73"" OR ""00anb1726"" OR ""02f51rf24"" OR ""0435rc536"" OR ""02jqkb192"" OR ""027y26122"" OR ""01cjash87"" OR ""013k5y296"" OR ""01n029866"" OR ""01xm4wg91"" OR ""04vvh7p27"" OR ""044tc0x05"" OR ""04ayvvz32"" OR ""01wfv3m53"" OR ""04sapgw72"" OR ""01v376g59"" OR ""01g1gvr46"" OR ""000wej815"" OR ""00d801g55"" OR ""055mhsv54"" OR ""0086q4c12"" OR ""01zgpn844"" OR ""016mq8947"" OR ""04e4j5d46"")) AND publication_type:""journal article"" AND date_published>=now-10y AND field_of_study: ((""Medicine"" OR ""Internal medicine"" OR ""Pharmacology"") AND (""Urology"" OR ""Renal function"" OR ""Kidney disease"" OR ""Kidney"" OR ""Urinary system"" OR ""Urine"" OR ""End stage renal disease"" OR ""Acute kidney injury""))",AND date_published>=now-10y,"AND field_of_study: ((""Medicine"" OR ""Internal medicine"" OR ""Pharmacology"") AND (""Urology"" OR ""Renal function"" OR ""Kidney disease"" OR ""Kidney"" OR ""Urinary system"" OR ""Urine"" OR ""End stage renal disease"" OR ""Acute kidney injury""))",NA,oa_therapy_area,Pharma,Genitourinary disorders,2020,568,159,50,165,55,1,430,138
genitourinary disorders (including nephrology)  (primary search + genitourinary tags) - pharma,"(author.affiliation.name:(""pfizer"" OR ""astrazeneca"" OR ""eli lilly"" OR ""merck"" OR ""emd serono"" OR ""msd"" OR ""merck sharp & dohme"" OR ""bristol myers squibb"" OR ""novartis"" OR ""roche"" OR ""hoffmann-la roche"" OR ""genentech"" OR ""johnson & johnson"" OR ""janssen"" OR ""biosense webster"" OR ""glaxosmithkline"" OR ""gsk"" OR ""abbvie"" OR ""sanofi"" OR ""sanofi-aventis"" OR ""gilead sciences"" OR ""takeda"" OR ""boehringer ingelheim"" OR ""myokardia"" OR ""amgen"" OR ""applied molecular genetics"" OR ""bayer"" OR ""vertex pharmaceuticals"" OR ""regeneron"" OR ""novo nordisk"" OR ""biogen"" OR ""biogen idec"" OR ""daiichi sankyo"" OR ""astellas pharma"" OR ""asuterasu seiyaku kabushiki-gaisha"" OR ""otsuka"" OR ""otsuka seiyaku kabushiki-gaisha"" OR ""astex pharmaceuticals"" OR ""ucb"" OR ""union chimique belge"" OR ""moderna"" OR ""eisai"" OR ""ezai kabushiki-gaisha"" OR ""ea pharma"" OR ""csl"" OR ""zlb behring"" OR ""jiangsu hengrui medicine"" OR ""teva pharmaceuticals"" OR ""sumitomo dainippon pharma"" OR ""dainippon sumitomo seiyaku kabushiki-gaisha"" OR ""fresenius"" OR ""fresenius se & co. kgaa"" OR ""viatris"" OR ""kyowa kirin"" OR ""kyowa hakko kirin"" OR ""ipsen"" OR ""jazz pharmaceuticals"" OR ""azur pharma"" OR ""sino biopharm"" OR ""bausch health companies"" OR ""valeant pharmaceuticals"" OR ""cspc pharmaceutical group"" OR ""galapagos"" OR ""galapagos genomics"" NOT ""La Roche College"") OR author.affiliation.ror_id_lineage:(""01xdqrp08"" OR ""00by1q217"" OR ""04b2dty93"" OR ""02891sr49"" OR ""03qd7mz70"" OR ""00gtmwv55"" OR ""02f9zrr09"" OR ""04r9x1a08"" OR ""01qat3289"" OR ""01xsqw823"" OR ""02g5p4n58"" OR ""02n6c9837"" OR ""056546b03"" OR ""04hjbmv12"" OR ""00q32j219"" OR ""03g03ge92"" OR ""04hmn8g73"" OR ""00anb1726"" OR ""02f51rf24"" OR ""0435rc536"" OR ""02jqkb192"" OR ""027y26122"" OR ""01cjash87"" OR ""013k5y296"" OR ""01n029866"" OR ""01xm4wg91"" OR ""04vvh7p27"" OR ""044tc0x05"" OR ""04ayvvz32"" OR ""01wfv3m53"" OR ""04sapgw72"" OR ""01v376g59"" OR ""01g1gvr46"" OR ""000wej815"" OR ""00d801g55"" OR ""055mhsv54"" OR ""0086q4c12"" OR ""01zgpn844"" OR ""016mq8947"" OR ""04e4j5d46"")) AND publication_type:""journal article"" AND date_published>=now-10y AND field_of_study: ((""Medicine"" OR ""Internal medicine"" OR ""Pharmacology"") AND (""Urology"" OR ""Renal function"" OR ""Kidney disease"" OR ""Kidney"" OR ""Urinary system"" OR ""Urine"" OR ""End stage renal disease"" OR ""Acute kidney injury""))",AND date_published>=now-10y,"AND field_of_study: ((""Medicine"" OR ""Internal medicine"" OR ""Pharmacology"") AND (""Urology"" OR ""Renal function"" OR ""Kidney disease"" OR ""Kidney"" OR ""Urinary system"" OR ""Urine"" OR ""End stage renal disease"" OR ""Acute kidney injury""))",NA,oa_therapy_area,Pharma,Genitourinary disorders,2021,620,205,43,180,44,14,486,134
genitourinary disorders (including nephrology)  (primary search + genitourinary tags) - pharma,"(author.affiliation.name:(""pfizer"" OR ""astrazeneca"" OR ""eli lilly"" OR ""merck"" OR ""emd serono"" OR ""msd"" OR ""merck sharp & dohme"" OR ""bristol myers squibb"" OR ""novartis"" OR ""roche"" OR ""hoffmann-la roche"" OR ""genentech"" OR ""johnson & johnson"" OR ""janssen"" OR ""biosense webster"" OR ""glaxosmithkline"" OR ""gsk"" OR ""abbvie"" OR ""sanofi"" OR ""sanofi-aventis"" OR ""gilead sciences"" OR ""takeda"" OR ""boehringer ingelheim"" OR ""myokardia"" OR ""amgen"" OR ""applied molecular genetics"" OR ""bayer"" OR ""vertex pharmaceuticals"" OR ""regeneron"" OR ""novo nordisk"" OR ""biogen"" OR ""biogen idec"" OR ""daiichi sankyo"" OR ""astellas pharma"" OR ""asuterasu seiyaku kabushiki-gaisha"" OR ""otsuka"" OR ""otsuka seiyaku kabushiki-gaisha"" OR ""astex pharmaceuticals"" OR ""ucb"" OR ""union chimique belge"" OR ""moderna"" OR ""eisai"" OR ""ezai kabushiki-gaisha"" OR ""ea pharma"" OR ""csl"" OR ""zlb behring"" OR ""jiangsu hengrui medicine"" OR ""teva pharmaceuticals"" OR ""sumitomo dainippon pharma"" OR ""dainippon sumitomo seiyaku kabushiki-gaisha"" OR ""fresenius"" OR ""fresenius se & co. kgaa"" OR ""viatris"" OR ""kyowa kirin"" OR ""kyowa hakko kirin"" OR ""ipsen"" OR ""jazz pharmaceuticals"" OR ""azur pharma"" OR ""sino biopharm"" OR ""bausch health companies"" OR ""valeant pharmaceuticals"" OR ""cspc pharmaceutical group"" OR ""galapagos"" OR ""galapagos genomics"" NOT ""La Roche College"") OR author.affiliation.ror_id_lineage:(""01xdqrp08"" OR ""00by1q217"" OR ""04b2dty93"" OR ""02891sr49"" OR ""03qd7mz70"" OR ""00gtmwv55"" OR ""02f9zrr09"" OR ""04r9x1a08"" OR ""01qat3289"" OR ""01xsqw823"" OR ""02g5p4n58"" OR ""02n6c9837"" OR ""056546b03"" OR ""04hjbmv12"" OR ""00q32j219"" OR ""03g03ge92"" OR ""04hmn8g73"" OR ""00anb1726"" OR ""02f51rf24"" OR ""0435rc536"" OR ""02jqkb192"" OR ""027y26122"" OR ""01cjash87"" OR ""013k5y296"" OR ""01n029866"" OR ""01xm4wg91"" OR ""04vvh7p27"" OR ""044tc0x05"" OR ""04ayvvz32"" OR ""01wfv3m53"" OR ""04sapgw72"" OR ""01v376g59"" OR ""01g1gvr46"" OR ""000wej815"" OR ""00d801g55"" OR ""055mhsv54"" OR ""0086q4c12"" OR ""01zgpn844"" OR ""016mq8947"" OR ""04e4j5d46"")) AND publication_type:""journal article"" AND date_published>=now-10y AND field_of_study: ((""Medicine"" OR ""Internal medicine"" OR ""Pharmacology"") AND (""Urology"" OR ""Renal function"" OR ""Kidney disease"" OR ""Kidney"" OR ""Urinary system"" OR ""Urine"" OR ""End stage renal disease"" OR ""Acute kidney injury""))",AND date_published>=now-10y,"AND field_of_study: ((""Medicine"" OR ""Internal medicine"" OR ""Pharmacology"") AND (""Urology"" OR ""Renal function"" OR ""Kidney disease"" OR ""Kidney"" OR ""Urinary system"" OR ""Urine"" OR ""End stage renal disease"" OR ""Acute kidney injury""))",NA,oa_therapy_area,Pharma,Genitourinary disorders,2022,674,217,57,154,41,13,482,192
genitourinary disorders (including nephrology)  (primary search + genitourinary tags) - pharma,"(author.affiliation.name:(""pfizer"" OR ""astrazeneca"" OR ""eli lilly"" OR ""merck"" OR ""emd serono"" OR ""msd"" OR ""merck sharp & dohme"" OR ""bristol myers squibb"" OR ""novartis"" OR ""roche"" OR ""hoffmann-la roche"" OR ""genentech"" OR ""johnson & johnson"" OR ""janssen"" OR ""biosense webster"" OR ""glaxosmithkline"" OR ""gsk"" OR ""abbvie"" OR ""sanofi"" OR ""sanofi-aventis"" OR ""gilead sciences"" OR ""takeda"" OR ""boehringer ingelheim"" OR ""myokardia"" OR ""amgen"" OR ""applied molecular genetics"" OR ""bayer"" OR ""vertex pharmaceuticals"" OR ""regeneron"" OR ""novo nordisk"" OR ""biogen"" OR ""biogen idec"" OR ""daiichi sankyo"" OR ""astellas pharma"" OR ""asuterasu seiyaku kabushiki-gaisha"" OR ""otsuka"" OR ""otsuka seiyaku kabushiki-gaisha"" OR ""astex pharmaceuticals"" OR ""ucb"" OR ""union chimique belge"" OR ""moderna"" OR ""eisai"" OR ""ezai kabushiki-gaisha"" OR ""ea pharma"" OR ""csl"" OR ""zlb behring"" OR ""jiangsu hengrui medicine"" OR ""teva pharmaceuticals"" OR ""sumitomo dainippon pharma"" OR ""dainippon sumitomo seiyaku kabushiki-gaisha"" OR ""fresenius"" OR ""fresenius se & co. kgaa"" OR ""viatris"" OR ""kyowa kirin"" OR ""kyowa hakko kirin"" OR ""ipsen"" OR ""jazz pharmaceuticals"" OR ""azur pharma"" OR ""sino biopharm"" OR ""bausch health companies"" OR ""valeant pharmaceuticals"" OR ""cspc pharmaceutical group"" OR ""galapagos"" OR ""galapagos genomics"" NOT ""La Roche College"") OR author.affiliation.ror_id_lineage:(""01xdqrp08"" OR ""00by1q217"" OR ""04b2dty93"" OR ""02891sr49"" OR ""03qd7mz70"" OR ""00gtmwv55"" OR ""02f9zrr09"" OR ""04r9x1a08"" OR ""01qat3289"" OR ""01xsqw823"" OR ""02g5p4n58"" OR ""02n6c9837"" OR ""056546b03"" OR ""04hjbmv12"" OR ""00q32j219"" OR ""03g03ge92"" OR ""04hmn8g73"" OR ""00anb1726"" OR ""02f51rf24"" OR ""0435rc536"" OR ""02jqkb192"" OR ""027y26122"" OR ""01cjash87"" OR ""013k5y296"" OR ""01n029866"" OR ""01xm4wg91"" OR ""04vvh7p27"" OR ""044tc0x05"" OR ""04ayvvz32"" OR ""01wfv3m53"" OR ""04sapgw72"" OR ""01v376g59"" OR ""01g1gvr46"" OR ""000wej815"" OR ""00d801g55"" OR ""055mhsv54"" OR ""0086q4c12"" OR ""01zgpn844"" OR ""016mq8947"" OR ""04e4j5d46"")) AND publication_type:""journal article"" AND date_published>=now-10y AND field_of_study: ((""Medicine"" OR ""Internal medicine"" OR ""Pharmacology"") AND (""Urology"" OR ""Renal function"" OR ""Kidney disease"" OR ""Kidney"" OR ""Urinary system"" OR ""Urine"" OR ""End stage renal disease"" OR ""Acute kidney injury""))",AND date_published>=now-10y,"AND field_of_study: ((""Medicine"" OR ""Internal medicine"" OR ""Pharmacology"") AND (""Urology"" OR ""Renal function"" OR ""Kidney disease"" OR ""Kidney"" OR ""Urinary system"" OR ""Urine"" OR ""End stage renal disease"" OR ""Acute kidney injury""))",NA,oa_therapy_area,Pharma,Genitourinary disorders,2023,309,100,7,61,6,31,205,104
oncology (primary search + oncology tags) - uni,"(author.affiliation.name:(""university of cape town"" OR ""south african college"" OR ""shanghai jiao tong university"" OR ""shanghai communications university"" OR ""fudan university"" OR ""sun yat-sen university"" OR ""zhejiang university"" OR ""chekiang university"" OR ""peking university"" OR ""imperial university of peking"" OR ""capital medical university"" OR ""cmu"" OR ""seoul national university"" OR ""seoul daehakgyo"" OR ""peking union medical college"" OR ""beijing xiehe hospital"" OR ""sichuan university"" OR ""sìchuān dàxué"" OR ""nanjing medical university"" OR ""national jiangsu medical college"" OR ""huazhong university of science and technology"" OR ""huázhōng kējì dàxué"" OR ""university college london"" OR ""london university"" OR ""karolinska institutet"" OR ""royal caroline institute"" OR ""university of oxford"" OR ""oxford university"" OR ""university of copenhagen"" OR ""universität kopenhagen"" OR ""université de paris"" OR ""university of paris"" OR ""king's college london"" OR ""kcl"" OR ""university of amsterdam"" OR ""universiteit van amsterdam"" OR ""imperial college london"" OR ""coleg imperial llundain"" OR ""utrecht university"" OR ""universiteit utrecht"" OR ""heidelberg university"" OR ""ruprecht-karls-universität heidelberg"" OR ""university of milan"" OR ""université de milan"" OR ""erasmus university rotterdam"" OR ""erasmus universiteit rotterdam"" OR ""freie universität berlin"" OR ""free university of berlin"" OR ""university of cambridge"" OR ""cambridge university"" OR ""humboldt-universität zu berlin"" OR ""humboldt university of berlin"" OR ""university of zurich"" OR ""universität zürich"" OR ""tel aviv university"" OR ""harvard university"" OR ""universidad de harvard"" OR ""johns hopkins university"" OR ""jhu"" OR ""university of toronto"" OR ""université de toronto"" OR ""university of pennsylvania"" Or ""upenn"" OR ""university of california, san francisco"" OR ""ucsf"" OR ""duke university"" OR ""Universidad de Duke"" OR ""university of michigan"" OR ""umich"" OR ""stanford university"" OR ""leland stanford junior university"" OR ""university of melbourne"" OR ""melbourne university"" OR ""university of sydney"" OR ""sydney university"" OR ""university of são paulo"" OR ""universidade de são paulo"") OR author.affiliation.ror_id_lineage:(""03p74gp79"" OR ""0220qvk04"" OR ""013q1eq08"" OR ""0064kty71"" OR ""00a2xv884"" OR ""02v51f717"" OR ""013xs5b60"" OR ""04h9pn542"" OR ""04jztag35"" OR ""011ashp19"" OR ""059gcgy73"" OR ""00p991c53"" OR ""02jx3x895"" OR ""056d84691"" OR ""052gg0110"" OR ""035b05819"" OR ""05f82e368"" OR ""0220mzb33"" OR ""04dkp9463"" OR ""041kmwe10"" OR ""04pp8hn57"" OR ""038t36y30"" OR ""00wjc7c48"" OR ""057w15z03"" OR ""046ak2485"" OR ""013meh722"" OR ""01hcx6992"" OR ""02crff812"" OR ""04mhzgx49"" OR ""03vek6s52"" OR ""00za53h95"" OR ""03dbr7087"" OR ""00b30xv10"" OR ""043mz5j54"" OR ""00py81415"" OR ""00jmfr291"" OR ""00f54p054"" OR ""01ej9dk98"" OR ""0384j8v12"" OR ""036rp1748"")) AND publication_type:""journal article"" AND date_published>=now-10y AND field_of_study: ((""Medicine"" OR ""Internal medicine"" OR ""Pharmacology"") AND (""Oncology"" OR ""Cancer"" OR ""Cancer research"" OR ""Chemotherapy"" OR ""Breast cancer"" OR ""Lung cancer"" OR ""Prostate cancer"" OR ""Pembrolizumab"" OR ""Multiple myeloma"" OR ""Colorectal cancer"" OR ""Neutropenia"" OR ""Metastatic breast cancer"" OR ""Lymphoma"" OR ""Myeloid leukemia"" OR ""Melanoma"" OR ""Renal cell carcinoma"" OR ""Leukemia"" OR ""Chronic lymphocytic leukemia"" OR ""Hepatocellular carcinoma"" OR ""Febrile neutropenia"" OR ""Carcinoma"" OR ""Ovarian cancer"" OR ""Response Evaluation Criteria in Solid Tumors"" OR ""Adenocarcinoma"" OR ""Follicular lymphoma"" OR ""Diffuse large B-cell lymphoma"" OR ""Cancer cell"" OR ""non-small cell lung cancer (NSCLC)"" OR ""Triple-negative breast cancer"" OR ""Pancreatic cancer"" OR ""Cancer immunotherapy"" OR ""Bladder cancer"" OR ""Cervical cancer"" OR ""Head and neck squamous-cell carcinoma"" OR ""Metastatic Urothelial Carcinoma"" OR ""Surgical oncology"" OR ""Head and neck cancer"" OR ""Carcinogenesis""))",AND date_published>=now-10y,"AND field_of_study: ((""Medicine"" OR ""Internal medicine"" OR ""Pharmacology"") AND (""Oncology"" OR ""Cancer"" OR ""Cancer research"" OR ""Chemotherapy"" OR ""Breast cancer"" OR ""Lung cancer"" OR ""Prostate cancer"" OR ""Pembrolizumab"" OR ""Multiple myeloma"" OR ""Colorectal cancer"" OR ""Neutropenia"" OR ""Metastatic breast cancer"" OR ""Lymphoma"" OR ""Myeloid leukemia"" OR ""Melanoma"" OR ""Renal cell carcinoma"" OR ""Leukemia"" OR ""Chronic lymphocytic leukemia"" OR ""Hepatocellular carcinoma"" OR ""Febrile neutropenia"" OR ""Carcinoma"" OR ""Ovarian cancer"" OR ""Response Evaluation Criteria in Solid Tumors"" OR ""Adenocarcinoma"" OR ""Follicular lymphoma"" OR ""Diffuse large B-cell lymphoma"" OR ""Cancer cell"" OR ""non-small cell lung cancer (NSCLC)"" OR ""Triple-negative breast cancer"" OR ""Pancreatic cancer"" OR ""Cancer immunotherapy"" OR ""Bladder cancer"" OR ""Cervical cancer"" OR ""Head and neck squamous-cell carcinoma"" OR ""Metastatic Urothelial Carcinoma"" OR ""Surgical oncology"" OR ""Head and neck cancer"" OR ""Carcinogenesis""))",NA,oa_therapy_area,Uni,Oncology,2013,5321,1052,919,253,362,70,2656,2665
oncology (primary search + oncology tags) - uni,"(author.affiliation.name:(""university of cape town"" OR ""south african college"" OR ""shanghai jiao tong university"" OR ""shanghai communications university"" OR ""fudan university"" OR ""sun yat-sen university"" OR ""zhejiang university"" OR ""chekiang university"" OR ""peking university"" OR ""imperial university of peking"" OR ""capital medical university"" OR ""cmu"" OR ""seoul national university"" OR ""seoul daehakgyo"" OR ""peking union medical college"" OR ""beijing xiehe hospital"" OR ""sichuan university"" OR ""sìchuān dàxué"" OR ""nanjing medical university"" OR ""national jiangsu medical college"" OR ""huazhong university of science and technology"" OR ""huázhōng kējì dàxué"" OR ""university college london"" OR ""london university"" OR ""karolinska institutet"" OR ""royal caroline institute"" OR ""university of oxford"" OR ""oxford university"" OR ""university of copenhagen"" OR ""universität kopenhagen"" OR ""université de paris"" OR ""university of paris"" OR ""king's college london"" OR ""kcl"" OR ""university of amsterdam"" OR ""universiteit van amsterdam"" OR ""imperial college london"" OR ""coleg imperial llundain"" OR ""utrecht university"" OR ""universiteit utrecht"" OR ""heidelberg university"" OR ""ruprecht-karls-universität heidelberg"" OR ""university of milan"" OR ""université de milan"" OR ""erasmus university rotterdam"" OR ""erasmus universiteit rotterdam"" OR ""freie universität berlin"" OR ""free university of berlin"" OR ""university of cambridge"" OR ""cambridge university"" OR ""humboldt-universität zu berlin"" OR ""humboldt university of berlin"" OR ""university of zurich"" OR ""universität zürich"" OR ""tel aviv university"" OR ""harvard university"" OR ""universidad de harvard"" OR ""johns hopkins university"" OR ""jhu"" OR ""university of toronto"" OR ""université de toronto"" OR ""university of pennsylvania"" Or ""upenn"" OR ""university of california, san francisco"" OR ""ucsf"" OR ""duke university"" OR ""Universidad de Duke"" OR ""university of michigan"" OR ""umich"" OR ""stanford university"" OR ""leland stanford junior university"" OR ""university of melbourne"" OR ""melbourne university"" OR ""university of sydney"" OR ""sydney university"" OR ""university of são paulo"" OR ""universidade de são paulo"") OR author.affiliation.ror_id_lineage:(""03p74gp79"" OR ""0220qvk04"" OR ""013q1eq08"" OR ""0064kty71"" OR ""00a2xv884"" OR ""02v51f717"" OR ""013xs5b60"" OR ""04h9pn542"" OR ""04jztag35"" OR ""011ashp19"" OR ""059gcgy73"" OR ""00p991c53"" OR ""02jx3x895"" OR ""056d84691"" OR ""052gg0110"" OR ""035b05819"" OR ""05f82e368"" OR ""0220mzb33"" OR ""04dkp9463"" OR ""041kmwe10"" OR ""04pp8hn57"" OR ""038t36y30"" OR ""00wjc7c48"" OR ""057w15z03"" OR ""046ak2485"" OR ""013meh722"" OR ""01hcx6992"" OR ""02crff812"" OR ""04mhzgx49"" OR ""03vek6s52"" OR ""00za53h95"" OR ""03dbr7087"" OR ""00b30xv10"" OR ""043mz5j54"" OR ""00py81415"" OR ""00jmfr291"" OR ""00f54p054"" OR ""01ej9dk98"" OR ""0384j8v12"" OR ""036rp1748"")) AND publication_type:""journal article"" AND date_published>=now-10y AND field_of_study: ((""Medicine"" OR ""Internal medicine"" OR ""Pharmacology"") AND (""Oncology"" OR ""Cancer"" OR ""Cancer research"" OR ""Chemotherapy"" OR ""Breast cancer"" OR ""Lung cancer"" OR ""Prostate cancer"" OR ""Pembrolizumab"" OR ""Multiple myeloma"" OR ""Colorectal cancer"" OR ""Neutropenia"" OR ""Metastatic breast cancer"" OR ""Lymphoma"" OR ""Myeloid leukemia"" OR ""Melanoma"" OR ""Renal cell carcinoma"" OR ""Leukemia"" OR ""Chronic lymphocytic leukemia"" OR ""Hepatocellular carcinoma"" OR ""Febrile neutropenia"" OR ""Carcinoma"" OR ""Ovarian cancer"" OR ""Response Evaluation Criteria in Solid Tumors"" OR ""Adenocarcinoma"" OR ""Follicular lymphoma"" OR ""Diffuse large B-cell lymphoma"" OR ""Cancer cell"" OR ""non-small cell lung cancer (NSCLC)"" OR ""Triple-negative breast cancer"" OR ""Pancreatic cancer"" OR ""Cancer immunotherapy"" OR ""Bladder cancer"" OR ""Cervical cancer"" OR ""Head and neck squamous-cell carcinoma"" OR ""Metastatic Urothelial Carcinoma"" OR ""Surgical oncology"" OR ""Head and neck cancer"" OR ""Carcinogenesis""))",AND date_published>=now-10y,"AND field_of_study: ((""Medicine"" OR ""Internal medicine"" OR ""Pharmacology"") AND (""Oncology"" OR ""Cancer"" OR ""Cancer research"" OR ""Chemotherapy"" OR ""Breast cancer"" OR ""Lung cancer"" OR ""Prostate cancer"" OR ""Pembrolizumab"" OR ""Multiple myeloma"" OR ""Colorectal cancer"" OR ""Neutropenia"" OR ""Metastatic breast cancer"" OR ""Lymphoma"" OR ""Myeloid leukemia"" OR ""Melanoma"" OR ""Renal cell carcinoma"" OR ""Leukemia"" OR ""Chronic lymphocytic leukemia"" OR ""Hepatocellular carcinoma"" OR ""Febrile neutropenia"" OR ""Carcinoma"" OR ""Ovarian cancer"" OR ""Response Evaluation Criteria in Solid Tumors"" OR ""Adenocarcinoma"" OR ""Follicular lymphoma"" OR ""Diffuse large B-cell lymphoma"" OR ""Cancer cell"" OR ""non-small cell lung cancer (NSCLC)"" OR ""Triple-negative breast cancer"" OR ""Pancreatic cancer"" OR ""Cancer immunotherapy"" OR ""Bladder cancer"" OR ""Cervical cancer"" OR ""Head and neck squamous-cell carcinoma"" OR ""Metastatic Urothelial Carcinoma"" OR ""Surgical oncology"" OR ""Head and neck cancer"" OR ""Carcinogenesis""))",NA,oa_therapy_area,Uni,Oncology,2014,15596,3325,2582,746,1242,360,8255,7341
oncology (primary search + oncology tags) - uni,"(author.affiliation.name:(""university of cape town"" OR ""south african college"" OR ""shanghai jiao tong university"" OR ""shanghai communications university"" OR ""fudan university"" OR ""sun yat-sen university"" OR ""zhejiang university"" OR ""chekiang university"" OR ""peking university"" OR ""imperial university of peking"" OR ""capital medical university"" OR ""cmu"" OR ""seoul national university"" OR ""seoul daehakgyo"" OR ""peking union medical college"" OR ""beijing xiehe hospital"" OR ""sichuan university"" OR ""sìchuān dàxué"" OR ""nanjing medical university"" OR ""national jiangsu medical college"" OR ""huazhong university of science and technology"" OR ""huázhōng kējì dàxué"" OR ""university college london"" OR ""london university"" OR ""karolinska institutet"" OR ""royal caroline institute"" OR ""university of oxford"" OR ""oxford university"" OR ""university of copenhagen"" OR ""universität kopenhagen"" OR ""université de paris"" OR ""university of paris"" OR ""king's college london"" OR ""kcl"" OR ""university of amsterdam"" OR ""universiteit van amsterdam"" OR ""imperial college london"" OR ""coleg imperial llundain"" OR ""utrecht university"" OR ""universiteit utrecht"" OR ""heidelberg university"" OR ""ruprecht-karls-universität heidelberg"" OR ""university of milan"" OR ""université de milan"" OR ""erasmus university rotterdam"" OR ""erasmus universiteit rotterdam"" OR ""freie universität berlin"" OR ""free university of berlin"" OR ""university of cambridge"" OR ""cambridge university"" OR ""humboldt-universität zu berlin"" OR ""humboldt university of berlin"" OR ""university of zurich"" OR ""universität zürich"" OR ""tel aviv university"" OR ""harvard university"" OR ""universidad de harvard"" OR ""johns hopkins university"" OR ""jhu"" OR ""university of toronto"" OR ""université de toronto"" OR ""university of pennsylvania"" Or ""upenn"" OR ""university of california, san francisco"" OR ""ucsf"" OR ""duke university"" OR ""Universidad de Duke"" OR ""university of michigan"" OR ""umich"" OR ""stanford university"" OR ""leland stanford junior university"" OR ""university of melbourne"" OR ""melbourne university"" OR ""university of sydney"" OR ""sydney university"" OR ""university of são paulo"" OR ""universidade de são paulo"") OR author.affiliation.ror_id_lineage:(""03p74gp79"" OR ""0220qvk04"" OR ""013q1eq08"" OR ""0064kty71"" OR ""00a2xv884"" OR ""02v51f717"" OR ""013xs5b60"" OR ""04h9pn542"" OR ""04jztag35"" OR ""011ashp19"" OR ""059gcgy73"" OR ""00p991c53"" OR ""02jx3x895"" OR ""056d84691"" OR ""052gg0110"" OR ""035b05819"" OR ""05f82e368"" OR ""0220mzb33"" OR ""04dkp9463"" OR ""041kmwe10"" OR ""04pp8hn57"" OR ""038t36y30"" OR ""00wjc7c48"" OR ""057w15z03"" OR ""046ak2485"" OR ""013meh722"" OR ""01hcx6992"" OR ""02crff812"" OR ""04mhzgx49"" OR ""03vek6s52"" OR ""00za53h95"" OR ""03dbr7087"" OR ""00b30xv10"" OR ""043mz5j54"" OR ""00py81415"" OR ""00jmfr291"" OR ""00f54p054"" OR ""01ej9dk98"" OR ""0384j8v12"" OR ""036rp1748"")) AND publication_type:""journal article"" AND date_published>=now-10y AND field_of_study: ((""Medicine"" OR ""Internal medicine"" OR ""Pharmacology"") AND (""Oncology"" OR ""Cancer"" OR ""Cancer research"" OR ""Chemotherapy"" OR ""Breast cancer"" OR ""Lung cancer"" OR ""Prostate cancer"" OR ""Pembrolizumab"" OR ""Multiple myeloma"" OR ""Colorectal cancer"" OR ""Neutropenia"" OR ""Metastatic breast cancer"" OR ""Lymphoma"" OR ""Myeloid leukemia"" OR ""Melanoma"" OR ""Renal cell carcinoma"" OR ""Leukemia"" OR ""Chronic lymphocytic leukemia"" OR ""Hepatocellular carcinoma"" OR ""Febrile neutropenia"" OR ""Carcinoma"" OR ""Ovarian cancer"" OR ""Response Evaluation Criteria in Solid Tumors"" OR ""Adenocarcinoma"" OR ""Follicular lymphoma"" OR ""Diffuse large B-cell lymphoma"" OR ""Cancer cell"" OR ""non-small cell lung cancer (NSCLC)"" OR ""Triple-negative breast cancer"" OR ""Pancreatic cancer"" OR ""Cancer immunotherapy"" OR ""Bladder cancer"" OR ""Cervical cancer"" OR ""Head and neck squamous-cell carcinoma"" OR ""Metastatic Urothelial Carcinoma"" OR ""Surgical oncology"" OR ""Head and neck cancer"" OR ""Carcinogenesis""))",AND date_published>=now-10y,"AND field_of_study: ((""Medicine"" OR ""Internal medicine"" OR ""Pharmacology"") AND (""Oncology"" OR ""Cancer"" OR ""Cancer research"" OR ""Chemotherapy"" OR ""Breast cancer"" OR ""Lung cancer"" OR ""Prostate cancer"" OR ""Pembrolizumab"" OR ""Multiple myeloma"" OR ""Colorectal cancer"" OR ""Neutropenia"" OR ""Metastatic breast cancer"" OR ""Lymphoma"" OR ""Myeloid leukemia"" OR ""Melanoma"" OR ""Renal cell carcinoma"" OR ""Leukemia"" OR ""Chronic lymphocytic leukemia"" OR ""Hepatocellular carcinoma"" OR ""Febrile neutropenia"" OR ""Carcinoma"" OR ""Ovarian cancer"" OR ""Response Evaluation Criteria in Solid Tumors"" OR ""Adenocarcinoma"" OR ""Follicular lymphoma"" OR ""Diffuse large B-cell lymphoma"" OR ""Cancer cell"" OR ""non-small cell lung cancer (NSCLC)"" OR ""Triple-negative breast cancer"" OR ""Pancreatic cancer"" OR ""Cancer immunotherapy"" OR ""Bladder cancer"" OR ""Cervical cancer"" OR ""Head and neck squamous-cell carcinoma"" OR ""Metastatic Urothelial Carcinoma"" OR ""Surgical oncology"" OR ""Head and neck cancer"" OR ""Carcinogenesis""))",NA,oa_therapy_area,Uni,Oncology,2015,17501,4325,2774,806,1292,538,9735,7766
oncology (primary search + oncology tags) - uni,"(author.affiliation.name:(""university of cape town"" OR ""south african college"" OR ""shanghai jiao tong university"" OR ""shanghai communications university"" OR ""fudan university"" OR ""sun yat-sen university"" OR ""zhejiang university"" OR ""chekiang university"" OR ""peking university"" OR ""imperial university of peking"" OR ""capital medical university"" OR ""cmu"" OR ""seoul national university"" OR ""seoul daehakgyo"" OR ""peking union medical college"" OR ""beijing xiehe hospital"" OR ""sichuan university"" OR ""sìchuān dàxué"" OR ""nanjing medical university"" OR ""national jiangsu medical college"" OR ""huazhong university of science and technology"" OR ""huázhōng kējì dàxué"" OR ""university college london"" OR ""london university"" OR ""karolinska institutet"" OR ""royal caroline institute"" OR ""university of oxford"" OR ""oxford university"" OR ""university of copenhagen"" OR ""universität kopenhagen"" OR ""université de paris"" OR ""university of paris"" OR ""king's college london"" OR ""kcl"" OR ""university of amsterdam"" OR ""universiteit van amsterdam"" OR ""imperial college london"" OR ""coleg imperial llundain"" OR ""utrecht university"" OR ""universiteit utrecht"" OR ""heidelberg university"" OR ""ruprecht-karls-universität heidelberg"" OR ""university of milan"" OR ""université de milan"" OR ""erasmus university rotterdam"" OR ""erasmus universiteit rotterdam"" OR ""freie universität berlin"" OR ""free university of berlin"" OR ""university of cambridge"" OR ""cambridge university"" OR ""humboldt-universität zu berlin"" OR ""humboldt university of berlin"" OR ""university of zurich"" OR ""universität zürich"" OR ""tel aviv university"" OR ""harvard university"" OR ""universidad de harvard"" OR ""johns hopkins university"" OR ""jhu"" OR ""university of toronto"" OR ""université de toronto"" OR ""university of pennsylvania"" Or ""upenn"" OR ""university of california, san francisco"" OR ""ucsf"" OR ""duke university"" OR ""Universidad de Duke"" OR ""university of michigan"" OR ""umich"" OR ""stanford university"" OR ""leland stanford junior university"" OR ""university of melbourne"" OR ""melbourne university"" OR ""university of sydney"" OR ""sydney university"" OR ""university of são paulo"" OR ""universidade de são paulo"") OR author.affiliation.ror_id_lineage:(""03p74gp79"" OR ""0220qvk04"" OR ""013q1eq08"" OR ""0064kty71"" OR ""00a2xv884"" OR ""02v51f717"" OR ""013xs5b60"" OR ""04h9pn542"" OR ""04jztag35"" OR ""011ashp19"" OR ""059gcgy73"" OR ""00p991c53"" OR ""02jx3x895"" OR ""056d84691"" OR ""052gg0110"" OR ""035b05819"" OR ""05f82e368"" OR ""0220mzb33"" OR ""04dkp9463"" OR ""041kmwe10"" OR ""04pp8hn57"" OR ""038t36y30"" OR ""00wjc7c48"" OR ""057w15z03"" OR ""046ak2485"" OR ""013meh722"" OR ""01hcx6992"" OR ""02crff812"" OR ""04mhzgx49"" OR ""03vek6s52"" OR ""00za53h95"" OR ""03dbr7087"" OR ""00b30xv10"" OR ""043mz5j54"" OR ""00py81415"" OR ""00jmfr291"" OR ""00f54p054"" OR ""01ej9dk98"" OR ""0384j8v12"" OR ""036rp1748"")) AND publication_type:""journal article"" AND date_published>=now-10y AND field_of_study: ((""Medicine"" OR ""Internal medicine"" OR ""Pharmacology"") AND (""Oncology"" OR ""Cancer"" OR ""Cancer research"" OR ""Chemotherapy"" OR ""Breast cancer"" OR ""Lung cancer"" OR ""Prostate cancer"" OR ""Pembrolizumab"" OR ""Multiple myeloma"" OR ""Colorectal cancer"" OR ""Neutropenia"" OR ""Metastatic breast cancer"" OR ""Lymphoma"" OR ""Myeloid leukemia"" OR ""Melanoma"" OR ""Renal cell carcinoma"" OR ""Leukemia"" OR ""Chronic lymphocytic leukemia"" OR ""Hepatocellular carcinoma"" OR ""Febrile neutropenia"" OR ""Carcinoma"" OR ""Ovarian cancer"" OR ""Response Evaluation Criteria in Solid Tumors"" OR ""Adenocarcinoma"" OR ""Follicular lymphoma"" OR ""Diffuse large B-cell lymphoma"" OR ""Cancer cell"" OR ""non-small cell lung cancer (NSCLC)"" OR ""Triple-negative breast cancer"" OR ""Pancreatic cancer"" OR ""Cancer immunotherapy"" OR ""Bladder cancer"" OR ""Cervical cancer"" OR ""Head and neck squamous-cell carcinoma"" OR ""Metastatic Urothelial Carcinoma"" OR ""Surgical oncology"" OR ""Head and neck cancer"" OR ""Carcinogenesis""))",AND date_published>=now-10y,"AND field_of_study: ((""Medicine"" OR ""Internal medicine"" OR ""Pharmacology"") AND (""Oncology"" OR ""Cancer"" OR ""Cancer research"" OR ""Chemotherapy"" OR ""Breast cancer"" OR ""Lung cancer"" OR ""Prostate cancer"" OR ""Pembrolizumab"" OR ""Multiple myeloma"" OR ""Colorectal cancer"" OR ""Neutropenia"" OR ""Metastatic breast cancer"" OR ""Lymphoma"" OR ""Myeloid leukemia"" OR ""Melanoma"" OR ""Renal cell carcinoma"" OR ""Leukemia"" OR ""Chronic lymphocytic leukemia"" OR ""Hepatocellular carcinoma"" OR ""Febrile neutropenia"" OR ""Carcinoma"" OR ""Ovarian cancer"" OR ""Response Evaluation Criteria in Solid Tumors"" OR ""Adenocarcinoma"" OR ""Follicular lymphoma"" OR ""Diffuse large B-cell lymphoma"" OR ""Cancer cell"" OR ""non-small cell lung cancer (NSCLC)"" OR ""Triple-negative breast cancer"" OR ""Pancreatic cancer"" OR ""Cancer immunotherapy"" OR ""Bladder cancer"" OR ""Cervical cancer"" OR ""Head and neck squamous-cell carcinoma"" OR ""Metastatic Urothelial Carcinoma"" OR ""Surgical oncology"" OR ""Head and neck cancer"" OR ""Carcinogenesis""))",NA,oa_therapy_area,Uni,Oncology,2016,19501,5520,3069,910,1502,263,11264,8237
oncology (primary search + oncology tags) - uni,"(author.affiliation.name:(""university of cape town"" OR ""south african college"" OR ""shanghai jiao tong university"" OR ""shanghai communications university"" OR ""fudan university"" OR ""sun yat-sen university"" OR ""zhejiang university"" OR ""chekiang university"" OR ""peking university"" OR ""imperial university of peking"" OR ""capital medical university"" OR ""cmu"" OR ""seoul national university"" OR ""seoul daehakgyo"" OR ""peking union medical college"" OR ""beijing xiehe hospital"" OR ""sichuan university"" OR ""sìchuān dàxué"" OR ""nanjing medical university"" OR ""national jiangsu medical college"" OR ""huazhong university of science and technology"" OR ""huázhōng kējì dàxué"" OR ""university college london"" OR ""london university"" OR ""karolinska institutet"" OR ""royal caroline institute"" OR ""university of oxford"" OR ""oxford university"" OR ""university of copenhagen"" OR ""universität kopenhagen"" OR ""université de paris"" OR ""university of paris"" OR ""king's college london"" OR ""kcl"" OR ""university of amsterdam"" OR ""universiteit van amsterdam"" OR ""imperial college london"" OR ""coleg imperial llundain"" OR ""utrecht university"" OR ""universiteit utrecht"" OR ""heidelberg university"" OR ""ruprecht-karls-universität heidelberg"" OR ""university of milan"" OR ""université de milan"" OR ""erasmus university rotterdam"" OR ""erasmus universiteit rotterdam"" OR ""freie universität berlin"" OR ""free university of berlin"" OR ""university of cambridge"" OR ""cambridge university"" OR ""humboldt-universität zu berlin"" OR ""humboldt university of berlin"" OR ""university of zurich"" OR ""universität zürich"" OR ""tel aviv university"" OR ""harvard university"" OR ""universidad de harvard"" OR ""johns hopkins university"" OR ""jhu"" OR ""university of toronto"" OR ""université de toronto"" OR ""university of pennsylvania"" Or ""upenn"" OR ""university of california, san francisco"" OR ""ucsf"" OR ""duke university"" OR ""Universidad de Duke"" OR ""university of michigan"" OR ""umich"" OR ""stanford university"" OR ""leland stanford junior university"" OR ""university of melbourne"" OR ""melbourne university"" OR ""university of sydney"" OR ""sydney university"" OR ""university of são paulo"" OR ""universidade de são paulo"") OR author.affiliation.ror_id_lineage:(""03p74gp79"" OR ""0220qvk04"" OR ""013q1eq08"" OR ""0064kty71"" OR ""00a2xv884"" OR ""02v51f717"" OR ""013xs5b60"" OR ""04h9pn542"" OR ""04jztag35"" OR ""011ashp19"" OR ""059gcgy73"" OR ""00p991c53"" OR ""02jx3x895"" OR ""056d84691"" OR ""052gg0110"" OR ""035b05819"" OR ""05f82e368"" OR ""0220mzb33"" OR ""04dkp9463"" OR ""041kmwe10"" OR ""04pp8hn57"" OR ""038t36y30"" OR ""00wjc7c48"" OR ""057w15z03"" OR ""046ak2485"" OR ""013meh722"" OR ""01hcx6992"" OR ""02crff812"" OR ""04mhzgx49"" OR ""03vek6s52"" OR ""00za53h95"" OR ""03dbr7087"" OR ""00b30xv10"" OR ""043mz5j54"" OR ""00py81415"" OR ""00jmfr291"" OR ""00f54p054"" OR ""01ej9dk98"" OR ""0384j8v12"" OR ""036rp1748"")) AND publication_type:""journal article"" AND date_published>=now-10y AND field_of_study: ((""Medicine"" OR ""Internal medicine"" OR ""Pharmacology"") AND (""Oncology"" OR ""Cancer"" OR ""Cancer research"" OR ""Chemotherapy"" OR ""Breast cancer"" OR ""Lung cancer"" OR ""Prostate cancer"" OR ""Pembrolizumab"" OR ""Multiple myeloma"" OR ""Colorectal cancer"" OR ""Neutropenia"" OR ""Metastatic breast cancer"" OR ""Lymphoma"" OR ""Myeloid leukemia"" OR ""Melanoma"" OR ""Renal cell carcinoma"" OR ""Leukemia"" OR ""Chronic lymphocytic leukemia"" OR ""Hepatocellular carcinoma"" OR ""Febrile neutropenia"" OR ""Carcinoma"" OR ""Ovarian cancer"" OR ""Response Evaluation Criteria in Solid Tumors"" OR ""Adenocarcinoma"" OR ""Follicular lymphoma"" OR ""Diffuse large B-cell lymphoma"" OR ""Cancer cell"" OR ""non-small cell lung cancer (NSCLC)"" OR ""Triple-negative breast cancer"" OR ""Pancreatic cancer"" OR ""Cancer immunotherapy"" OR ""Bladder cancer"" OR ""Cervical cancer"" OR ""Head and neck squamous-cell carcinoma"" OR ""Metastatic Urothelial Carcinoma"" OR ""Surgical oncology"" OR ""Head and neck cancer"" OR ""Carcinogenesis""))",AND date_published>=now-10y,"AND field_of_study: ((""Medicine"" OR ""Internal medicine"" OR ""Pharmacology"") AND (""Oncology"" OR ""Cancer"" OR ""Cancer research"" OR ""Chemotherapy"" OR ""Breast cancer"" OR ""Lung cancer"" OR ""Prostate cancer"" OR ""Pembrolizumab"" OR ""Multiple myeloma"" OR ""Colorectal cancer"" OR ""Neutropenia"" OR ""Metastatic breast cancer"" OR ""Lymphoma"" OR ""Myeloid leukemia"" OR ""Melanoma"" OR ""Renal cell carcinoma"" OR ""Leukemia"" OR ""Chronic lymphocytic leukemia"" OR ""Hepatocellular carcinoma"" OR ""Febrile neutropenia"" OR ""Carcinoma"" OR ""Ovarian cancer"" OR ""Response Evaluation Criteria in Solid Tumors"" OR ""Adenocarcinoma"" OR ""Follicular lymphoma"" OR ""Diffuse large B-cell lymphoma"" OR ""Cancer cell"" OR ""non-small cell lung cancer (NSCLC)"" OR ""Triple-negative breast cancer"" OR ""Pancreatic cancer"" OR ""Cancer immunotherapy"" OR ""Bladder cancer"" OR ""Cervical cancer"" OR ""Head and neck squamous-cell carcinoma"" OR ""Metastatic Urothelial Carcinoma"" OR ""Surgical oncology"" OR ""Head and neck cancer"" OR ""Carcinogenesis""))",NA,oa_therapy_area,Uni,Oncology,2017,20937,6090,3498,1082,1422,363,12455,8482
oncology (primary search + oncology tags) - uni,"(author.affiliation.name:(""university of cape town"" OR ""south african college"" OR ""shanghai jiao tong university"" OR ""shanghai communications university"" OR ""fudan university"" OR ""sun yat-sen university"" OR ""zhejiang university"" OR ""chekiang university"" OR ""peking university"" OR ""imperial university of peking"" OR ""capital medical university"" OR ""cmu"" OR ""seoul national university"" OR ""seoul daehakgyo"" OR ""peking union medical college"" OR ""beijing xiehe hospital"" OR ""sichuan university"" OR ""sìchuān dàxué"" OR ""nanjing medical university"" OR ""national jiangsu medical college"" OR ""huazhong university of science and technology"" OR ""huázhōng kējì dàxué"" OR ""university college london"" OR ""london university"" OR ""karolinska institutet"" OR ""royal caroline institute"" OR ""university of oxford"" OR ""oxford university"" OR ""university of copenhagen"" OR ""universität kopenhagen"" OR ""université de paris"" OR ""university of paris"" OR ""king's college london"" OR ""kcl"" OR ""university of amsterdam"" OR ""universiteit van amsterdam"" OR ""imperial college london"" OR ""coleg imperial llundain"" OR ""utrecht university"" OR ""universiteit utrecht"" OR ""heidelberg university"" OR ""ruprecht-karls-universität heidelberg"" OR ""university of milan"" OR ""université de milan"" OR ""erasmus university rotterdam"" OR ""erasmus universiteit rotterdam"" OR ""freie universität berlin"" OR ""free university of berlin"" OR ""university of cambridge"" OR ""cambridge university"" OR ""humboldt-universität zu berlin"" OR ""humboldt university of berlin"" OR ""university of zurich"" OR ""universität zürich"" OR ""tel aviv university"" OR ""harvard university"" OR ""universidad de harvard"" OR ""johns hopkins university"" OR ""jhu"" OR ""university of toronto"" OR ""université de toronto"" OR ""university of pennsylvania"" Or ""upenn"" OR ""university of california, san francisco"" OR ""ucsf"" OR ""duke university"" OR ""Universidad de Duke"" OR ""university of michigan"" OR ""umich"" OR ""stanford university"" OR ""leland stanford junior university"" OR ""university of melbourne"" OR ""melbourne university"" OR ""university of sydney"" OR ""sydney university"" OR ""university of são paulo"" OR ""universidade de são paulo"") OR author.affiliation.ror_id_lineage:(""03p74gp79"" OR ""0220qvk04"" OR ""013q1eq08"" OR ""0064kty71"" OR ""00a2xv884"" OR ""02v51f717"" OR ""013xs5b60"" OR ""04h9pn542"" OR ""04jztag35"" OR ""011ashp19"" OR ""059gcgy73"" OR ""00p991c53"" OR ""02jx3x895"" OR ""056d84691"" OR ""052gg0110"" OR ""035b05819"" OR ""05f82e368"" OR ""0220mzb33"" OR ""04dkp9463"" OR ""041kmwe10"" OR ""04pp8hn57"" OR ""038t36y30"" OR ""00wjc7c48"" OR ""057w15z03"" OR ""046ak2485"" OR ""013meh722"" OR ""01hcx6992"" OR ""02crff812"" OR ""04mhzgx49"" OR ""03vek6s52"" OR ""00za53h95"" OR ""03dbr7087"" OR ""00b30xv10"" OR ""043mz5j54"" OR ""00py81415"" OR ""00jmfr291"" OR ""00f54p054"" OR ""01ej9dk98"" OR ""0384j8v12"" OR ""036rp1748"")) AND publication_type:""journal article"" AND date_published>=now-10y AND field_of_study: ((""Medicine"" OR ""Internal medicine"" OR ""Pharmacology"") AND (""Oncology"" OR ""Cancer"" OR ""Cancer research"" OR ""Chemotherapy"" OR ""Breast cancer"" OR ""Lung cancer"" OR ""Prostate cancer"" OR ""Pembrolizumab"" OR ""Multiple myeloma"" OR ""Colorectal cancer"" OR ""Neutropenia"" OR ""Metastatic breast cancer"" OR ""Lymphoma"" OR ""Myeloid leukemia"" OR ""Melanoma"" OR ""Renal cell carcinoma"" OR ""Leukemia"" OR ""Chronic lymphocytic leukemia"" OR ""Hepatocellular carcinoma"" OR ""Febrile neutropenia"" OR ""Carcinoma"" OR ""Ovarian cancer"" OR ""Response Evaluation Criteria in Solid Tumors"" OR ""Adenocarcinoma"" OR ""Follicular lymphoma"" OR ""Diffuse large B-cell lymphoma"" OR ""Cancer cell"" OR ""non-small cell lung cancer (NSCLC)"" OR ""Triple-negative breast cancer"" OR ""Pancreatic cancer"" OR ""Cancer immunotherapy"" OR ""Bladder cancer"" OR ""Cervical cancer"" OR ""Head and neck squamous-cell carcinoma"" OR ""Metastatic Urothelial Carcinoma"" OR ""Surgical oncology"" OR ""Head and neck cancer"" OR ""Carcinogenesis""))",AND date_published>=now-10y,"AND field_of_study: ((""Medicine"" OR ""Internal medicine"" OR ""Pharmacology"") AND (""Oncology"" OR ""Cancer"" OR ""Cancer research"" OR ""Chemotherapy"" OR ""Breast cancer"" OR ""Lung cancer"" OR ""Prostate cancer"" OR ""Pembrolizumab"" OR ""Multiple myeloma"" OR ""Colorectal cancer"" OR ""Neutropenia"" OR ""Metastatic breast cancer"" OR ""Lymphoma"" OR ""Myeloid leukemia"" OR ""Melanoma"" OR ""Renal cell carcinoma"" OR ""Leukemia"" OR ""Chronic lymphocytic leukemia"" OR ""Hepatocellular carcinoma"" OR ""Febrile neutropenia"" OR ""Carcinoma"" OR ""Ovarian cancer"" OR ""Response Evaluation Criteria in Solid Tumors"" OR ""Adenocarcinoma"" OR ""Follicular lymphoma"" OR ""Diffuse large B-cell lymphoma"" OR ""Cancer cell"" OR ""non-small cell lung cancer (NSCLC)"" OR ""Triple-negative breast cancer"" OR ""Pancreatic cancer"" OR ""Cancer immunotherapy"" OR ""Bladder cancer"" OR ""Cervical cancer"" OR ""Head and neck squamous-cell carcinoma"" OR ""Metastatic Urothelial Carcinoma"" OR ""Surgical oncology"" OR ""Head and neck cancer"" OR ""Carcinogenesis""))",NA,oa_therapy_area,Uni,Oncology,2018,22875,5935,3726,1426,2085,462,13634,9241
oncology (primary search + oncology tags) - uni,"(author.affiliation.name:(""university of cape town"" OR ""south african college"" OR ""shanghai jiao tong university"" OR ""shanghai communications university"" OR ""fudan university"" OR ""sun yat-sen university"" OR ""zhejiang university"" OR ""chekiang university"" OR ""peking university"" OR ""imperial university of peking"" OR ""capital medical university"" OR ""cmu"" OR ""seoul national university"" OR ""seoul daehakgyo"" OR ""peking union medical college"" OR ""beijing xiehe hospital"" OR ""sichuan university"" OR ""sìchuān dàxué"" OR ""nanjing medical university"" OR ""national jiangsu medical college"" OR ""huazhong university of science and technology"" OR ""huázhōng kējì dàxué"" OR ""university college london"" OR ""london university"" OR ""karolinska institutet"" OR ""royal caroline institute"" OR ""university of oxford"" OR ""oxford university"" OR ""university of copenhagen"" OR ""universität kopenhagen"" OR ""université de paris"" OR ""university of paris"" OR ""king's college london"" OR ""kcl"" OR ""university of amsterdam"" OR ""universiteit van amsterdam"" OR ""imperial college london"" OR ""coleg imperial llundain"" OR ""utrecht university"" OR ""universiteit utrecht"" OR ""heidelberg university"" OR ""ruprecht-karls-universität heidelberg"" OR ""university of milan"" OR ""université de milan"" OR ""erasmus university rotterdam"" OR ""erasmus universiteit rotterdam"" OR ""freie universität berlin"" OR ""free university of berlin"" OR ""university of cambridge"" OR ""cambridge university"" OR ""humboldt-universität zu berlin"" OR ""humboldt university of berlin"" OR ""university of zurich"" OR ""universität zürich"" OR ""tel aviv university"" OR ""harvard university"" OR ""universidad de harvard"" OR ""johns hopkins university"" OR ""jhu"" OR ""university of toronto"" OR ""université de toronto"" OR ""university of pennsylvania"" Or ""upenn"" OR ""university of california, san francisco"" OR ""ucsf"" OR ""duke university"" OR ""Universidad de Duke"" OR ""university of michigan"" OR ""umich"" OR ""stanford university"" OR ""leland stanford junior university"" OR ""university of melbourne"" OR ""melbourne university"" OR ""university of sydney"" OR ""sydney university"" OR ""university of são paulo"" OR ""universidade de são paulo"") OR author.affiliation.ror_id_lineage:(""03p74gp79"" OR ""0220qvk04"" OR ""013q1eq08"" OR ""0064kty71"" OR ""00a2xv884"" OR ""02v51f717"" OR ""013xs5b60"" OR ""04h9pn542"" OR ""04jztag35"" OR ""011ashp19"" OR ""059gcgy73"" OR ""00p991c53"" OR ""02jx3x895"" OR ""056d84691"" OR ""052gg0110"" OR ""035b05819"" OR ""05f82e368"" OR ""0220mzb33"" OR ""04dkp9463"" OR ""041kmwe10"" OR ""04pp8hn57"" OR ""038t36y30"" OR ""00wjc7c48"" OR ""057w15z03"" OR ""046ak2485"" OR ""013meh722"" OR ""01hcx6992"" OR ""02crff812"" OR ""04mhzgx49"" OR ""03vek6s52"" OR ""00za53h95"" OR ""03dbr7087"" OR ""00b30xv10"" OR ""043mz5j54"" OR ""00py81415"" OR ""00jmfr291"" OR ""00f54p054"" OR ""01ej9dk98"" OR ""0384j8v12"" OR ""036rp1748"")) AND publication_type:""journal article"" AND date_published>=now-10y AND field_of_study: ((""Medicine"" OR ""Internal medicine"" OR ""Pharmacology"") AND (""Oncology"" OR ""Cancer"" OR ""Cancer research"" OR ""Chemotherapy"" OR ""Breast cancer"" OR ""Lung cancer"" OR ""Prostate cancer"" OR ""Pembrolizumab"" OR ""Multiple myeloma"" OR ""Colorectal cancer"" OR ""Neutropenia"" OR ""Metastatic breast cancer"" OR ""Lymphoma"" OR ""Myeloid leukemia"" OR ""Melanoma"" OR ""Renal cell carcinoma"" OR ""Leukemia"" OR ""Chronic lymphocytic leukemia"" OR ""Hepatocellular carcinoma"" OR ""Febrile neutropenia"" OR ""Carcinoma"" OR ""Ovarian cancer"" OR ""Response Evaluation Criteria in Solid Tumors"" OR ""Adenocarcinoma"" OR ""Follicular lymphoma"" OR ""Diffuse large B-cell lymphoma"" OR ""Cancer cell"" OR ""non-small cell lung cancer (NSCLC)"" OR ""Triple-negative breast cancer"" OR ""Pancreatic cancer"" OR ""Cancer immunotherapy"" OR ""Bladder cancer"" OR ""Cervical cancer"" OR ""Head and neck squamous-cell carcinoma"" OR ""Metastatic Urothelial Carcinoma"" OR ""Surgical oncology"" OR ""Head and neck cancer"" OR ""Carcinogenesis""))",AND date_published>=now-10y,"AND field_of_study: ((""Medicine"" OR ""Internal medicine"" OR ""Pharmacology"") AND (""Oncology"" OR ""Cancer"" OR ""Cancer research"" OR ""Chemotherapy"" OR ""Breast cancer"" OR ""Lung cancer"" OR ""Prostate cancer"" OR ""Pembrolizumab"" OR ""Multiple myeloma"" OR ""Colorectal cancer"" OR ""Neutropenia"" OR ""Metastatic breast cancer"" OR ""Lymphoma"" OR ""Myeloid leukemia"" OR ""Melanoma"" OR ""Renal cell carcinoma"" OR ""Leukemia"" OR ""Chronic lymphocytic leukemia"" OR ""Hepatocellular carcinoma"" OR ""Febrile neutropenia"" OR ""Carcinoma"" OR ""Ovarian cancer"" OR ""Response Evaluation Criteria in Solid Tumors"" OR ""Adenocarcinoma"" OR ""Follicular lymphoma"" OR ""Diffuse large B-cell lymphoma"" OR ""Cancer cell"" OR ""non-small cell lung cancer (NSCLC)"" OR ""Triple-negative breast cancer"" OR ""Pancreatic cancer"" OR ""Cancer immunotherapy"" OR ""Bladder cancer"" OR ""Cervical cancer"" OR ""Head and neck squamous-cell carcinoma"" OR ""Metastatic Urothelial Carcinoma"" OR ""Surgical oncology"" OR ""Head and neck cancer"" OR ""Carcinogenesis""))",NA,oa_therapy_area,Uni,Oncology,2019,24984,7163,3657,1817,2130,427,15194,9790
oncology (primary search + oncology tags) - uni,"(author.affiliation.name:(""university of cape town"" OR ""south african college"" OR ""shanghai jiao tong university"" OR ""shanghai communications university"" OR ""fudan university"" OR ""sun yat-sen university"" OR ""zhejiang university"" OR ""chekiang university"" OR ""peking university"" OR ""imperial university of peking"" OR ""capital medical university"" OR ""cmu"" OR ""seoul national university"" OR ""seoul daehakgyo"" OR ""peking union medical college"" OR ""beijing xiehe hospital"" OR ""sichuan university"" OR ""sìchuān dàxué"" OR ""nanjing medical university"" OR ""national jiangsu medical college"" OR ""huazhong university of science and technology"" OR ""huázhōng kējì dàxué"" OR ""university college london"" OR ""london university"" OR ""karolinska institutet"" OR ""royal caroline institute"" OR ""university of oxford"" OR ""oxford university"" OR ""university of copenhagen"" OR ""universität kopenhagen"" OR ""université de paris"" OR ""university of paris"" OR ""king's college london"" OR ""kcl"" OR ""university of amsterdam"" OR ""universiteit van amsterdam"" OR ""imperial college london"" OR ""coleg imperial llundain"" OR ""utrecht university"" OR ""universiteit utrecht"" OR ""heidelberg university"" OR ""ruprecht-karls-universität heidelberg"" OR ""university of milan"" OR ""université de milan"" OR ""erasmus university rotterdam"" OR ""erasmus universiteit rotterdam"" OR ""freie universität berlin"" OR ""free university of berlin"" OR ""university of cambridge"" OR ""cambridge university"" OR ""humboldt-universität zu berlin"" OR ""humboldt university of berlin"" OR ""university of zurich"" OR ""universität zürich"" OR ""tel aviv university"" OR ""harvard university"" OR ""universidad de harvard"" OR ""johns hopkins university"" OR ""jhu"" OR ""university of toronto"" OR ""université de toronto"" OR ""university of pennsylvania"" Or ""upenn"" OR ""university of california, san francisco"" OR ""ucsf"" OR ""duke university"" OR ""Universidad de Duke"" OR ""university of michigan"" OR ""umich"" OR ""stanford university"" OR ""leland stanford junior university"" OR ""university of melbourne"" OR ""melbourne university"" OR ""university of sydney"" OR ""sydney university"" OR ""university of são paulo"" OR ""universidade de são paulo"") OR author.affiliation.ror_id_lineage:(""03p74gp79"" OR ""0220qvk04"" OR ""013q1eq08"" OR ""0064kty71"" OR ""00a2xv884"" OR ""02v51f717"" OR ""013xs5b60"" OR ""04h9pn542"" OR ""04jztag35"" OR ""011ashp19"" OR ""059gcgy73"" OR ""00p991c53"" OR ""02jx3x895"" OR ""056d84691"" OR ""052gg0110"" OR ""035b05819"" OR ""05f82e368"" OR ""0220mzb33"" OR ""04dkp9463"" OR ""041kmwe10"" OR ""04pp8hn57"" OR ""038t36y30"" OR ""00wjc7c48"" OR ""057w15z03"" OR ""046ak2485"" OR ""013meh722"" OR ""01hcx6992"" OR ""02crff812"" OR ""04mhzgx49"" OR ""03vek6s52"" OR ""00za53h95"" OR ""03dbr7087"" OR ""00b30xv10"" OR ""043mz5j54"" OR ""00py81415"" OR ""00jmfr291"" OR ""00f54p054"" OR ""01ej9dk98"" OR ""0384j8v12"" OR ""036rp1748"")) AND publication_type:""journal article"" AND date_published>=now-10y AND field_of_study: ((""Medicine"" OR ""Internal medicine"" OR ""Pharmacology"") AND (""Oncology"" OR ""Cancer"" OR ""Cancer research"" OR ""Chemotherapy"" OR ""Breast cancer"" OR ""Lung cancer"" OR ""Prostate cancer"" OR ""Pembrolizumab"" OR ""Multiple myeloma"" OR ""Colorectal cancer"" OR ""Neutropenia"" OR ""Metastatic breast cancer"" OR ""Lymphoma"" OR ""Myeloid leukemia"" OR ""Melanoma"" OR ""Renal cell carcinoma"" OR ""Leukemia"" OR ""Chronic lymphocytic leukemia"" OR ""Hepatocellular carcinoma"" OR ""Febrile neutropenia"" OR ""Carcinoma"" OR ""Ovarian cancer"" OR ""Response Evaluation Criteria in Solid Tumors"" OR ""Adenocarcinoma"" OR ""Follicular lymphoma"" OR ""Diffuse large B-cell lymphoma"" OR ""Cancer cell"" OR ""non-small cell lung cancer (NSCLC)"" OR ""Triple-negative breast cancer"" OR ""Pancreatic cancer"" OR ""Cancer immunotherapy"" OR ""Bladder cancer"" OR ""Cervical cancer"" OR ""Head and neck squamous-cell carcinoma"" OR ""Metastatic Urothelial Carcinoma"" OR ""Surgical oncology"" OR ""Head and neck cancer"" OR ""Carcinogenesis""))",AND date_published>=now-10y,"AND field_of_study: ((""Medicine"" OR ""Internal medicine"" OR ""Pharmacology"") AND (""Oncology"" OR ""Cancer"" OR ""Cancer research"" OR ""Chemotherapy"" OR ""Breast cancer"" OR ""Lung cancer"" OR ""Prostate cancer"" OR ""Pembrolizumab"" OR ""Multiple myeloma"" OR ""Colorectal cancer"" OR ""Neutropenia"" OR ""Metastatic breast cancer"" OR ""Lymphoma"" OR ""Myeloid leukemia"" OR ""Melanoma"" OR ""Renal cell carcinoma"" OR ""Leukemia"" OR ""Chronic lymphocytic leukemia"" OR ""Hepatocellular carcinoma"" OR ""Febrile neutropenia"" OR ""Carcinoma"" OR ""Ovarian cancer"" OR ""Response Evaluation Criteria in Solid Tumors"" OR ""Adenocarcinoma"" OR ""Follicular lymphoma"" OR ""Diffuse large B-cell lymphoma"" OR ""Cancer cell"" OR ""non-small cell lung cancer (NSCLC)"" OR ""Triple-negative breast cancer"" OR ""Pancreatic cancer"" OR ""Cancer immunotherapy"" OR ""Bladder cancer"" OR ""Cervical cancer"" OR ""Head and neck squamous-cell carcinoma"" OR ""Metastatic Urothelial Carcinoma"" OR ""Surgical oncology"" OR ""Head and neck cancer"" OR ""Carcinogenesis""))",NA,oa_therapy_area,Uni,Oncology,2020,29562,9921,3634,2450,1913,645,18563,10999
oncology (primary search + oncology tags) - uni,"(author.affiliation.name:(""university of cape town"" OR ""south african college"" OR ""shanghai jiao tong university"" OR ""shanghai communications university"" OR ""fudan university"" OR ""sun yat-sen university"" OR ""zhejiang university"" OR ""chekiang university"" OR ""peking university"" OR ""imperial university of peking"" OR ""capital medical university"" OR ""cmu"" OR ""seoul national university"" OR ""seoul daehakgyo"" OR ""peking union medical college"" OR ""beijing xiehe hospital"" OR ""sichuan university"" OR ""sìchuān dàxué"" OR ""nanjing medical university"" OR ""national jiangsu medical college"" OR ""huazhong university of science and technology"" OR ""huázhōng kējì dàxué"" OR ""university college london"" OR ""london university"" OR ""karolinska institutet"" OR ""royal caroline institute"" OR ""university of oxford"" OR ""oxford university"" OR ""university of copenhagen"" OR ""universität kopenhagen"" OR ""université de paris"" OR ""university of paris"" OR ""king's college london"" OR ""kcl"" OR ""university of amsterdam"" OR ""universiteit van amsterdam"" OR ""imperial college london"" OR ""coleg imperial llundain"" OR ""utrecht university"" OR ""universiteit utrecht"" OR ""heidelberg university"" OR ""ruprecht-karls-universität heidelberg"" OR ""university of milan"" OR ""université de milan"" OR ""erasmus university rotterdam"" OR ""erasmus universiteit rotterdam"" OR ""freie universität berlin"" OR ""free university of berlin"" OR ""university of cambridge"" OR ""cambridge university"" OR ""humboldt-universität zu berlin"" OR ""humboldt university of berlin"" OR ""university of zurich"" OR ""universität zürich"" OR ""tel aviv university"" OR ""harvard university"" OR ""universidad de harvard"" OR ""johns hopkins university"" OR ""jhu"" OR ""university of toronto"" OR ""université de toronto"" OR ""university of pennsylvania"" Or ""upenn"" OR ""university of california, san francisco"" OR ""ucsf"" OR ""duke university"" OR ""Universidad de Duke"" OR ""university of michigan"" OR ""umich"" OR ""stanford university"" OR ""leland stanford junior university"" OR ""university of melbourne"" OR ""melbourne university"" OR ""university of sydney"" OR ""sydney university"" OR ""university of são paulo"" OR ""universidade de são paulo"") OR author.affiliation.ror_id_lineage:(""03p74gp79"" OR ""0220qvk04"" OR ""013q1eq08"" OR ""0064kty71"" OR ""00a2xv884"" OR ""02v51f717"" OR ""013xs5b60"" OR ""04h9pn542"" OR ""04jztag35"" OR ""011ashp19"" OR ""059gcgy73"" OR ""00p991c53"" OR ""02jx3x895"" OR ""056d84691"" OR ""052gg0110"" OR ""035b05819"" OR ""05f82e368"" OR ""0220mzb33"" OR ""04dkp9463"" OR ""041kmwe10"" OR ""04pp8hn57"" OR ""038t36y30"" OR ""00wjc7c48"" OR ""057w15z03"" OR ""046ak2485"" OR ""013meh722"" OR ""01hcx6992"" OR ""02crff812"" OR ""04mhzgx49"" OR ""03vek6s52"" OR ""00za53h95"" OR ""03dbr7087"" OR ""00b30xv10"" OR ""043mz5j54"" OR ""00py81415"" OR ""00jmfr291"" OR ""00f54p054"" OR ""01ej9dk98"" OR ""0384j8v12"" OR ""036rp1748"")) AND publication_type:""journal article"" AND date_published>=now-10y AND field_of_study: ((""Medicine"" OR ""Internal medicine"" OR ""Pharmacology"") AND (""Oncology"" OR ""Cancer"" OR ""Cancer research"" OR ""Chemotherapy"" OR ""Breast cancer"" OR ""Lung cancer"" OR ""Prostate cancer"" OR ""Pembrolizumab"" OR ""Multiple myeloma"" OR ""Colorectal cancer"" OR ""Neutropenia"" OR ""Metastatic breast cancer"" OR ""Lymphoma"" OR ""Myeloid leukemia"" OR ""Melanoma"" OR ""Renal cell carcinoma"" OR ""Leukemia"" OR ""Chronic lymphocytic leukemia"" OR ""Hepatocellular carcinoma"" OR ""Febrile neutropenia"" OR ""Carcinoma"" OR ""Ovarian cancer"" OR ""Response Evaluation Criteria in Solid Tumors"" OR ""Adenocarcinoma"" OR ""Follicular lymphoma"" OR ""Diffuse large B-cell lymphoma"" OR ""Cancer cell"" OR ""non-small cell lung cancer (NSCLC)"" OR ""Triple-negative breast cancer"" OR ""Pancreatic cancer"" OR ""Cancer immunotherapy"" OR ""Bladder cancer"" OR ""Cervical cancer"" OR ""Head and neck squamous-cell carcinoma"" OR ""Metastatic Urothelial Carcinoma"" OR ""Surgical oncology"" OR ""Head and neck cancer"" OR ""Carcinogenesis""))",AND date_published>=now-10y,"AND field_of_study: ((""Medicine"" OR ""Internal medicine"" OR ""Pharmacology"") AND (""Oncology"" OR ""Cancer"" OR ""Cancer research"" OR ""Chemotherapy"" OR ""Breast cancer"" OR ""Lung cancer"" OR ""Prostate cancer"" OR ""Pembrolizumab"" OR ""Multiple myeloma"" OR ""Colorectal cancer"" OR ""Neutropenia"" OR ""Metastatic breast cancer"" OR ""Lymphoma"" OR ""Myeloid leukemia"" OR ""Melanoma"" OR ""Renal cell carcinoma"" OR ""Leukemia"" OR ""Chronic lymphocytic leukemia"" OR ""Hepatocellular carcinoma"" OR ""Febrile neutropenia"" OR ""Carcinoma"" OR ""Ovarian cancer"" OR ""Response Evaluation Criteria in Solid Tumors"" OR ""Adenocarcinoma"" OR ""Follicular lymphoma"" OR ""Diffuse large B-cell lymphoma"" OR ""Cancer cell"" OR ""non-small cell lung cancer (NSCLC)"" OR ""Triple-negative breast cancer"" OR ""Pancreatic cancer"" OR ""Cancer immunotherapy"" OR ""Bladder cancer"" OR ""Cervical cancer"" OR ""Head and neck squamous-cell carcinoma"" OR ""Metastatic Urothelial Carcinoma"" OR ""Surgical oncology"" OR ""Head and neck cancer"" OR ""Carcinogenesis""))",NA,oa_therapy_area,Uni,Oncology,2021,32002,12866,1693,2888,2219,1555,21221,10781
oncology (primary search + oncology tags) - uni,"(author.affiliation.name:(""university of cape town"" OR ""south african college"" OR ""shanghai jiao tong university"" OR ""shanghai communications university"" OR ""fudan university"" OR ""sun yat-sen university"" OR ""zhejiang university"" OR ""chekiang university"" OR ""peking university"" OR ""imperial university of peking"" OR ""capital medical university"" OR ""cmu"" OR ""seoul national university"" OR ""seoul daehakgyo"" OR ""peking union medical college"" OR ""beijing xiehe hospital"" OR ""sichuan university"" OR ""sìchuān dàxué"" OR ""nanjing medical university"" OR ""national jiangsu medical college"" OR ""huazhong university of science and technology"" OR ""huázhōng kējì dàxué"" OR ""university college london"" OR ""london university"" OR ""karolinska institutet"" OR ""royal caroline institute"" OR ""university of oxford"" OR ""oxford university"" OR ""university of copenhagen"" OR ""universität kopenhagen"" OR ""université de paris"" OR ""university of paris"" OR ""king's college london"" OR ""kcl"" OR ""university of amsterdam"" OR ""universiteit van amsterdam"" OR ""imperial college london"" OR ""coleg imperial llundain"" OR ""utrecht university"" OR ""universiteit utrecht"" OR ""heidelberg university"" OR ""ruprecht-karls-universität heidelberg"" OR ""university of milan"" OR ""université de milan"" OR ""erasmus university rotterdam"" OR ""erasmus universiteit rotterdam"" OR ""freie universität berlin"" OR ""free university of berlin"" OR ""university of cambridge"" OR ""cambridge university"" OR ""humboldt-universität zu berlin"" OR ""humboldt university of berlin"" OR ""university of zurich"" OR ""universität zürich"" OR ""tel aviv university"" OR ""harvard university"" OR ""universidad de harvard"" OR ""johns hopkins university"" OR ""jhu"" OR ""university of toronto"" OR ""université de toronto"" OR ""university of pennsylvania"" Or ""upenn"" OR ""university of california, san francisco"" OR ""ucsf"" OR ""duke university"" OR ""Universidad de Duke"" OR ""university of michigan"" OR ""umich"" OR ""stanford university"" OR ""leland stanford junior university"" OR ""university of melbourne"" OR ""melbourne university"" OR ""university of sydney"" OR ""sydney university"" OR ""university of são paulo"" OR ""universidade de são paulo"") OR author.affiliation.ror_id_lineage:(""03p74gp79"" OR ""0220qvk04"" OR ""013q1eq08"" OR ""0064kty71"" OR ""00a2xv884"" OR ""02v51f717"" OR ""013xs5b60"" OR ""04h9pn542"" OR ""04jztag35"" OR ""011ashp19"" OR ""059gcgy73"" OR ""00p991c53"" OR ""02jx3x895"" OR ""056d84691"" OR ""052gg0110"" OR ""035b05819"" OR ""05f82e368"" OR ""0220mzb33"" OR ""04dkp9463"" OR ""041kmwe10"" OR ""04pp8hn57"" OR ""038t36y30"" OR ""00wjc7c48"" OR ""057w15z03"" OR ""046ak2485"" OR ""013meh722"" OR ""01hcx6992"" OR ""02crff812"" OR ""04mhzgx49"" OR ""03vek6s52"" OR ""00za53h95"" OR ""03dbr7087"" OR ""00b30xv10"" OR ""043mz5j54"" OR ""00py81415"" OR ""00jmfr291"" OR ""00f54p054"" OR ""01ej9dk98"" OR ""0384j8v12"" OR ""036rp1748"")) AND publication_type:""journal article"" AND date_published>=now-10y AND field_of_study: ((""Medicine"" OR ""Internal medicine"" OR ""Pharmacology"") AND (""Oncology"" OR ""Cancer"" OR ""Cancer research"" OR ""Chemotherapy"" OR ""Breast cancer"" OR ""Lung cancer"" OR ""Prostate cancer"" OR ""Pembrolizumab"" OR ""Multiple myeloma"" OR ""Colorectal cancer"" OR ""Neutropenia"" OR ""Metastatic breast cancer"" OR ""Lymphoma"" OR ""Myeloid leukemia"" OR ""Melanoma"" OR ""Renal cell carcinoma"" OR ""Leukemia"" OR ""Chronic lymphocytic leukemia"" OR ""Hepatocellular carcinoma"" OR ""Febrile neutropenia"" OR ""Carcinoma"" OR ""Ovarian cancer"" OR ""Response Evaluation Criteria in Solid Tumors"" OR ""Adenocarcinoma"" OR ""Follicular lymphoma"" OR ""Diffuse large B-cell lymphoma"" OR ""Cancer cell"" OR ""non-small cell lung cancer (NSCLC)"" OR ""Triple-negative breast cancer"" OR ""Pancreatic cancer"" OR ""Cancer immunotherapy"" OR ""Bladder cancer"" OR ""Cervical cancer"" OR ""Head and neck squamous-cell carcinoma"" OR ""Metastatic Urothelial Carcinoma"" OR ""Surgical oncology"" OR ""Head and neck cancer"" OR ""Carcinogenesis""))",AND date_published>=now-10y,"AND field_of_study: ((""Medicine"" OR ""Internal medicine"" OR ""Pharmacology"") AND (""Oncology"" OR ""Cancer"" OR ""Cancer research"" OR ""Chemotherapy"" OR ""Breast cancer"" OR ""Lung cancer"" OR ""Prostate cancer"" OR ""Pembrolizumab"" OR ""Multiple myeloma"" OR ""Colorectal cancer"" OR ""Neutropenia"" OR ""Metastatic breast cancer"" OR ""Lymphoma"" OR ""Myeloid leukemia"" OR ""Melanoma"" OR ""Renal cell carcinoma"" OR ""Leukemia"" OR ""Chronic lymphocytic leukemia"" OR ""Hepatocellular carcinoma"" OR ""Febrile neutropenia"" OR ""Carcinoma"" OR ""Ovarian cancer"" OR ""Response Evaluation Criteria in Solid Tumors"" OR ""Adenocarcinoma"" OR ""Follicular lymphoma"" OR ""Diffuse large B-cell lymphoma"" OR ""Cancer cell"" OR ""non-small cell lung cancer (NSCLC)"" OR ""Triple-negative breast cancer"" OR ""Pancreatic cancer"" OR ""Cancer immunotherapy"" OR ""Bladder cancer"" OR ""Cervical cancer"" OR ""Head and neck squamous-cell carcinoma"" OR ""Metastatic Urothelial Carcinoma"" OR ""Surgical oncology"" OR ""Head and neck cancer"" OR ""Carcinogenesis""))",NA,oa_therapy_area,Uni,Oncology,2022,38066,17489,1582,3424,1350,879,24724,13342
oncology (primary search + oncology tags) - uni,"(author.affiliation.name:(""university of cape town"" OR ""south african college"" OR ""shanghai jiao tong university"" OR ""shanghai communications university"" OR ""fudan university"" OR ""sun yat-sen university"" OR ""zhejiang university"" OR ""chekiang university"" OR ""peking university"" OR ""imperial university of peking"" OR ""capital medical university"" OR ""cmu"" OR ""seoul national university"" OR ""seoul daehakgyo"" OR ""peking union medical college"" OR ""beijing xiehe hospital"" OR ""sichuan university"" OR ""sìchuān dàxué"" OR ""nanjing medical university"" OR ""national jiangsu medical college"" OR ""huazhong university of science and technology"" OR ""huázhōng kējì dàxué"" OR ""university college london"" OR ""london university"" OR ""karolinska institutet"" OR ""royal caroline institute"" OR ""university of oxford"" OR ""oxford university"" OR ""university of copenhagen"" OR ""universität kopenhagen"" OR ""université de paris"" OR ""university of paris"" OR ""king's college london"" OR ""kcl"" OR ""university of amsterdam"" OR ""universiteit van amsterdam"" OR ""imperial college london"" OR ""coleg imperial llundain"" OR ""utrecht university"" OR ""universiteit utrecht"" OR ""heidelberg university"" OR ""ruprecht-karls-universität heidelberg"" OR ""university of milan"" OR ""université de milan"" OR ""erasmus university rotterdam"" OR ""erasmus universiteit rotterdam"" OR ""freie universität berlin"" OR ""free university of berlin"" OR ""university of cambridge"" OR ""cambridge university"" OR ""humboldt-universität zu berlin"" OR ""humboldt university of berlin"" OR ""university of zurich"" OR ""universität zürich"" OR ""tel aviv university"" OR ""harvard university"" OR ""universidad de harvard"" OR ""johns hopkins university"" OR ""jhu"" OR ""university of toronto"" OR ""université de toronto"" OR ""university of pennsylvania"" Or ""upenn"" OR ""university of california, san francisco"" OR ""ucsf"" OR ""duke university"" OR ""Universidad de Duke"" OR ""university of michigan"" OR ""umich"" OR ""stanford university"" OR ""leland stanford junior university"" OR ""university of melbourne"" OR ""melbourne university"" OR ""university of sydney"" OR ""sydney university"" OR ""university of são paulo"" OR ""universidade de são paulo"") OR author.affiliation.ror_id_lineage:(""03p74gp79"" OR ""0220qvk04"" OR ""013q1eq08"" OR ""0064kty71"" OR ""00a2xv884"" OR ""02v51f717"" OR ""013xs5b60"" OR ""04h9pn542"" OR ""04jztag35"" OR ""011ashp19"" OR ""059gcgy73"" OR ""00p991c53"" OR ""02jx3x895"" OR ""056d84691"" OR ""052gg0110"" OR ""035b05819"" OR ""05f82e368"" OR ""0220mzb33"" OR ""04dkp9463"" OR ""041kmwe10"" OR ""04pp8hn57"" OR ""038t36y30"" OR ""00wjc7c48"" OR ""057w15z03"" OR ""046ak2485"" OR ""013meh722"" OR ""01hcx6992"" OR ""02crff812"" OR ""04mhzgx49"" OR ""03vek6s52"" OR ""00za53h95"" OR ""03dbr7087"" OR ""00b30xv10"" OR ""043mz5j54"" OR ""00py81415"" OR ""00jmfr291"" OR ""00f54p054"" OR ""01ej9dk98"" OR ""0384j8v12"" OR ""036rp1748"")) AND publication_type:""journal article"" AND date_published>=now-10y AND field_of_study: ((""Medicine"" OR ""Internal medicine"" OR ""Pharmacology"") AND (""Oncology"" OR ""Cancer"" OR ""Cancer research"" OR ""Chemotherapy"" OR ""Breast cancer"" OR ""Lung cancer"" OR ""Prostate cancer"" OR ""Pembrolizumab"" OR ""Multiple myeloma"" OR ""Colorectal cancer"" OR ""Neutropenia"" OR ""Metastatic breast cancer"" OR ""Lymphoma"" OR ""Myeloid leukemia"" OR ""Melanoma"" OR ""Renal cell carcinoma"" OR ""Leukemia"" OR ""Chronic lymphocytic leukemia"" OR ""Hepatocellular carcinoma"" OR ""Febrile neutropenia"" OR ""Carcinoma"" OR ""Ovarian cancer"" OR ""Response Evaluation Criteria in Solid Tumors"" OR ""Adenocarcinoma"" OR ""Follicular lymphoma"" OR ""Diffuse large B-cell lymphoma"" OR ""Cancer cell"" OR ""non-small cell lung cancer (NSCLC)"" OR ""Triple-negative breast cancer"" OR ""Pancreatic cancer"" OR ""Cancer immunotherapy"" OR ""Bladder cancer"" OR ""Cervical cancer"" OR ""Head and neck squamous-cell carcinoma"" OR ""Metastatic Urothelial Carcinoma"" OR ""Surgical oncology"" OR ""Head and neck cancer"" OR ""Carcinogenesis""))",AND date_published>=now-10y,"AND field_of_study: ((""Medicine"" OR ""Internal medicine"" OR ""Pharmacology"") AND (""Oncology"" OR ""Cancer"" OR ""Cancer research"" OR ""Chemotherapy"" OR ""Breast cancer"" OR ""Lung cancer"" OR ""Prostate cancer"" OR ""Pembrolizumab"" OR ""Multiple myeloma"" OR ""Colorectal cancer"" OR ""Neutropenia"" OR ""Metastatic breast cancer"" OR ""Lymphoma"" OR ""Myeloid leukemia"" OR ""Melanoma"" OR ""Renal cell carcinoma"" OR ""Leukemia"" OR ""Chronic lymphocytic leukemia"" OR ""Hepatocellular carcinoma"" OR ""Febrile neutropenia"" OR ""Carcinoma"" OR ""Ovarian cancer"" OR ""Response Evaluation Criteria in Solid Tumors"" OR ""Adenocarcinoma"" OR ""Follicular lymphoma"" OR ""Diffuse large B-cell lymphoma"" OR ""Cancer cell"" OR ""non-small cell lung cancer (NSCLC)"" OR ""Triple-negative breast cancer"" OR ""Pancreatic cancer"" OR ""Cancer immunotherapy"" OR ""Bladder cancer"" OR ""Cervical cancer"" OR ""Head and neck squamous-cell carcinoma"" OR ""Metastatic Urothelial Carcinoma"" OR ""Surgical oncology"" OR ""Head and neck cancer"" OR ""Carcinogenesis""))",NA,oa_therapy_area,Uni,Oncology,2023,14583,6484,178,1248,283,784,8977,5606
pharmacology (primary search + pharmacology tags) - uni,"(author.affiliation.name:(""university of cape town"" OR ""south african college"" OR ""shanghai jiao tong university"" OR ""shanghai communications university"" OR ""fudan university"" OR ""sun yat-sen university"" OR ""zhejiang university"" OR ""chekiang university"" OR ""peking university"" OR ""imperial university of peking"" OR ""capital medical university"" OR ""cmu"" OR ""seoul national university"" OR ""seoul daehakgyo"" OR ""peking union medical college"" OR ""beijing xiehe hospital"" OR ""sichuan university"" OR ""sìchuān dàxué"" OR ""nanjing medical university"" OR ""national jiangsu medical college"" OR ""huazhong university of science and technology"" OR ""huázhōng kējì dàxué"" OR ""university college london"" OR ""london university"" OR ""karolinska institutet"" OR ""royal caroline institute"" OR ""university of oxford"" OR ""oxford university"" OR ""university of copenhagen"" OR ""universität kopenhagen"" OR ""université de paris"" OR ""university of paris"" OR ""king's college london"" OR ""kcl"" OR ""university of amsterdam"" OR ""universiteit van amsterdam"" OR ""imperial college london"" OR ""coleg imperial llundain"" OR ""utrecht university"" OR ""universiteit utrecht"" OR ""heidelberg university"" OR ""ruprecht-karls-universität heidelberg"" OR ""university of milan"" OR ""université de milan"" OR ""erasmus university rotterdam"" OR ""erasmus universiteit rotterdam"" OR ""freie universität berlin"" OR ""free university of berlin"" OR ""university of cambridge"" OR ""cambridge university"" OR ""humboldt-universität zu berlin"" OR ""humboldt university of berlin"" OR ""university of zurich"" OR ""universität zürich"" OR ""tel aviv university"" OR ""harvard university"" OR ""universidad de harvard"" OR ""johns hopkins university"" OR ""jhu"" OR ""university of toronto"" OR ""université de toronto"" OR ""university of pennsylvania"" Or ""upenn"" OR ""university of california, san francisco"" OR ""ucsf"" OR ""duke university"" OR ""Universidad de Duke"" OR ""university of michigan"" OR ""umich"" OR ""stanford university"" OR ""leland stanford junior university"" OR ""university of melbourne"" OR ""melbourne university"" OR ""university of sydney"" OR ""sydney university"" OR ""university of são paulo"" OR ""universidade de são paulo"") OR author.affiliation.ror_id_lineage:(""03p74gp79"" OR ""0220qvk04"" OR ""013q1eq08"" OR ""0064kty71"" OR ""00a2xv884"" OR ""02v51f717"" OR ""013xs5b60"" OR ""04h9pn542"" OR ""04jztag35"" OR ""011ashp19"" OR ""059gcgy73"" OR ""00p991c53"" OR ""02jx3x895"" OR ""056d84691"" OR ""052gg0110"" OR ""035b05819"" OR ""05f82e368"" OR ""0220mzb33"" OR ""04dkp9463"" OR ""041kmwe10"" OR ""04pp8hn57"" OR ""038t36y30"" OR ""00wjc7c48"" OR ""057w15z03"" OR ""046ak2485"" OR ""013meh722"" OR ""01hcx6992"" OR ""02crff812"" OR ""04mhzgx49"" OR ""03vek6s52"" OR ""00za53h95"" OR ""03dbr7087"" OR ""00b30xv10"" OR ""043mz5j54"" OR ""00py81415"" OR ""00jmfr291"" OR ""00f54p054"" OR ""01ej9dk98"" OR ""0384j8v12"" OR ""036rp1748"")) AND publication_type:""journal article"" AND date_published>=now-10y AND field_of_study: ((""Medicine"" OR ""Internal medicine"" OR ""Pharmacology"") AND (""Pharmacology"" OR ""Pharmacokinetics"" OR ""Chemistry"" OR ""Biochemistry"" OR ""Pharmacodynamics"" OR ""In vitro"" OR ""Pharmacotherapy"" OR ""Clinical pharmacology""))",AND date_published>=now-10y,"AND field_of_study: ((""Medicine"" OR ""Internal medicine"" OR ""Pharmacology"") AND (""Pharmacology"" OR ""Pharmacokinetics"" OR ""Chemistry"" OR ""Biochemistry"" OR ""Pharmacodynamics"" OR ""In vitro"" OR ""Pharmacotherapy"" OR ""Clinical pharmacology""))",NA,oa_therapy_area,Uni,Pharmacology,2013,2294,474,480,84,128,22,1188,1106
pharmacology (primary search + pharmacology tags) - uni,"(author.affiliation.name:(""university of cape town"" OR ""south african college"" OR ""shanghai jiao tong university"" OR ""shanghai communications university"" OR ""fudan university"" OR ""sun yat-sen university"" OR ""zhejiang university"" OR ""chekiang university"" OR ""peking university"" OR ""imperial university of peking"" OR ""capital medical university"" OR ""cmu"" OR ""seoul national university"" OR ""seoul daehakgyo"" OR ""peking union medical college"" OR ""beijing xiehe hospital"" OR ""sichuan university"" OR ""sìchuān dàxué"" OR ""nanjing medical university"" OR ""national jiangsu medical college"" OR ""huazhong university of science and technology"" OR ""huázhōng kējì dàxué"" OR ""university college london"" OR ""london university"" OR ""karolinska institutet"" OR ""royal caroline institute"" OR ""university of oxford"" OR ""oxford university"" OR ""university of copenhagen"" OR ""universität kopenhagen"" OR ""université de paris"" OR ""university of paris"" OR ""king's college london"" OR ""kcl"" OR ""university of amsterdam"" OR ""universiteit van amsterdam"" OR ""imperial college london"" OR ""coleg imperial llundain"" OR ""utrecht university"" OR ""universiteit utrecht"" OR ""heidelberg university"" OR ""ruprecht-karls-universität heidelberg"" OR ""university of milan"" OR ""université de milan"" OR ""erasmus university rotterdam"" OR ""erasmus universiteit rotterdam"" OR ""freie universität berlin"" OR ""free university of berlin"" OR ""university of cambridge"" OR ""cambridge university"" OR ""humboldt-universität zu berlin"" OR ""humboldt university of berlin"" OR ""university of zurich"" OR ""universität zürich"" OR ""tel aviv university"" OR ""harvard university"" OR ""universidad de harvard"" OR ""johns hopkins university"" OR ""jhu"" OR ""university of toronto"" OR ""université de toronto"" OR ""university of pennsylvania"" Or ""upenn"" OR ""university of california, san francisco"" OR ""ucsf"" OR ""duke university"" OR ""Universidad de Duke"" OR ""university of michigan"" OR ""umich"" OR ""stanford university"" OR ""leland stanford junior university"" OR ""university of melbourne"" OR ""melbourne university"" OR ""university of sydney"" OR ""sydney university"" OR ""university of são paulo"" OR ""universidade de são paulo"") OR author.affiliation.ror_id_lineage:(""03p74gp79"" OR ""0220qvk04"" OR ""013q1eq08"" OR ""0064kty71"" OR ""00a2xv884"" OR ""02v51f717"" OR ""013xs5b60"" OR ""04h9pn542"" OR ""04jztag35"" OR ""011ashp19"" OR ""059gcgy73"" OR ""00p991c53"" OR ""02jx3x895"" OR ""056d84691"" OR ""052gg0110"" OR ""035b05819"" OR ""05f82e368"" OR ""0220mzb33"" OR ""04dkp9463"" OR ""041kmwe10"" OR ""04pp8hn57"" OR ""038t36y30"" OR ""00wjc7c48"" OR ""057w15z03"" OR ""046ak2485"" OR ""013meh722"" OR ""01hcx6992"" OR ""02crff812"" OR ""04mhzgx49"" OR ""03vek6s52"" OR ""00za53h95"" OR ""03dbr7087"" OR ""00b30xv10"" OR ""043mz5j54"" OR ""00py81415"" OR ""00jmfr291"" OR ""00f54p054"" OR ""01ej9dk98"" OR ""0384j8v12"" OR ""036rp1748"")) AND publication_type:""journal article"" AND date_published>=now-10y AND field_of_study: ((""Medicine"" OR ""Internal medicine"" OR ""Pharmacology"") AND (""Pharmacology"" OR ""Pharmacokinetics"" OR ""Chemistry"" OR ""Biochemistry"" OR ""Pharmacodynamics"" OR ""In vitro"" OR ""Pharmacotherapy"" OR ""Clinical pharmacology""))",AND date_published>=now-10y,"AND field_of_study: ((""Medicine"" OR ""Internal medicine"" OR ""Pharmacology"") AND (""Pharmacology"" OR ""Pharmacokinetics"" OR ""Chemistry"" OR ""Biochemistry"" OR ""Pharmacodynamics"" OR ""In vitro"" OR ""Pharmacotherapy"" OR ""Clinical pharmacology""))",NA,oa_therapy_area,Uni,Pharmacology,2014,6458,1455,1300,275,399,77,3506,2952
pharmacology (primary search + pharmacology tags) - uni,"(author.affiliation.name:(""university of cape town"" OR ""south african college"" OR ""shanghai jiao tong university"" OR ""shanghai communications university"" OR ""fudan university"" OR ""sun yat-sen university"" OR ""zhejiang university"" OR ""chekiang university"" OR ""peking university"" OR ""imperial university of peking"" OR ""capital medical university"" OR ""cmu"" OR ""seoul national university"" OR ""seoul daehakgyo"" OR ""peking union medical college"" OR ""beijing xiehe hospital"" OR ""sichuan university"" OR ""sìchuān dàxué"" OR ""nanjing medical university"" OR ""national jiangsu medical college"" OR ""huazhong university of science and technology"" OR ""huázhōng kējì dàxué"" OR ""university college london"" OR ""london university"" OR ""karolinska institutet"" OR ""royal caroline institute"" OR ""university of oxford"" OR ""oxford university"" OR ""university of copenhagen"" OR ""universität kopenhagen"" OR ""université de paris"" OR ""university of paris"" OR ""king's college london"" OR ""kcl"" OR ""university of amsterdam"" OR ""universiteit van amsterdam"" OR ""imperial college london"" OR ""coleg imperial llundain"" OR ""utrecht university"" OR ""universiteit utrecht"" OR ""heidelberg university"" OR ""ruprecht-karls-universität heidelberg"" OR ""university of milan"" OR ""université de milan"" OR ""erasmus university rotterdam"" OR ""erasmus universiteit rotterdam"" OR ""freie universität berlin"" OR ""free university of berlin"" OR ""university of cambridge"" OR ""cambridge university"" OR ""humboldt-universität zu berlin"" OR ""humboldt university of berlin"" OR ""university of zurich"" OR ""universität zürich"" OR ""tel aviv university"" OR ""harvard university"" OR ""universidad de harvard"" OR ""johns hopkins university"" OR ""jhu"" OR ""university of toronto"" OR ""université de toronto"" OR ""university of pennsylvania"" Or ""upenn"" OR ""university of california, san francisco"" OR ""ucsf"" OR ""duke university"" OR ""Universidad de Duke"" OR ""university of michigan"" OR ""umich"" OR ""stanford university"" OR ""leland stanford junior university"" OR ""university of melbourne"" OR ""melbourne university"" OR ""university of sydney"" OR ""sydney university"" OR ""university of são paulo"" OR ""universidade de são paulo"") OR author.affiliation.ror_id_lineage:(""03p74gp79"" OR ""0220qvk04"" OR ""013q1eq08"" OR ""0064kty71"" OR ""00a2xv884"" OR ""02v51f717"" OR ""013xs5b60"" OR ""04h9pn542"" OR ""04jztag35"" OR ""011ashp19"" OR ""059gcgy73"" OR ""00p991c53"" OR ""02jx3x895"" OR ""056d84691"" OR ""052gg0110"" OR ""035b05819"" OR ""05f82e368"" OR ""0220mzb33"" OR ""04dkp9463"" OR ""041kmwe10"" OR ""04pp8hn57"" OR ""038t36y30"" OR ""00wjc7c48"" OR ""057w15z03"" OR ""046ak2485"" OR ""013meh722"" OR ""01hcx6992"" OR ""02crff812"" OR ""04mhzgx49"" OR ""03vek6s52"" OR ""00za53h95"" OR ""03dbr7087"" OR ""00b30xv10"" OR ""043mz5j54"" OR ""00py81415"" OR ""00jmfr291"" OR ""00f54p054"" OR ""01ej9dk98"" OR ""0384j8v12"" OR ""036rp1748"")) AND publication_type:""journal article"" AND date_published>=now-10y AND field_of_study: ((""Medicine"" OR ""Internal medicine"" OR ""Pharmacology"") AND (""Pharmacology"" OR ""Pharmacokinetics"" OR ""Chemistry"" OR ""Biochemistry"" OR ""Pharmacodynamics"" OR ""In vitro"" OR ""Pharmacotherapy"" OR ""Clinical pharmacology""))",AND date_published>=now-10y,"AND field_of_study: ((""Medicine"" OR ""Internal medicine"" OR ""Pharmacology"") AND (""Pharmacology"" OR ""Pharmacokinetics"" OR ""Chemistry"" OR ""Biochemistry"" OR ""Pharmacodynamics"" OR ""In vitro"" OR ""Pharmacotherapy"" OR ""Clinical pharmacology""))",NA,oa_therapy_area,Uni,Pharmacology,2015,6675,1516,1365,338,424,132,3775,2900
pharmacology (primary search + pharmacology tags) - uni,"(author.affiliation.name:(""university of cape town"" OR ""south african college"" OR ""shanghai jiao tong university"" OR ""shanghai communications university"" OR ""fudan university"" OR ""sun yat-sen university"" OR ""zhejiang university"" OR ""chekiang university"" OR ""peking university"" OR ""imperial university of peking"" OR ""capital medical university"" OR ""cmu"" OR ""seoul national university"" OR ""seoul daehakgyo"" OR ""peking union medical college"" OR ""beijing xiehe hospital"" OR ""sichuan university"" OR ""sìchuān dàxué"" OR ""nanjing medical university"" OR ""national jiangsu medical college"" OR ""huazhong university of science and technology"" OR ""huázhōng kējì dàxué"" OR ""university college london"" OR ""london university"" OR ""karolinska institutet"" OR ""royal caroline institute"" OR ""university of oxford"" OR ""oxford university"" OR ""university of copenhagen"" OR ""universität kopenhagen"" OR ""université de paris"" OR ""university of paris"" OR ""king's college london"" OR ""kcl"" OR ""university of amsterdam"" OR ""universiteit van amsterdam"" OR ""imperial college london"" OR ""coleg imperial llundain"" OR ""utrecht university"" OR ""universiteit utrecht"" OR ""heidelberg university"" OR ""ruprecht-karls-universität heidelberg"" OR ""university of milan"" OR ""université de milan"" OR ""erasmus university rotterdam"" OR ""erasmus universiteit rotterdam"" OR ""freie universität berlin"" OR ""free university of berlin"" OR ""university of cambridge"" OR ""cambridge university"" OR ""humboldt-universität zu berlin"" OR ""humboldt university of berlin"" OR ""university of zurich"" OR ""universität zürich"" OR ""tel aviv university"" OR ""harvard university"" OR ""universidad de harvard"" OR ""johns hopkins university"" OR ""jhu"" OR ""university of toronto"" OR ""université de toronto"" OR ""university of pennsylvania"" Or ""upenn"" OR ""university of california, san francisco"" OR ""ucsf"" OR ""duke university"" OR ""Universidad de Duke"" OR ""university of michigan"" OR ""umich"" OR ""stanford university"" OR ""leland stanford junior university"" OR ""university of melbourne"" OR ""melbourne university"" OR ""university of sydney"" OR ""sydney university"" OR ""university of são paulo"" OR ""universidade de são paulo"") OR author.affiliation.ror_id_lineage:(""03p74gp79"" OR ""0220qvk04"" OR ""013q1eq08"" OR ""0064kty71"" OR ""00a2xv884"" OR ""02v51f717"" OR ""013xs5b60"" OR ""04h9pn542"" OR ""04jztag35"" OR ""011ashp19"" OR ""059gcgy73"" OR ""00p991c53"" OR ""02jx3x895"" OR ""056d84691"" OR ""052gg0110"" OR ""035b05819"" OR ""05f82e368"" OR ""0220mzb33"" OR ""04dkp9463"" OR ""041kmwe10"" OR ""04pp8hn57"" OR ""038t36y30"" OR ""00wjc7c48"" OR ""057w15z03"" OR ""046ak2485"" OR ""013meh722"" OR ""01hcx6992"" OR ""02crff812"" OR ""04mhzgx49"" OR ""03vek6s52"" OR ""00za53h95"" OR ""03dbr7087"" OR ""00b30xv10"" OR ""043mz5j54"" OR ""00py81415"" OR ""00jmfr291"" OR ""00f54p054"" OR ""01ej9dk98"" OR ""0384j8v12"" OR ""036rp1748"")) AND publication_type:""journal article"" AND date_published>=now-10y AND field_of_study: ((""Medicine"" OR ""Internal medicine"" OR ""Pharmacology"") AND (""Pharmacology"" OR ""Pharmacokinetics"" OR ""Chemistry"" OR ""Biochemistry"" OR ""Pharmacodynamics"" OR ""In vitro"" OR ""Pharmacotherapy"" OR ""Clinical pharmacology""))",AND date_published>=now-10y,"AND field_of_study: ((""Medicine"" OR ""Internal medicine"" OR ""Pharmacology"") AND (""Pharmacology"" OR ""Pharmacokinetics"" OR ""Chemistry"" OR ""Biochemistry"" OR ""Pharmacodynamics"" OR ""In vitro"" OR ""Pharmacotherapy"" OR ""Clinical pharmacology""))",NA,oa_therapy_area,Uni,Pharmacology,2016,6853,1765,1396,401,477,95,4134,2719
pharmacology (primary search + pharmacology tags) - uni,"(author.affiliation.name:(""university of cape town"" OR ""south african college"" OR ""shanghai jiao tong university"" OR ""shanghai communications university"" OR ""fudan university"" OR ""sun yat-sen university"" OR ""zhejiang university"" OR ""chekiang university"" OR ""peking university"" OR ""imperial university of peking"" OR ""capital medical university"" OR ""cmu"" OR ""seoul national university"" OR ""seoul daehakgyo"" OR ""peking union medical college"" OR ""beijing xiehe hospital"" OR ""sichuan university"" OR ""sìchuān dàxué"" OR ""nanjing medical university"" OR ""national jiangsu medical college"" OR ""huazhong university of science and technology"" OR ""huázhōng kējì dàxué"" OR ""university college london"" OR ""london university"" OR ""karolinska institutet"" OR ""royal caroline institute"" OR ""university of oxford"" OR ""oxford university"" OR ""university of copenhagen"" OR ""universität kopenhagen"" OR ""université de paris"" OR ""university of paris"" OR ""king's college london"" OR ""kcl"" OR ""university of amsterdam"" OR ""universiteit van amsterdam"" OR ""imperial college london"" OR ""coleg imperial llundain"" OR ""utrecht university"" OR ""universiteit utrecht"" OR ""heidelberg university"" OR ""ruprecht-karls-universität heidelberg"" OR ""university of milan"" OR ""université de milan"" OR ""erasmus university rotterdam"" OR ""erasmus universiteit rotterdam"" OR ""freie universität berlin"" OR ""free university of berlin"" OR ""university of cambridge"" OR ""cambridge university"" OR ""humboldt-universität zu berlin"" OR ""humboldt university of berlin"" OR ""university of zurich"" OR ""universität zürich"" OR ""tel aviv university"" OR ""harvard university"" OR ""universidad de harvard"" OR ""johns hopkins university"" OR ""jhu"" OR ""university of toronto"" OR ""université de toronto"" OR ""university of pennsylvania"" Or ""upenn"" OR ""university of california, san francisco"" OR ""ucsf"" OR ""duke university"" OR ""Universidad de Duke"" OR ""university of michigan"" OR ""umich"" OR ""stanford university"" OR ""leland stanford junior university"" OR ""university of melbourne"" OR ""melbourne university"" OR ""university of sydney"" OR ""sydney university"" OR ""university of são paulo"" OR ""universidade de são paulo"") OR author.affiliation.ror_id_lineage:(""03p74gp79"" OR ""0220qvk04"" OR ""013q1eq08"" OR ""0064kty71"" OR ""00a2xv884"" OR ""02v51f717"" OR ""013xs5b60"" OR ""04h9pn542"" OR ""04jztag35"" OR ""011ashp19"" OR ""059gcgy73"" OR ""00p991c53"" OR ""02jx3x895"" OR ""056d84691"" OR ""052gg0110"" OR ""035b05819"" OR ""05f82e368"" OR ""0220mzb33"" OR ""04dkp9463"" OR ""041kmwe10"" OR ""04pp8hn57"" OR ""038t36y30"" OR ""00wjc7c48"" OR ""057w15z03"" OR ""046ak2485"" OR ""013meh722"" OR ""01hcx6992"" OR ""02crff812"" OR ""04mhzgx49"" OR ""03vek6s52"" OR ""00za53h95"" OR ""03dbr7087"" OR ""00b30xv10"" OR ""043mz5j54"" OR ""00py81415"" OR ""00jmfr291"" OR ""00f54p054"" OR ""01ej9dk98"" OR ""0384j8v12"" OR ""036rp1748"")) AND publication_type:""journal article"" AND date_published>=now-10y AND field_of_study: ((""Medicine"" OR ""Internal medicine"" OR ""Pharmacology"") AND (""Pharmacology"" OR ""Pharmacokinetics"" OR ""Chemistry"" OR ""Biochemistry"" OR ""Pharmacodynamics"" OR ""In vitro"" OR ""Pharmacotherapy"" OR ""Clinical pharmacology""))",AND date_published>=now-10y,"AND field_of_study: ((""Medicine"" OR ""Internal medicine"" OR ""Pharmacology"") AND (""Pharmacology"" OR ""Pharmacokinetics"" OR ""Chemistry"" OR ""Biochemistry"" OR ""Pharmacodynamics"" OR ""In vitro"" OR ""Pharmacotherapy"" OR ""Clinical pharmacology""))",NA,oa_therapy_area,Uni,Pharmacology,2017,7357,2166,1438,488,482,114,4688,2669
pharmacology (primary search + pharmacology tags) - uni,"(author.affiliation.name:(""university of cape town"" OR ""south african college"" OR ""shanghai jiao tong university"" OR ""shanghai communications university"" OR ""fudan university"" OR ""sun yat-sen university"" OR ""zhejiang university"" OR ""chekiang university"" OR ""peking university"" OR ""imperial university of peking"" OR ""capital medical university"" OR ""cmu"" OR ""seoul national university"" OR ""seoul daehakgyo"" OR ""peking union medical college"" OR ""beijing xiehe hospital"" OR ""sichuan university"" OR ""sìchuān dàxué"" OR ""nanjing medical university"" OR ""national jiangsu medical college"" OR ""huazhong university of science and technology"" OR ""huázhōng kējì dàxué"" OR ""university college london"" OR ""london university"" OR ""karolinska institutet"" OR ""royal caroline institute"" OR ""university of oxford"" OR ""oxford university"" OR ""university of copenhagen"" OR ""universität kopenhagen"" OR ""université de paris"" OR ""university of paris"" OR ""king's college london"" OR ""kcl"" OR ""university of amsterdam"" OR ""universiteit van amsterdam"" OR ""imperial college london"" OR ""coleg imperial llundain"" OR ""utrecht university"" OR ""universiteit utrecht"" OR ""heidelberg university"" OR ""ruprecht-karls-universität heidelberg"" OR ""university of milan"" OR ""université de milan"" OR ""erasmus university rotterdam"" OR ""erasmus universiteit rotterdam"" OR ""freie universität berlin"" OR ""free university of berlin"" OR ""university of cambridge"" OR ""cambridge university"" OR ""humboldt-universität zu berlin"" OR ""humboldt university of berlin"" OR ""university of zurich"" OR ""universität zürich"" OR ""tel aviv university"" OR ""harvard university"" OR ""universidad de harvard"" OR ""johns hopkins university"" OR ""jhu"" OR ""university of toronto"" OR ""université de toronto"" OR ""university of pennsylvania"" Or ""upenn"" OR ""university of california, san francisco"" OR ""ucsf"" OR ""duke university"" OR ""Universidad de Duke"" OR ""university of michigan"" OR ""umich"" OR ""stanford university"" OR ""leland stanford junior university"" OR ""university of melbourne"" OR ""melbourne university"" OR ""university of sydney"" OR ""sydney university"" OR ""university of são paulo"" OR ""universidade de são paulo"") OR author.affiliation.ror_id_lineage:(""03p74gp79"" OR ""0220qvk04"" OR ""013q1eq08"" OR ""0064kty71"" OR ""00a2xv884"" OR ""02v51f717"" OR ""013xs5b60"" OR ""04h9pn542"" OR ""04jztag35"" OR ""011ashp19"" OR ""059gcgy73"" OR ""00p991c53"" OR ""02jx3x895"" OR ""056d84691"" OR ""052gg0110"" OR ""035b05819"" OR ""05f82e368"" OR ""0220mzb33"" OR ""04dkp9463"" OR ""041kmwe10"" OR ""04pp8hn57"" OR ""038t36y30"" OR ""00wjc7c48"" OR ""057w15z03"" OR ""046ak2485"" OR ""013meh722"" OR ""01hcx6992"" OR ""02crff812"" OR ""04mhzgx49"" OR ""03vek6s52"" OR ""00za53h95"" OR ""03dbr7087"" OR ""00b30xv10"" OR ""043mz5j54"" OR ""00py81415"" OR ""00jmfr291"" OR ""00f54p054"" OR ""01ej9dk98"" OR ""0384j8v12"" OR ""036rp1748"")) AND publication_type:""journal article"" AND date_published>=now-10y AND field_of_study: ((""Medicine"" OR ""Internal medicine"" OR ""Pharmacology"") AND (""Pharmacology"" OR ""Pharmacokinetics"" OR ""Chemistry"" OR ""Biochemistry"" OR ""Pharmacodynamics"" OR ""In vitro"" OR ""Pharmacotherapy"" OR ""Clinical pharmacology""))",AND date_published>=now-10y,"AND field_of_study: ((""Medicine"" OR ""Internal medicine"" OR ""Pharmacology"") AND (""Pharmacology"" OR ""Pharmacokinetics"" OR ""Chemistry"" OR ""Biochemistry"" OR ""Pharmacodynamics"" OR ""In vitro"" OR ""Pharmacotherapy"" OR ""Clinical pharmacology""))",NA,oa_therapy_area,Uni,Pharmacology,2018,6378,1932,1138,493,447,103,4113,2265
pharmacology (primary search + pharmacology tags) - uni,"(author.affiliation.name:(""university of cape town"" OR ""south african college"" OR ""shanghai jiao tong university"" OR ""shanghai communications university"" OR ""fudan university"" OR ""sun yat-sen university"" OR ""zhejiang university"" OR ""chekiang university"" OR ""peking university"" OR ""imperial university of peking"" OR ""capital medical university"" OR ""cmu"" OR ""seoul national university"" OR ""seoul daehakgyo"" OR ""peking union medical college"" OR ""beijing xiehe hospital"" OR ""sichuan university"" OR ""sìchuān dàxué"" OR ""nanjing medical university"" OR ""national jiangsu medical college"" OR ""huazhong university of science and technology"" OR ""huázhōng kējì dàxué"" OR ""university college london"" OR ""london university"" OR ""karolinska institutet"" OR ""royal caroline institute"" OR ""university of oxford"" OR ""oxford university"" OR ""university of copenhagen"" OR ""universität kopenhagen"" OR ""université de paris"" OR ""university of paris"" OR ""king's college london"" OR ""kcl"" OR ""university of amsterdam"" OR ""universiteit van amsterdam"" OR ""imperial college london"" OR ""coleg imperial llundain"" OR ""utrecht university"" OR ""universiteit utrecht"" OR ""heidelberg university"" OR ""ruprecht-karls-universität heidelberg"" OR ""university of milan"" OR ""université de milan"" OR ""erasmus university rotterdam"" OR ""erasmus universiteit rotterdam"" OR ""freie universität berlin"" OR ""free university of berlin"" OR ""university of cambridge"" OR ""cambridge university"" OR ""humboldt-universität zu berlin"" OR ""humboldt university of berlin"" OR ""university of zurich"" OR ""universität zürich"" OR ""tel aviv university"" OR ""harvard university"" OR ""universidad de harvard"" OR ""johns hopkins university"" OR ""jhu"" OR ""university of toronto"" OR ""université de toronto"" OR ""university of pennsylvania"" Or ""upenn"" OR ""university of california, san francisco"" OR ""ucsf"" OR ""duke university"" OR ""Universidad de Duke"" OR ""university of michigan"" OR ""umich"" OR ""stanford university"" OR ""leland stanford junior university"" OR ""university of melbourne"" OR ""melbourne university"" OR ""university of sydney"" OR ""sydney university"" OR ""university of são paulo"" OR ""universidade de são paulo"") OR author.affiliation.ror_id_lineage:(""03p74gp79"" OR ""0220qvk04"" OR ""013q1eq08"" OR ""0064kty71"" OR ""00a2xv884"" OR ""02v51f717"" OR ""013xs5b60"" OR ""04h9pn542"" OR ""04jztag35"" OR ""011ashp19"" OR ""059gcgy73"" OR ""00p991c53"" OR ""02jx3x895"" OR ""056d84691"" OR ""052gg0110"" OR ""035b05819"" OR ""05f82e368"" OR ""0220mzb33"" OR ""04dkp9463"" OR ""041kmwe10"" OR ""04pp8hn57"" OR ""038t36y30"" OR ""00wjc7c48"" OR ""057w15z03"" OR ""046ak2485"" OR ""013meh722"" OR ""01hcx6992"" OR ""02crff812"" OR ""04mhzgx49"" OR ""03vek6s52"" OR ""00za53h95"" OR ""03dbr7087"" OR ""00b30xv10"" OR ""043mz5j54"" OR ""00py81415"" OR ""00jmfr291"" OR ""00f54p054"" OR ""01ej9dk98"" OR ""0384j8v12"" OR ""036rp1748"")) AND publication_type:""journal article"" AND date_published>=now-10y AND field_of_study: ((""Medicine"" OR ""Internal medicine"" OR ""Pharmacology"") AND (""Pharmacology"" OR ""Pharmacokinetics"" OR ""Chemistry"" OR ""Biochemistry"" OR ""Pharmacodynamics"" OR ""In vitro"" OR ""Pharmacotherapy"" OR ""Clinical pharmacology""))",AND date_published>=now-10y,"AND field_of_study: ((""Medicine"" OR ""Internal medicine"" OR ""Pharmacology"") AND (""Pharmacology"" OR ""Pharmacokinetics"" OR ""Chemistry"" OR ""Biochemistry"" OR ""Pharmacodynamics"" OR ""In vitro"" OR ""Pharmacotherapy"" OR ""Clinical pharmacology""))",NA,oa_therapy_area,Uni,Pharmacology,2019,6694,2139,1076,559,400,102,4276,2418
pharmacology (primary search + pharmacology tags) - uni,"(author.affiliation.name:(""university of cape town"" OR ""south african college"" OR ""shanghai jiao tong university"" OR ""shanghai communications university"" OR ""fudan university"" OR ""sun yat-sen university"" OR ""zhejiang university"" OR ""chekiang university"" OR ""peking university"" OR ""imperial university of peking"" OR ""capital medical university"" OR ""cmu"" OR ""seoul national university"" OR ""seoul daehakgyo"" OR ""peking union medical college"" OR ""beijing xiehe hospital"" OR ""sichuan university"" OR ""sìchuān dàxué"" OR ""nanjing medical university"" OR ""national jiangsu medical college"" OR ""huazhong university of science and technology"" OR ""huázhōng kējì dàxué"" OR ""university college london"" OR ""london university"" OR ""karolinska institutet"" OR ""royal caroline institute"" OR ""university of oxford"" OR ""oxford university"" OR ""university of copenhagen"" OR ""universität kopenhagen"" OR ""université de paris"" OR ""university of paris"" OR ""king's college london"" OR ""kcl"" OR ""university of amsterdam"" OR ""universiteit van amsterdam"" OR ""imperial college london"" OR ""coleg imperial llundain"" OR ""utrecht university"" OR ""universiteit utrecht"" OR ""heidelberg university"" OR ""ruprecht-karls-universität heidelberg"" OR ""university of milan"" OR ""université de milan"" OR ""erasmus university rotterdam"" OR ""erasmus universiteit rotterdam"" OR ""freie universität berlin"" OR ""free university of berlin"" OR ""university of cambridge"" OR ""cambridge university"" OR ""humboldt-universität zu berlin"" OR ""humboldt university of berlin"" OR ""university of zurich"" OR ""universität zürich"" OR ""tel aviv university"" OR ""harvard university"" OR ""universidad de harvard"" OR ""johns hopkins university"" OR ""jhu"" OR ""university of toronto"" OR ""université de toronto"" OR ""university of pennsylvania"" Or ""upenn"" OR ""university of california, san francisco"" OR ""ucsf"" OR ""duke university"" OR ""Universidad de Duke"" OR ""university of michigan"" OR ""umich"" OR ""stanford university"" OR ""leland stanford junior university"" OR ""university of melbourne"" OR ""melbourne university"" OR ""university of sydney"" OR ""sydney university"" OR ""university of são paulo"" OR ""universidade de são paulo"") OR author.affiliation.ror_id_lineage:(""03p74gp79"" OR ""0220qvk04"" OR ""013q1eq08"" OR ""0064kty71"" OR ""00a2xv884"" OR ""02v51f717"" OR ""013xs5b60"" OR ""04h9pn542"" OR ""04jztag35"" OR ""011ashp19"" OR ""059gcgy73"" OR ""00p991c53"" OR ""02jx3x895"" OR ""056d84691"" OR ""052gg0110"" OR ""035b05819"" OR ""05f82e368"" OR ""0220mzb33"" OR ""04dkp9463"" OR ""041kmwe10"" OR ""04pp8hn57"" OR ""038t36y30"" OR ""00wjc7c48"" OR ""057w15z03"" OR ""046ak2485"" OR ""013meh722"" OR ""01hcx6992"" OR ""02crff812"" OR ""04mhzgx49"" OR ""03vek6s52"" OR ""00za53h95"" OR ""03dbr7087"" OR ""00b30xv10"" OR ""043mz5j54"" OR ""00py81415"" OR ""00jmfr291"" OR ""00f54p054"" OR ""01ej9dk98"" OR ""0384j8v12"" OR ""036rp1748"")) AND publication_type:""journal article"" AND date_published>=now-10y AND field_of_study: ((""Medicine"" OR ""Internal medicine"" OR ""Pharmacology"") AND (""Pharmacology"" OR ""Pharmacokinetics"" OR ""Chemistry"" OR ""Biochemistry"" OR ""Pharmacodynamics"" OR ""In vitro"" OR ""Pharmacotherapy"" OR ""Clinical pharmacology""))",AND date_published>=now-10y,"AND field_of_study: ((""Medicine"" OR ""Internal medicine"" OR ""Pharmacology"") AND (""Pharmacology"" OR ""Pharmacokinetics"" OR ""Chemistry"" OR ""Biochemistry"" OR ""Pharmacodynamics"" OR ""In vitro"" OR ""Pharmacotherapy"" OR ""Clinical pharmacology""))",NA,oa_therapy_area,Uni,Pharmacology,2020,7594,2717,1105,687,389,131,5029,2565
pharmacology (primary search + pharmacology tags) - uni,"(author.affiliation.name:(""university of cape town"" OR ""south african college"" OR ""shanghai jiao tong university"" OR ""shanghai communications university"" OR ""fudan university"" OR ""sun yat-sen university"" OR ""zhejiang university"" OR ""chekiang university"" OR ""peking university"" OR ""imperial university of peking"" OR ""capital medical university"" OR ""cmu"" OR ""seoul national university"" OR ""seoul daehakgyo"" OR ""peking union medical college"" OR ""beijing xiehe hospital"" OR ""sichuan university"" OR ""sìchuān dàxué"" OR ""nanjing medical university"" OR ""national jiangsu medical college"" OR ""huazhong university of science and technology"" OR ""huázhōng kējì dàxué"" OR ""university college london"" OR ""london university"" OR ""karolinska institutet"" OR ""royal caroline institute"" OR ""university of oxford"" OR ""oxford university"" OR ""university of copenhagen"" OR ""universität kopenhagen"" OR ""université de paris"" OR ""university of paris"" OR ""king's college london"" OR ""kcl"" OR ""university of amsterdam"" OR ""universiteit van amsterdam"" OR ""imperial college london"" OR ""coleg imperial llundain"" OR ""utrecht university"" OR ""universiteit utrecht"" OR ""heidelberg university"" OR ""ruprecht-karls-universität heidelberg"" OR ""university of milan"" OR ""université de milan"" OR ""erasmus university rotterdam"" OR ""erasmus universiteit rotterdam"" OR ""freie universität berlin"" OR ""free university of berlin"" OR ""university of cambridge"" OR ""cambridge university"" OR ""humboldt-universität zu berlin"" OR ""humboldt university of berlin"" OR ""university of zurich"" OR ""universität zürich"" OR ""tel aviv university"" OR ""harvard university"" OR ""universidad de harvard"" OR ""johns hopkins university"" OR ""jhu"" OR ""university of toronto"" OR ""université de toronto"" OR ""university of pennsylvania"" Or ""upenn"" OR ""university of california, san francisco"" OR ""ucsf"" OR ""duke university"" OR ""Universidad de Duke"" OR ""university of michigan"" OR ""umich"" OR ""stanford university"" OR ""leland stanford junior university"" OR ""university of melbourne"" OR ""melbourne university"" OR ""university of sydney"" OR ""sydney university"" OR ""university of são paulo"" OR ""universidade de são paulo"") OR author.affiliation.ror_id_lineage:(""03p74gp79"" OR ""0220qvk04"" OR ""013q1eq08"" OR ""0064kty71"" OR ""00a2xv884"" OR ""02v51f717"" OR ""013xs5b60"" OR ""04h9pn542"" OR ""04jztag35"" OR ""011ashp19"" OR ""059gcgy73"" OR ""00p991c53"" OR ""02jx3x895"" OR ""056d84691"" OR ""052gg0110"" OR ""035b05819"" OR ""05f82e368"" OR ""0220mzb33"" OR ""04dkp9463"" OR ""041kmwe10"" OR ""04pp8hn57"" OR ""038t36y30"" OR ""00wjc7c48"" OR ""057w15z03"" OR ""046ak2485"" OR ""013meh722"" OR ""01hcx6992"" OR ""02crff812"" OR ""04mhzgx49"" OR ""03vek6s52"" OR ""00za53h95"" OR ""03dbr7087"" OR ""00b30xv10"" OR ""043mz5j54"" OR ""00py81415"" OR ""00jmfr291"" OR ""00f54p054"" OR ""01ej9dk98"" OR ""0384j8v12"" OR ""036rp1748"")) AND publication_type:""journal article"" AND date_published>=now-10y AND field_of_study: ((""Medicine"" OR ""Internal medicine"" OR ""Pharmacology"") AND (""Pharmacology"" OR ""Pharmacokinetics"" OR ""Chemistry"" OR ""Biochemistry"" OR ""Pharmacodynamics"" OR ""In vitro"" OR ""Pharmacotherapy"" OR ""Clinical pharmacology""))",AND date_published>=now-10y,"AND field_of_study: ((""Medicine"" OR ""Internal medicine"" OR ""Pharmacology"") AND (""Pharmacology"" OR ""Pharmacokinetics"" OR ""Chemistry"" OR ""Biochemistry"" OR ""Pharmacodynamics"" OR ""In vitro"" OR ""Pharmacotherapy"" OR ""Clinical pharmacology""))",NA,oa_therapy_area,Uni,Pharmacology,2021,10091,4254,708,1012,539,467,6980,3111
pharmacology (primary search + pharmacology tags) - uni,"(author.affiliation.name:(""university of cape town"" OR ""south african college"" OR ""shanghai jiao tong university"" OR ""shanghai communications university"" OR ""fudan university"" OR ""sun yat-sen university"" OR ""zhejiang university"" OR ""chekiang university"" OR ""peking university"" OR ""imperial university of peking"" OR ""capital medical university"" OR ""cmu"" OR ""seoul national university"" OR ""seoul daehakgyo"" OR ""peking union medical college"" OR ""beijing xiehe hospital"" OR ""sichuan university"" OR ""sìchuān dàxué"" OR ""nanjing medical university"" OR ""national jiangsu medical college"" OR ""huazhong university of science and technology"" OR ""huázhōng kējì dàxué"" OR ""university college london"" OR ""london university"" OR ""karolinska institutet"" OR ""royal caroline institute"" OR ""university of oxford"" OR ""oxford university"" OR ""university of copenhagen"" OR ""universität kopenhagen"" OR ""université de paris"" OR ""university of paris"" OR ""king's college london"" OR ""kcl"" OR ""university of amsterdam"" OR ""universiteit van amsterdam"" OR ""imperial college london"" OR ""coleg imperial llundain"" OR ""utrecht university"" OR ""universiteit utrecht"" OR ""heidelberg university"" OR ""ruprecht-karls-universität heidelberg"" OR ""university of milan"" OR ""université de milan"" OR ""erasmus university rotterdam"" OR ""erasmus universiteit rotterdam"" OR ""freie universität berlin"" OR ""free university of berlin"" OR ""university of cambridge"" OR ""cambridge university"" OR ""humboldt-universität zu berlin"" OR ""humboldt university of berlin"" OR ""university of zurich"" OR ""universität zürich"" OR ""tel aviv university"" OR ""harvard university"" OR ""universidad de harvard"" OR ""johns hopkins university"" OR ""jhu"" OR ""university of toronto"" OR ""université de toronto"" OR ""university of pennsylvania"" Or ""upenn"" OR ""university of california, san francisco"" OR ""ucsf"" OR ""duke university"" OR ""Universidad de Duke"" OR ""university of michigan"" OR ""umich"" OR ""stanford university"" OR ""leland stanford junior university"" OR ""university of melbourne"" OR ""melbourne university"" OR ""university of sydney"" OR ""sydney university"" OR ""university of são paulo"" OR ""universidade de são paulo"") OR author.affiliation.ror_id_lineage:(""03p74gp79"" OR ""0220qvk04"" OR ""013q1eq08"" OR ""0064kty71"" OR ""00a2xv884"" OR ""02v51f717"" OR ""013xs5b60"" OR ""04h9pn542"" OR ""04jztag35"" OR ""011ashp19"" OR ""059gcgy73"" OR ""00p991c53"" OR ""02jx3x895"" OR ""056d84691"" OR ""052gg0110"" OR ""035b05819"" OR ""05f82e368"" OR ""0220mzb33"" OR ""04dkp9463"" OR ""041kmwe10"" OR ""04pp8hn57"" OR ""038t36y30"" OR ""00wjc7c48"" OR ""057w15z03"" OR ""046ak2485"" OR ""013meh722"" OR ""01hcx6992"" OR ""02crff812"" OR ""04mhzgx49"" OR ""03vek6s52"" OR ""00za53h95"" OR ""03dbr7087"" OR ""00b30xv10"" OR ""043mz5j54"" OR ""00py81415"" OR ""00jmfr291"" OR ""00f54p054"" OR ""01ej9dk98"" OR ""0384j8v12"" OR ""036rp1748"")) AND publication_type:""journal article"" AND date_published>=now-10y AND field_of_study: ((""Medicine"" OR ""Internal medicine"" OR ""Pharmacology"") AND (""Pharmacology"" OR ""Pharmacokinetics"" OR ""Chemistry"" OR ""Biochemistry"" OR ""Pharmacodynamics"" OR ""In vitro"" OR ""Pharmacotherapy"" OR ""Clinical pharmacology""))",AND date_published>=now-10y,"AND field_of_study: ((""Medicine"" OR ""Internal medicine"" OR ""Pharmacology"") AND (""Pharmacology"" OR ""Pharmacokinetics"" OR ""Chemistry"" OR ""Biochemistry"" OR ""Pharmacodynamics"" OR ""In vitro"" OR ""Pharmacotherapy"" OR ""Clinical pharmacology""))",NA,oa_therapy_area,Uni,Pharmacology,2022,37567,17305,2128,3493,1241,901,25068,12499
pharmacology (primary search + pharmacology tags) - uni,"(author.affiliation.name:(""university of cape town"" OR ""south african college"" OR ""shanghai jiao tong university"" OR ""shanghai communications university"" OR ""fudan university"" OR ""sun yat-sen university"" OR ""zhejiang university"" OR ""chekiang university"" OR ""peking university"" OR ""imperial university of peking"" OR ""capital medical university"" OR ""cmu"" OR ""seoul national university"" OR ""seoul daehakgyo"" OR ""peking union medical college"" OR ""beijing xiehe hospital"" OR ""sichuan university"" OR ""sìchuān dàxué"" OR ""nanjing medical university"" OR ""national jiangsu medical college"" OR ""huazhong university of science and technology"" OR ""huázhōng kējì dàxué"" OR ""university college london"" OR ""london university"" OR ""karolinska institutet"" OR ""royal caroline institute"" OR ""university of oxford"" OR ""oxford university"" OR ""university of copenhagen"" OR ""universität kopenhagen"" OR ""université de paris"" OR ""university of paris"" OR ""king's college london"" OR ""kcl"" OR ""university of amsterdam"" OR ""universiteit van amsterdam"" OR ""imperial college london"" OR ""coleg imperial llundain"" OR ""utrecht university"" OR ""universiteit utrecht"" OR ""heidelberg university"" OR ""ruprecht-karls-universität heidelberg"" OR ""university of milan"" OR ""université de milan"" OR ""erasmus university rotterdam"" OR ""erasmus universiteit rotterdam"" OR ""freie universität berlin"" OR ""free university of berlin"" OR ""university of cambridge"" OR ""cambridge university"" OR ""humboldt-universität zu berlin"" OR ""humboldt university of berlin"" OR ""university of zurich"" OR ""universität zürich"" OR ""tel aviv university"" OR ""harvard university"" OR ""universidad de harvard"" OR ""johns hopkins university"" OR ""jhu"" OR ""university of toronto"" OR ""université de toronto"" OR ""university of pennsylvania"" Or ""upenn"" OR ""university of california, san francisco"" OR ""ucsf"" OR ""duke university"" OR ""Universidad de Duke"" OR ""university of michigan"" OR ""umich"" OR ""stanford university"" OR ""leland stanford junior university"" OR ""university of melbourne"" OR ""melbourne university"" OR ""university of sydney"" OR ""sydney university"" OR ""university of são paulo"" OR ""universidade de são paulo"") OR author.affiliation.ror_id_lineage:(""03p74gp79"" OR ""0220qvk04"" OR ""013q1eq08"" OR ""0064kty71"" OR ""00a2xv884"" OR ""02v51f717"" OR ""013xs5b60"" OR ""04h9pn542"" OR ""04jztag35"" OR ""011ashp19"" OR ""059gcgy73"" OR ""00p991c53"" OR ""02jx3x895"" OR ""056d84691"" OR ""052gg0110"" OR ""035b05819"" OR ""05f82e368"" OR ""0220mzb33"" OR ""04dkp9463"" OR ""041kmwe10"" OR ""04pp8hn57"" OR ""038t36y30"" OR ""00wjc7c48"" OR ""057w15z03"" OR ""046ak2485"" OR ""013meh722"" OR ""01hcx6992"" OR ""02crff812"" OR ""04mhzgx49"" OR ""03vek6s52"" OR ""00za53h95"" OR ""03dbr7087"" OR ""00b30xv10"" OR ""043mz5j54"" OR ""00py81415"" OR ""00jmfr291"" OR ""00f54p054"" OR ""01ej9dk98"" OR ""0384j8v12"" OR ""036rp1748"")) AND publication_type:""journal article"" AND date_published>=now-10y AND field_of_study: ((""Medicine"" OR ""Internal medicine"" OR ""Pharmacology"") AND (""Pharmacology"" OR ""Pharmacokinetics"" OR ""Chemistry"" OR ""Biochemistry"" OR ""Pharmacodynamics"" OR ""In vitro"" OR ""Pharmacotherapy"" OR ""Clinical pharmacology""))",AND date_published>=now-10y,"AND field_of_study: ((""Medicine"" OR ""Internal medicine"" OR ""Pharmacology"") AND (""Pharmacology"" OR ""Pharmacokinetics"" OR ""Chemistry"" OR ""Biochemistry"" OR ""Pharmacodynamics"" OR ""In vitro"" OR ""Pharmacotherapy"" OR ""Clinical pharmacology""))",NA,oa_therapy_area,Uni,Pharmacology,2023,14556,6278,294,1348,284,821,9025,5531
immunology (primary search + immunology tags) - uni,"(author.affiliation.name:(""university of cape town"" OR ""south african college"" OR ""shanghai jiao tong university"" OR ""shanghai communications university"" OR ""fudan university"" OR ""sun yat-sen university"" OR ""zhejiang university"" OR ""chekiang university"" OR ""peking university"" OR ""imperial university of peking"" OR ""capital medical university"" OR ""cmu"" OR ""seoul national university"" OR ""seoul daehakgyo"" OR ""peking union medical college"" OR ""beijing xiehe hospital"" OR ""sichuan university"" OR ""sìchuān dàxué"" OR ""nanjing medical university"" OR ""national jiangsu medical college"" OR ""huazhong university of science and technology"" OR ""huázhōng kējì dàxué"" OR ""university college london"" OR ""london university"" OR ""karolinska institutet"" OR ""royal caroline institute"" OR ""university of oxford"" OR ""oxford university"" OR ""university of copenhagen"" OR ""universität kopenhagen"" OR ""université de paris"" OR ""university of paris"" OR ""king's college london"" OR ""kcl"" OR ""university of amsterdam"" OR ""universiteit van amsterdam"" OR ""imperial college london"" OR ""coleg imperial llundain"" OR ""utrecht university"" OR ""universiteit utrecht"" OR ""heidelberg university"" OR ""ruprecht-karls-universität heidelberg"" OR ""university of milan"" OR ""université de milan"" OR ""erasmus university rotterdam"" OR ""erasmus universiteit rotterdam"" OR ""freie universität berlin"" OR ""free university of berlin"" OR ""university of cambridge"" OR ""cambridge university"" OR ""humboldt-universität zu berlin"" OR ""humboldt university of berlin"" OR ""university of zurich"" OR ""universität zürich"" OR ""tel aviv university"" OR ""harvard university"" OR ""universidad de harvard"" OR ""johns hopkins university"" OR ""jhu"" OR ""university of toronto"" OR ""université de toronto"" OR ""university of pennsylvania"" Or ""upenn"" OR ""university of california, san francisco"" OR ""ucsf"" OR ""duke university"" OR ""Universidad de Duke"" OR ""university of michigan"" OR ""umich"" OR ""stanford university"" OR ""leland stanford junior university"" OR ""university of melbourne"" OR ""melbourne university"" OR ""university of sydney"" OR ""sydney university"" OR ""university of são paulo"" OR ""universidade de são paulo"") OR author.affiliation.ror_id_lineage:(""03p74gp79"" OR ""0220qvk04"" OR ""013q1eq08"" OR ""0064kty71"" OR ""00a2xv884"" OR ""02v51f717"" OR ""013xs5b60"" OR ""04h9pn542"" OR ""04jztag35"" OR ""011ashp19"" OR ""059gcgy73"" OR ""00p991c53"" OR ""02jx3x895"" OR ""056d84691"" OR ""052gg0110"" OR ""035b05819"" OR ""05f82e368"" OR ""0220mzb33"" OR ""04dkp9463"" OR ""041kmwe10"" OR ""04pp8hn57"" OR ""038t36y30"" OR ""00wjc7c48"" OR ""057w15z03"" OR ""046ak2485"" OR ""013meh722"" OR ""01hcx6992"" OR ""02crff812"" OR ""04mhzgx49"" OR ""03vek6s52"" OR ""00za53h95"" OR ""03dbr7087"" OR ""00b30xv10"" OR ""043mz5j54"" OR ""00py81415"" OR ""00jmfr291"" OR ""00f54p054"" OR ""01ej9dk98"" OR ""0384j8v12"" OR ""036rp1748"")) AND publication_type:""journal article"" AND date_published>=now-10y AND field_of_study: ((""Medicine"" OR ""Internal medicine"" OR ""Pharmacology"") AND (""Immunology"" OR ""Rheumatoid arthritis"" OR ""Immune system"" OR ""Inflammation"" OR ""Psoriatic arthritis"" OR ""Psoriasis"" OR ""Rheumatology"" OR ""Arthritis"" OR ""T cell"" OR ""Ankylosing spondylitis"" OR ""Cytotoxic T cell"" OR ""Proinflammatory cytokine"" OR ""Autoimmune disease""))",AND date_published>=now-10y,"AND field_of_study: ((""Medicine"" OR ""Internal medicine"" OR ""Pharmacology"") AND (""Immunology"" OR ""Rheumatoid arthritis"" OR ""Immune system"" OR ""Inflammation"" OR ""Psoriatic arthritis"" OR ""Psoriasis"" OR ""Rheumatology"" OR ""Arthritis"" OR ""T cell"" OR ""Ankylosing spondylitis"" OR ""Cytotoxic T cell"" OR ""Proinflammatory cytokine"" OR ""Autoimmune disease""))",NA,oa_therapy_area,Uni,Immunology,2013,3359,890,656,163,211,37,1957,1402
immunology (primary search + immunology tags) - uni,"(author.affiliation.name:(""university of cape town"" OR ""south african college"" OR ""shanghai jiao tong university"" OR ""shanghai communications university"" OR ""fudan university"" OR ""sun yat-sen university"" OR ""zhejiang university"" OR ""chekiang university"" OR ""peking university"" OR ""imperial university of peking"" OR ""capital medical university"" OR ""cmu"" OR ""seoul national university"" OR ""seoul daehakgyo"" OR ""peking union medical college"" OR ""beijing xiehe hospital"" OR ""sichuan university"" OR ""sìchuān dàxué"" OR ""nanjing medical university"" OR ""national jiangsu medical college"" OR ""huazhong university of science and technology"" OR ""huázhōng kējì dàxué"" OR ""university college london"" OR ""london university"" OR ""karolinska institutet"" OR ""royal caroline institute"" OR ""university of oxford"" OR ""oxford university"" OR ""university of copenhagen"" OR ""universität kopenhagen"" OR ""université de paris"" OR ""university of paris"" OR ""king's college london"" OR ""kcl"" OR ""university of amsterdam"" OR ""universiteit van amsterdam"" OR ""imperial college london"" OR ""coleg imperial llundain"" OR ""utrecht university"" OR ""universiteit utrecht"" OR ""heidelberg university"" OR ""ruprecht-karls-universität heidelberg"" OR ""university of milan"" OR ""université de milan"" OR ""erasmus university rotterdam"" OR ""erasmus universiteit rotterdam"" OR ""freie universität berlin"" OR ""free university of berlin"" OR ""university of cambridge"" OR ""cambridge university"" OR ""humboldt-universität zu berlin"" OR ""humboldt university of berlin"" OR ""university of zurich"" OR ""universität zürich"" OR ""tel aviv university"" OR ""harvard university"" OR ""universidad de harvard"" OR ""johns hopkins university"" OR ""jhu"" OR ""university of toronto"" OR ""université de toronto"" OR ""university of pennsylvania"" Or ""upenn"" OR ""university of california, san francisco"" OR ""ucsf"" OR ""duke university"" OR ""Universidad de Duke"" OR ""university of michigan"" OR ""umich"" OR ""stanford university"" OR ""leland stanford junior university"" OR ""university of melbourne"" OR ""melbourne university"" OR ""university of sydney"" OR ""sydney university"" OR ""university of são paulo"" OR ""universidade de são paulo"") OR author.affiliation.ror_id_lineage:(""03p74gp79"" OR ""0220qvk04"" OR ""013q1eq08"" OR ""0064kty71"" OR ""00a2xv884"" OR ""02v51f717"" OR ""013xs5b60"" OR ""04h9pn542"" OR ""04jztag35"" OR ""011ashp19"" OR ""059gcgy73"" OR ""00p991c53"" OR ""02jx3x895"" OR ""056d84691"" OR ""052gg0110"" OR ""035b05819"" OR ""05f82e368"" OR ""0220mzb33"" OR ""04dkp9463"" OR ""041kmwe10"" OR ""04pp8hn57"" OR ""038t36y30"" OR ""00wjc7c48"" OR ""057w15z03"" OR ""046ak2485"" OR ""013meh722"" OR ""01hcx6992"" OR ""02crff812"" OR ""04mhzgx49"" OR ""03vek6s52"" OR ""00za53h95"" OR ""03dbr7087"" OR ""00b30xv10"" OR ""043mz5j54"" OR ""00py81415"" OR ""00jmfr291"" OR ""00f54p054"" OR ""01ej9dk98"" OR ""0384j8v12"" OR ""036rp1748"")) AND publication_type:""journal article"" AND date_published>=now-10y AND field_of_study: ((""Medicine"" OR ""Internal medicine"" OR ""Pharmacology"") AND (""Immunology"" OR ""Rheumatoid arthritis"" OR ""Immune system"" OR ""Inflammation"" OR ""Psoriatic arthritis"" OR ""Psoriasis"" OR ""Rheumatology"" OR ""Arthritis"" OR ""T cell"" OR ""Ankylosing spondylitis"" OR ""Cytotoxic T cell"" OR ""Proinflammatory cytokine"" OR ""Autoimmune disease""))",AND date_published>=now-10y,"AND field_of_study: ((""Medicine"" OR ""Internal medicine"" OR ""Pharmacology"") AND (""Immunology"" OR ""Rheumatoid arthritis"" OR ""Immune system"" OR ""Inflammation"" OR ""Psoriatic arthritis"" OR ""Psoriasis"" OR ""Rheumatology"" OR ""Arthritis"" OR ""T cell"" OR ""Ankylosing spondylitis"" OR ""Cytotoxic T cell"" OR ""Proinflammatory cytokine"" OR ""Autoimmune disease""))",NA,oa_therapy_area,Uni,Immunology,2014,9243,2293,1752,479,766,144,5434,3809
immunology (primary search + immunology tags) - uni,"(author.affiliation.name:(""university of cape town"" OR ""south african college"" OR ""shanghai jiao tong university"" OR ""shanghai communications university"" OR ""fudan university"" OR ""sun yat-sen university"" OR ""zhejiang university"" OR ""chekiang university"" OR ""peking university"" OR ""imperial university of peking"" OR ""capital medical university"" OR ""cmu"" OR ""seoul national university"" OR ""seoul daehakgyo"" OR ""peking union medical college"" OR ""beijing xiehe hospital"" OR ""sichuan university"" OR ""sìchuān dàxué"" OR ""nanjing medical university"" OR ""national jiangsu medical college"" OR ""huazhong university of science and technology"" OR ""huázhōng kējì dàxué"" OR ""university college london"" OR ""london university"" OR ""karolinska institutet"" OR ""royal caroline institute"" OR ""university of oxford"" OR ""oxford university"" OR ""university of copenhagen"" OR ""universität kopenhagen"" OR ""université de paris"" OR ""university of paris"" OR ""king's college london"" OR ""kcl"" OR ""university of amsterdam"" OR ""universiteit van amsterdam"" OR ""imperial college london"" OR ""coleg imperial llundain"" OR ""utrecht university"" OR ""universiteit utrecht"" OR ""heidelberg university"" OR ""ruprecht-karls-universität heidelberg"" OR ""university of milan"" OR ""université de milan"" OR ""erasmus university rotterdam"" OR ""erasmus universiteit rotterdam"" OR ""freie universität berlin"" OR ""free university of berlin"" OR ""university of cambridge"" OR ""cambridge university"" OR ""humboldt-universität zu berlin"" OR ""humboldt university of berlin"" OR ""university of zurich"" OR ""universität zürich"" OR ""tel aviv university"" OR ""harvard university"" OR ""universidad de harvard"" OR ""johns hopkins university"" OR ""jhu"" OR ""university of toronto"" OR ""université de toronto"" OR ""university of pennsylvania"" Or ""upenn"" OR ""university of california, san francisco"" OR ""ucsf"" OR ""duke university"" OR ""Universidad de Duke"" OR ""university of michigan"" OR ""umich"" OR ""stanford university"" OR ""leland stanford junior university"" OR ""university of melbourne"" OR ""melbourne university"" OR ""university of sydney"" OR ""sydney university"" OR ""university of são paulo"" OR ""universidade de são paulo"") OR author.affiliation.ror_id_lineage:(""03p74gp79"" OR ""0220qvk04"" OR ""013q1eq08"" OR ""0064kty71"" OR ""00a2xv884"" OR ""02v51f717"" OR ""013xs5b60"" OR ""04h9pn542"" OR ""04jztag35"" OR ""011ashp19"" OR ""059gcgy73"" OR ""00p991c53"" OR ""02jx3x895"" OR ""056d84691"" OR ""052gg0110"" OR ""035b05819"" OR ""05f82e368"" OR ""0220mzb33"" OR ""04dkp9463"" OR ""041kmwe10"" OR ""04pp8hn57"" OR ""038t36y30"" OR ""00wjc7c48"" OR ""057w15z03"" OR ""046ak2485"" OR ""013meh722"" OR ""01hcx6992"" OR ""02crff812"" OR ""04mhzgx49"" OR ""03vek6s52"" OR ""00za53h95"" OR ""03dbr7087"" OR ""00b30xv10"" OR ""043mz5j54"" OR ""00py81415"" OR ""00jmfr291"" OR ""00f54p054"" OR ""01ej9dk98"" OR ""0384j8v12"" OR ""036rp1748"")) AND publication_type:""journal article"" AND date_published>=now-10y AND field_of_study: ((""Medicine"" OR ""Internal medicine"" OR ""Pharmacology"") AND (""Immunology"" OR ""Rheumatoid arthritis"" OR ""Immune system"" OR ""Inflammation"" OR ""Psoriatic arthritis"" OR ""Psoriasis"" OR ""Rheumatology"" OR ""Arthritis"" OR ""T cell"" OR ""Ankylosing spondylitis"" OR ""Cytotoxic T cell"" OR ""Proinflammatory cytokine"" OR ""Autoimmune disease""))",AND date_published>=now-10y,"AND field_of_study: ((""Medicine"" OR ""Internal medicine"" OR ""Pharmacology"") AND (""Immunology"" OR ""Rheumatoid arthritis"" OR ""Immune system"" OR ""Inflammation"" OR ""Psoriatic arthritis"" OR ""Psoriasis"" OR ""Rheumatology"" OR ""Arthritis"" OR ""T cell"" OR ""Ankylosing spondylitis"" OR ""Cytotoxic T cell"" OR ""Proinflammatory cytokine"" OR ""Autoimmune disease""))",NA,oa_therapy_area,Uni,Immunology,2015,9982,2642,1738,541,968,224,6113,3869
immunology (primary search + immunology tags) - uni,"(author.affiliation.name:(""university of cape town"" OR ""south african college"" OR ""shanghai jiao tong university"" OR ""shanghai communications university"" OR ""fudan university"" OR ""sun yat-sen university"" OR ""zhejiang university"" OR ""chekiang university"" OR ""peking university"" OR ""imperial university of peking"" OR ""capital medical university"" OR ""cmu"" OR ""seoul national university"" OR ""seoul daehakgyo"" OR ""peking union medical college"" OR ""beijing xiehe hospital"" OR ""sichuan university"" OR ""sìchuān dàxué"" OR ""nanjing medical university"" OR ""national jiangsu medical college"" OR ""huazhong university of science and technology"" OR ""huázhōng kējì dàxué"" OR ""university college london"" OR ""london university"" OR ""karolinska institutet"" OR ""royal caroline institute"" OR ""university of oxford"" OR ""oxford university"" OR ""university of copenhagen"" OR ""universität kopenhagen"" OR ""université de paris"" OR ""university of paris"" OR ""king's college london"" OR ""kcl"" OR ""university of amsterdam"" OR ""universiteit van amsterdam"" OR ""imperial college london"" OR ""coleg imperial llundain"" OR ""utrecht university"" OR ""universiteit utrecht"" OR ""heidelberg university"" OR ""ruprecht-karls-universität heidelberg"" OR ""university of milan"" OR ""université de milan"" OR ""erasmus university rotterdam"" OR ""erasmus universiteit rotterdam"" OR ""freie universität berlin"" OR ""free university of berlin"" OR ""university of cambridge"" OR ""cambridge university"" OR ""humboldt-universität zu berlin"" OR ""humboldt university of berlin"" OR ""university of zurich"" OR ""universität zürich"" OR ""tel aviv university"" OR ""harvard university"" OR ""universidad de harvard"" OR ""johns hopkins university"" OR ""jhu"" OR ""university of toronto"" OR ""université de toronto"" OR ""university of pennsylvania"" Or ""upenn"" OR ""university of california, san francisco"" OR ""ucsf"" OR ""duke university"" OR ""Universidad de Duke"" OR ""university of michigan"" OR ""umich"" OR ""stanford university"" OR ""leland stanford junior university"" OR ""university of melbourne"" OR ""melbourne university"" OR ""university of sydney"" OR ""sydney university"" OR ""university of são paulo"" OR ""universidade de são paulo"") OR author.affiliation.ror_id_lineage:(""03p74gp79"" OR ""0220qvk04"" OR ""013q1eq08"" OR ""0064kty71"" OR ""00a2xv884"" OR ""02v51f717"" OR ""013xs5b60"" OR ""04h9pn542"" OR ""04jztag35"" OR ""011ashp19"" OR ""059gcgy73"" OR ""00p991c53"" OR ""02jx3x895"" OR ""056d84691"" OR ""052gg0110"" OR ""035b05819"" OR ""05f82e368"" OR ""0220mzb33"" OR ""04dkp9463"" OR ""041kmwe10"" OR ""04pp8hn57"" OR ""038t36y30"" OR ""00wjc7c48"" OR ""057w15z03"" OR ""046ak2485"" OR ""013meh722"" OR ""01hcx6992"" OR ""02crff812"" OR ""04mhzgx49"" OR ""03vek6s52"" OR ""00za53h95"" OR ""03dbr7087"" OR ""00b30xv10"" OR ""043mz5j54"" OR ""00py81415"" OR ""00jmfr291"" OR ""00f54p054"" OR ""01ej9dk98"" OR ""0384j8v12"" OR ""036rp1748"")) AND publication_type:""journal article"" AND date_published>=now-10y AND field_of_study: ((""Medicine"" OR ""Internal medicine"" OR ""Pharmacology"") AND (""Immunology"" OR ""Rheumatoid arthritis"" OR ""Immune system"" OR ""Inflammation"" OR ""Psoriatic arthritis"" OR ""Psoriasis"" OR ""Rheumatology"" OR ""Arthritis"" OR ""T cell"" OR ""Ankylosing spondylitis"" OR ""Cytotoxic T cell"" OR ""Proinflammatory cytokine"" OR ""Autoimmune disease""))",AND date_published>=now-10y,"AND field_of_study: ((""Medicine"" OR ""Internal medicine"" OR ""Pharmacology"") AND (""Immunology"" OR ""Rheumatoid arthritis"" OR ""Immune system"" OR ""Inflammation"" OR ""Psoriatic arthritis"" OR ""Psoriasis"" OR ""Rheumatology"" OR ""Arthritis"" OR ""T cell"" OR ""Ankylosing spondylitis"" OR ""Cytotoxic T cell"" OR ""Proinflammatory cytokine"" OR ""Autoimmune disease""))",NA,oa_therapy_area,Uni,Immunology,2016,10335,3100,1966,584,904,124,6678,3657
immunology (primary search + immunology tags) - uni,"(author.affiliation.name:(""university of cape town"" OR ""south african college"" OR ""shanghai jiao tong university"" OR ""shanghai communications university"" OR ""fudan university"" OR ""sun yat-sen university"" OR ""zhejiang university"" OR ""chekiang university"" OR ""peking university"" OR ""imperial university of peking"" OR ""capital medical university"" OR ""cmu"" OR ""seoul national university"" OR ""seoul daehakgyo"" OR ""peking union medical college"" OR ""beijing xiehe hospital"" OR ""sichuan university"" OR ""sìchuān dàxué"" OR ""nanjing medical university"" OR ""national jiangsu medical college"" OR ""huazhong university of science and technology"" OR ""huázhōng kējì dàxué"" OR ""university college london"" OR ""london university"" OR ""karolinska institutet"" OR ""royal caroline institute"" OR ""university of oxford"" OR ""oxford university"" OR ""university of copenhagen"" OR ""universität kopenhagen"" OR ""université de paris"" OR ""university of paris"" OR ""king's college london"" OR ""kcl"" OR ""university of amsterdam"" OR ""universiteit van amsterdam"" OR ""imperial college london"" OR ""coleg imperial llundain"" OR ""utrecht university"" OR ""universiteit utrecht"" OR ""heidelberg university"" OR ""ruprecht-karls-universität heidelberg"" OR ""university of milan"" OR ""université de milan"" OR ""erasmus university rotterdam"" OR ""erasmus universiteit rotterdam"" OR ""freie universität berlin"" OR ""free university of berlin"" OR ""university of cambridge"" OR ""cambridge university"" OR ""humboldt-universität zu berlin"" OR ""humboldt university of berlin"" OR ""university of zurich"" OR ""universität zürich"" OR ""tel aviv university"" OR ""harvard university"" OR ""universidad de harvard"" OR ""johns hopkins university"" OR ""jhu"" OR ""university of toronto"" OR ""université de toronto"" OR ""university of pennsylvania"" Or ""upenn"" OR ""university of california, san francisco"" OR ""ucsf"" OR ""duke university"" OR ""Universidad de Duke"" OR ""university of michigan"" OR ""umich"" OR ""stanford university"" OR ""leland stanford junior university"" OR ""university of melbourne"" OR ""melbourne university"" OR ""university of sydney"" OR ""sydney university"" OR ""university of são paulo"" OR ""universidade de são paulo"") OR author.affiliation.ror_id_lineage:(""03p74gp79"" OR ""0220qvk04"" OR ""013q1eq08"" OR ""0064kty71"" OR ""00a2xv884"" OR ""02v51f717"" OR ""013xs5b60"" OR ""04h9pn542"" OR ""04jztag35"" OR ""011ashp19"" OR ""059gcgy73"" OR ""00p991c53"" OR ""02jx3x895"" OR ""056d84691"" OR ""052gg0110"" OR ""035b05819"" OR ""05f82e368"" OR ""0220mzb33"" OR ""04dkp9463"" OR ""041kmwe10"" OR ""04pp8hn57"" OR ""038t36y30"" OR ""00wjc7c48"" OR ""057w15z03"" OR ""046ak2485"" OR ""013meh722"" OR ""01hcx6992"" OR ""02crff812"" OR ""04mhzgx49"" OR ""03vek6s52"" OR ""00za53h95"" OR ""03dbr7087"" OR ""00b30xv10"" OR ""043mz5j54"" OR ""00py81415"" OR ""00jmfr291"" OR ""00f54p054"" OR ""01ej9dk98"" OR ""0384j8v12"" OR ""036rp1748"")) AND publication_type:""journal article"" AND date_published>=now-10y AND field_of_study: ((""Medicine"" OR ""Internal medicine"" OR ""Pharmacology"") AND (""Immunology"" OR ""Rheumatoid arthritis"" OR ""Immune system"" OR ""Inflammation"" OR ""Psoriatic arthritis"" OR ""Psoriasis"" OR ""Rheumatology"" OR ""Arthritis"" OR ""T cell"" OR ""Ankylosing spondylitis"" OR ""Cytotoxic T cell"" OR ""Proinflammatory cytokine"" OR ""Autoimmune disease""))",AND date_published>=now-10y,"AND field_of_study: ((""Medicine"" OR ""Internal medicine"" OR ""Pharmacology"") AND (""Immunology"" OR ""Rheumatoid arthritis"" OR ""Immune system"" OR ""Inflammation"" OR ""Psoriatic arthritis"" OR ""Psoriasis"" OR ""Rheumatology"" OR ""Arthritis"" OR ""T cell"" OR ""Ankylosing spondylitis"" OR ""Cytotoxic T cell"" OR ""Proinflammatory cytokine"" OR ""Autoimmune disease""))",NA,oa_therapy_area,Uni,Immunology,2017,10123,3221,1956,637,1080,130,7024,3099
immunology (primary search + immunology tags) - uni,"(author.affiliation.name:(""university of cape town"" OR ""south african college"" OR ""shanghai jiao tong university"" OR ""shanghai communications university"" OR ""fudan university"" OR ""sun yat-sen university"" OR ""zhejiang university"" OR ""chekiang university"" OR ""peking university"" OR ""imperial university of peking"" OR ""capital medical university"" OR ""cmu"" OR ""seoul national university"" OR ""seoul daehakgyo"" OR ""peking union medical college"" OR ""beijing xiehe hospital"" OR ""sichuan university"" OR ""sìchuān dàxué"" OR ""nanjing medical university"" OR ""national jiangsu medical college"" OR ""huazhong university of science and technology"" OR ""huázhōng kējì dàxué"" OR ""university college london"" OR ""london university"" OR ""karolinska institutet"" OR ""royal caroline institute"" OR ""university of oxford"" OR ""oxford university"" OR ""university of copenhagen"" OR ""universität kopenhagen"" OR ""université de paris"" OR ""university of paris"" OR ""king's college london"" OR ""kcl"" OR ""university of amsterdam"" OR ""universiteit van amsterdam"" OR ""imperial college london"" OR ""coleg imperial llundain"" OR ""utrecht university"" OR ""universiteit utrecht"" OR ""heidelberg university"" OR ""ruprecht-karls-universität heidelberg"" OR ""university of milan"" OR ""université de milan"" OR ""erasmus university rotterdam"" OR ""erasmus universiteit rotterdam"" OR ""freie universität berlin"" OR ""free university of berlin"" OR ""university of cambridge"" OR ""cambridge university"" OR ""humboldt-universität zu berlin"" OR ""humboldt university of berlin"" OR ""university of zurich"" OR ""universität zürich"" OR ""tel aviv university"" OR ""harvard university"" OR ""universidad de harvard"" OR ""johns hopkins university"" OR ""jhu"" OR ""university of toronto"" OR ""université de toronto"" OR ""university of pennsylvania"" Or ""upenn"" OR ""university of california, san francisco"" OR ""ucsf"" OR ""duke university"" OR ""Universidad de Duke"" OR ""university of michigan"" OR ""umich"" OR ""stanford university"" OR ""leland stanford junior university"" OR ""university of melbourne"" OR ""melbourne university"" OR ""university of sydney"" OR ""sydney university"" OR ""university of são paulo"" OR ""universidade de são paulo"") OR author.affiliation.ror_id_lineage:(""03p74gp79"" OR ""0220qvk04"" OR ""013q1eq08"" OR ""0064kty71"" OR ""00a2xv884"" OR ""02v51f717"" OR ""013xs5b60"" OR ""04h9pn542"" OR ""04jztag35"" OR ""011ashp19"" OR ""059gcgy73"" OR ""00p991c53"" OR ""02jx3x895"" OR ""056d84691"" OR ""052gg0110"" OR ""035b05819"" OR ""05f82e368"" OR ""0220mzb33"" OR ""04dkp9463"" OR ""041kmwe10"" OR ""04pp8hn57"" OR ""038t36y30"" OR ""00wjc7c48"" OR ""057w15z03"" OR ""046ak2485"" OR ""013meh722"" OR ""01hcx6992"" OR ""02crff812"" OR ""04mhzgx49"" OR ""03vek6s52"" OR ""00za53h95"" OR ""03dbr7087"" OR ""00b30xv10"" OR ""043mz5j54"" OR ""00py81415"" OR ""00jmfr291"" OR ""00f54p054"" OR ""01ej9dk98"" OR ""0384j8v12"" OR ""036rp1748"")) AND publication_type:""journal article"" AND date_published>=now-10y AND field_of_study: ((""Medicine"" OR ""Internal medicine"" OR ""Pharmacology"") AND (""Immunology"" OR ""Rheumatoid arthritis"" OR ""Immune system"" OR ""Inflammation"" OR ""Psoriatic arthritis"" OR ""Psoriasis"" OR ""Rheumatology"" OR ""Arthritis"" OR ""T cell"" OR ""Ankylosing spondylitis"" OR ""Cytotoxic T cell"" OR ""Proinflammatory cytokine"" OR ""Autoimmune disease""))",AND date_published>=now-10y,"AND field_of_study: ((""Medicine"" OR ""Internal medicine"" OR ""Pharmacology"") AND (""Immunology"" OR ""Rheumatoid arthritis"" OR ""Immune system"" OR ""Inflammation"" OR ""Psoriatic arthritis"" OR ""Psoriasis"" OR ""Rheumatology"" OR ""Arthritis"" OR ""T cell"" OR ""Ankylosing spondylitis"" OR ""Cytotoxic T cell"" OR ""Proinflammatory cytokine"" OR ""Autoimmune disease""))",NA,oa_therapy_area,Uni,Immunology,2018,8439,2569,1534,589,1049,118,5859,2580
immunology (primary search + immunology tags) - uni,"(author.affiliation.name:(""university of cape town"" OR ""south african college"" OR ""shanghai jiao tong university"" OR ""shanghai communications university"" OR ""fudan university"" OR ""sun yat-sen university"" OR ""zhejiang university"" OR ""chekiang university"" OR ""peking university"" OR ""imperial university of peking"" OR ""capital medical university"" OR ""cmu"" OR ""seoul national university"" OR ""seoul daehakgyo"" OR ""peking union medical college"" OR ""beijing xiehe hospital"" OR ""sichuan university"" OR ""sìchuān dàxué"" OR ""nanjing medical university"" OR ""national jiangsu medical college"" OR ""huazhong university of science and technology"" OR ""huázhōng kējì dàxué"" OR ""university college london"" OR ""london university"" OR ""karolinska institutet"" OR ""royal caroline institute"" OR ""university of oxford"" OR ""oxford university"" OR ""university of copenhagen"" OR ""universität kopenhagen"" OR ""université de paris"" OR ""university of paris"" OR ""king's college london"" OR ""kcl"" OR ""university of amsterdam"" OR ""universiteit van amsterdam"" OR ""imperial college london"" OR ""coleg imperial llundain"" OR ""utrecht university"" OR ""universiteit utrecht"" OR ""heidelberg university"" OR ""ruprecht-karls-universität heidelberg"" OR ""university of milan"" OR ""université de milan"" OR ""erasmus university rotterdam"" OR ""erasmus universiteit rotterdam"" OR ""freie universität berlin"" OR ""free university of berlin"" OR ""university of cambridge"" OR ""cambridge university"" OR ""humboldt-universität zu berlin"" OR ""humboldt university of berlin"" OR ""university of zurich"" OR ""universität zürich"" OR ""tel aviv university"" OR ""harvard university"" OR ""universidad de harvard"" OR ""johns hopkins university"" OR ""jhu"" OR ""university of toronto"" OR ""université de toronto"" OR ""university of pennsylvania"" Or ""upenn"" OR ""university of california, san francisco"" OR ""ucsf"" OR ""duke university"" OR ""Universidad de Duke"" OR ""university of michigan"" OR ""umich"" OR ""stanford university"" OR ""leland stanford junior university"" OR ""university of melbourne"" OR ""melbourne university"" OR ""university of sydney"" OR ""sydney university"" OR ""university of são paulo"" OR ""universidade de são paulo"") OR author.affiliation.ror_id_lineage:(""03p74gp79"" OR ""0220qvk04"" OR ""013q1eq08"" OR ""0064kty71"" OR ""00a2xv884"" OR ""02v51f717"" OR ""013xs5b60"" OR ""04h9pn542"" OR ""04jztag35"" OR ""011ashp19"" OR ""059gcgy73"" OR ""00p991c53"" OR ""02jx3x895"" OR ""056d84691"" OR ""052gg0110"" OR ""035b05819"" OR ""05f82e368"" OR ""0220mzb33"" OR ""04dkp9463"" OR ""041kmwe10"" OR ""04pp8hn57"" OR ""038t36y30"" OR ""00wjc7c48"" OR ""057w15z03"" OR ""046ak2485"" OR ""013meh722"" OR ""01hcx6992"" OR ""02crff812"" OR ""04mhzgx49"" OR ""03vek6s52"" OR ""00za53h95"" OR ""03dbr7087"" OR ""00b30xv10"" OR ""043mz5j54"" OR ""00py81415"" OR ""00jmfr291"" OR ""00f54p054"" OR ""01ej9dk98"" OR ""0384j8v12"" OR ""036rp1748"")) AND publication_type:""journal article"" AND date_published>=now-10y AND field_of_study: ((""Medicine"" OR ""Internal medicine"" OR ""Pharmacology"") AND (""Immunology"" OR ""Rheumatoid arthritis"" OR ""Immune system"" OR ""Inflammation"" OR ""Psoriatic arthritis"" OR ""Psoriasis"" OR ""Rheumatology"" OR ""Arthritis"" OR ""T cell"" OR ""Ankylosing spondylitis"" OR ""Cytotoxic T cell"" OR ""Proinflammatory cytokine"" OR ""Autoimmune disease""))",AND date_published>=now-10y,"AND field_of_study: ((""Medicine"" OR ""Internal medicine"" OR ""Pharmacology"") AND (""Immunology"" OR ""Rheumatoid arthritis"" OR ""Immune system"" OR ""Inflammation"" OR ""Psoriatic arthritis"" OR ""Psoriasis"" OR ""Rheumatology"" OR ""Arthritis"" OR ""T cell"" OR ""Ankylosing spondylitis"" OR ""Cytotoxic T cell"" OR ""Proinflammatory cytokine"" OR ""Autoimmune disease""))",NA,oa_therapy_area,Uni,Immunology,2019,9073,3118,1458,695,715,129,6115,2958
immunology (primary search + immunology tags) - uni,"(author.affiliation.name:(""university of cape town"" OR ""south african college"" OR ""shanghai jiao tong university"" OR ""shanghai communications university"" OR ""fudan university"" OR ""sun yat-sen university"" OR ""zhejiang university"" OR ""chekiang university"" OR ""peking university"" OR ""imperial university of peking"" OR ""capital medical university"" OR ""cmu"" OR ""seoul national university"" OR ""seoul daehakgyo"" OR ""peking union medical college"" OR ""beijing xiehe hospital"" OR ""sichuan university"" OR ""sìchuān dàxué"" OR ""nanjing medical university"" OR ""national jiangsu medical college"" OR ""huazhong university of science and technology"" OR ""huázhōng kējì dàxué"" OR ""university college london"" OR ""london university"" OR ""karolinska institutet"" OR ""royal caroline institute"" OR ""university of oxford"" OR ""oxford university"" OR ""university of copenhagen"" OR ""universität kopenhagen"" OR ""université de paris"" OR ""university of paris"" OR ""king's college london"" OR ""kcl"" OR ""university of amsterdam"" OR ""universiteit van amsterdam"" OR ""imperial college london"" OR ""coleg imperial llundain"" OR ""utrecht university"" OR ""universiteit utrecht"" OR ""heidelberg university"" OR ""ruprecht-karls-universität heidelberg"" OR ""university of milan"" OR ""université de milan"" OR ""erasmus university rotterdam"" OR ""erasmus universiteit rotterdam"" OR ""freie universität berlin"" OR ""free university of berlin"" OR ""university of cambridge"" OR ""cambridge university"" OR ""humboldt-universität zu berlin"" OR ""humboldt university of berlin"" OR ""university of zurich"" OR ""universität zürich"" OR ""tel aviv university"" OR ""harvard university"" OR ""universidad de harvard"" OR ""johns hopkins university"" OR ""jhu"" OR ""university of toronto"" OR ""université de toronto"" OR ""university of pennsylvania"" Or ""upenn"" OR ""university of california, san francisco"" OR ""ucsf"" OR ""duke university"" OR ""Universidad de Duke"" OR ""university of michigan"" OR ""umich"" OR ""stanford university"" OR ""leland stanford junior university"" OR ""university of melbourne"" OR ""melbourne university"" OR ""university of sydney"" OR ""sydney university"" OR ""university of são paulo"" OR ""universidade de são paulo"") OR author.affiliation.ror_id_lineage:(""03p74gp79"" OR ""0220qvk04"" OR ""013q1eq08"" OR ""0064kty71"" OR ""00a2xv884"" OR ""02v51f717"" OR ""013xs5b60"" OR ""04h9pn542"" OR ""04jztag35"" OR ""011ashp19"" OR ""059gcgy73"" OR ""00p991c53"" OR ""02jx3x895"" OR ""056d84691"" OR ""052gg0110"" OR ""035b05819"" OR ""05f82e368"" OR ""0220mzb33"" OR ""04dkp9463"" OR ""041kmwe10"" OR ""04pp8hn57"" OR ""038t36y30"" OR ""00wjc7c48"" OR ""057w15z03"" OR ""046ak2485"" OR ""013meh722"" OR ""01hcx6992"" OR ""02crff812"" OR ""04mhzgx49"" OR ""03vek6s52"" OR ""00za53h95"" OR ""03dbr7087"" OR ""00b30xv10"" OR ""043mz5j54"" OR ""00py81415"" OR ""00jmfr291"" OR ""00f54p054"" OR ""01ej9dk98"" OR ""0384j8v12"" OR ""036rp1748"")) AND publication_type:""journal article"" AND date_published>=now-10y AND field_of_study: ((""Medicine"" OR ""Internal medicine"" OR ""Pharmacology"") AND (""Immunology"" OR ""Rheumatoid arthritis"" OR ""Immune system"" OR ""Inflammation"" OR ""Psoriatic arthritis"" OR ""Psoriasis"" OR ""Rheumatology"" OR ""Arthritis"" OR ""T cell"" OR ""Ankylosing spondylitis"" OR ""Cytotoxic T cell"" OR ""Proinflammatory cytokine"" OR ""Autoimmune disease""))",AND date_published>=now-10y,"AND field_of_study: ((""Medicine"" OR ""Internal medicine"" OR ""Pharmacology"") AND (""Immunology"" OR ""Rheumatoid arthritis"" OR ""Immune system"" OR ""Inflammation"" OR ""Psoriatic arthritis"" OR ""Psoriasis"" OR ""Rheumatology"" OR ""Arthritis"" OR ""T cell"" OR ""Ankylosing spondylitis"" OR ""Cytotoxic T cell"" OR ""Proinflammatory cytokine"" OR ""Autoimmune disease""))",NA,oa_therapy_area,Uni,Immunology,2020,11712,4428,1811,1059,964,202,8464,3248
immunology (primary search + immunology tags) - uni,"(author.affiliation.name:(""university of cape town"" OR ""south african college"" OR ""shanghai jiao tong university"" OR ""shanghai communications university"" OR ""fudan university"" OR ""sun yat-sen university"" OR ""zhejiang university"" OR ""chekiang university"" OR ""peking university"" OR ""imperial university of peking"" OR ""capital medical university"" OR ""cmu"" OR ""seoul national university"" OR ""seoul daehakgyo"" OR ""peking union medical college"" OR ""beijing xiehe hospital"" OR ""sichuan university"" OR ""sìchuān dàxué"" OR ""nanjing medical university"" OR ""national jiangsu medical college"" OR ""huazhong university of science and technology"" OR ""huázhōng kējì dàxué"" OR ""university college london"" OR ""london university"" OR ""karolinska institutet"" OR ""royal caroline institute"" OR ""university of oxford"" OR ""oxford university"" OR ""university of copenhagen"" OR ""universität kopenhagen"" OR ""université de paris"" OR ""university of paris"" OR ""king's college london"" OR ""kcl"" OR ""university of amsterdam"" OR ""universiteit van amsterdam"" OR ""imperial college london"" OR ""coleg imperial llundain"" OR ""utrecht university"" OR ""universiteit utrecht"" OR ""heidelberg university"" OR ""ruprecht-karls-universität heidelberg"" OR ""university of milan"" OR ""université de milan"" OR ""erasmus university rotterdam"" OR ""erasmus universiteit rotterdam"" OR ""freie universität berlin"" OR ""free university of berlin"" OR ""university of cambridge"" OR ""cambridge university"" OR ""humboldt-universität zu berlin"" OR ""humboldt university of berlin"" OR ""university of zurich"" OR ""universität zürich"" OR ""tel aviv university"" OR ""harvard university"" OR ""universidad de harvard"" OR ""johns hopkins university"" OR ""jhu"" OR ""university of toronto"" OR ""université de toronto"" OR ""university of pennsylvania"" Or ""upenn"" OR ""university of california, san francisco"" OR ""ucsf"" OR ""duke university"" OR ""Universidad de Duke"" OR ""university of michigan"" OR ""umich"" OR ""stanford university"" OR ""leland stanford junior university"" OR ""university of melbourne"" OR ""melbourne university"" OR ""university of sydney"" OR ""sydney university"" OR ""university of são paulo"" OR ""universidade de são paulo"") OR author.affiliation.ror_id_lineage:(""03p74gp79"" OR ""0220qvk04"" OR ""013q1eq08"" OR ""0064kty71"" OR ""00a2xv884"" OR ""02v51f717"" OR ""013xs5b60"" OR ""04h9pn542"" OR ""04jztag35"" OR ""011ashp19"" OR ""059gcgy73"" OR ""00p991c53"" OR ""02jx3x895"" OR ""056d84691"" OR ""052gg0110"" OR ""035b05819"" OR ""05f82e368"" OR ""0220mzb33"" OR ""04dkp9463"" OR ""041kmwe10"" OR ""04pp8hn57"" OR ""038t36y30"" OR ""00wjc7c48"" OR ""057w15z03"" OR ""046ak2485"" OR ""013meh722"" OR ""01hcx6992"" OR ""02crff812"" OR ""04mhzgx49"" OR ""03vek6s52"" OR ""00za53h95"" OR ""03dbr7087"" OR ""00b30xv10"" OR ""043mz5j54"" OR ""00py81415"" OR ""00jmfr291"" OR ""00f54p054"" OR ""01ej9dk98"" OR ""0384j8v12"" OR ""036rp1748"")) AND publication_type:""journal article"" AND date_published>=now-10y AND field_of_study: ((""Medicine"" OR ""Internal medicine"" OR ""Pharmacology"") AND (""Immunology"" OR ""Rheumatoid arthritis"" OR ""Immune system"" OR ""Inflammation"" OR ""Psoriatic arthritis"" OR ""Psoriasis"" OR ""Rheumatology"" OR ""Arthritis"" OR ""T cell"" OR ""Ankylosing spondylitis"" OR ""Cytotoxic T cell"" OR ""Proinflammatory cytokine"" OR ""Autoimmune disease""))",AND date_published>=now-10y,"AND field_of_study: ((""Medicine"" OR ""Internal medicine"" OR ""Pharmacology"") AND (""Immunology"" OR ""Rheumatoid arthritis"" OR ""Immune system"" OR ""Inflammation"" OR ""Psoriatic arthritis"" OR ""Psoriasis"" OR ""Rheumatology"" OR ""Arthritis"" OR ""T cell"" OR ""Ankylosing spondylitis"" OR ""Cytotoxic T cell"" OR ""Proinflammatory cytokine"" OR ""Autoimmune disease""))",NA,oa_therapy_area,Uni,Immunology,2021,13995,6612,1271,1412,826,616,10737,3258
immunology (primary search + immunology tags) - uni,"(author.affiliation.name:(""university of cape town"" OR ""south african college"" OR ""shanghai jiao tong university"" OR ""shanghai communications university"" OR ""fudan university"" OR ""sun yat-sen university"" OR ""zhejiang university"" OR ""chekiang university"" OR ""peking university"" OR ""imperial university of peking"" OR ""capital medical university"" OR ""cmu"" OR ""seoul national university"" OR ""seoul daehakgyo"" OR ""peking union medical college"" OR ""beijing xiehe hospital"" OR ""sichuan university"" OR ""sìchuān dàxué"" OR ""nanjing medical university"" OR ""national jiangsu medical college"" OR ""huazhong university of science and technology"" OR ""huázhōng kējì dàxué"" OR ""university college london"" OR ""london university"" OR ""karolinska institutet"" OR ""royal caroline institute"" OR ""university of oxford"" OR ""oxford university"" OR ""university of copenhagen"" OR ""universität kopenhagen"" OR ""université de paris"" OR ""university of paris"" OR ""king's college london"" OR ""kcl"" OR ""university of amsterdam"" OR ""universiteit van amsterdam"" OR ""imperial college london"" OR ""coleg imperial llundain"" OR ""utrecht university"" OR ""universiteit utrecht"" OR ""heidelberg university"" OR ""ruprecht-karls-universität heidelberg"" OR ""university of milan"" OR ""université de milan"" OR ""erasmus university rotterdam"" OR ""erasmus universiteit rotterdam"" OR ""freie universität berlin"" OR ""free university of berlin"" OR ""university of cambridge"" OR ""cambridge university"" OR ""humboldt-universität zu berlin"" OR ""humboldt university of berlin"" OR ""university of zurich"" OR ""universität zürich"" OR ""tel aviv university"" OR ""harvard university"" OR ""universidad de harvard"" OR ""johns hopkins university"" OR ""jhu"" OR ""university of toronto"" OR ""université de toronto"" OR ""university of pennsylvania"" Or ""upenn"" OR ""university of california, san francisco"" OR ""ucsf"" OR ""duke university"" OR ""Universidad de Duke"" OR ""university of michigan"" OR ""umich"" OR ""stanford university"" OR ""leland stanford junior university"" OR ""university of melbourne"" OR ""melbourne university"" OR ""university of sydney"" OR ""sydney university"" OR ""university of são paulo"" OR ""universidade de são paulo"") OR author.affiliation.ror_id_lineage:(""03p74gp79"" OR ""0220qvk04"" OR ""013q1eq08"" OR ""0064kty71"" OR ""00a2xv884"" OR ""02v51f717"" OR ""013xs5b60"" OR ""04h9pn542"" OR ""04jztag35"" OR ""011ashp19"" OR ""059gcgy73"" OR ""00p991c53"" OR ""02jx3x895"" OR ""056d84691"" OR ""052gg0110"" OR ""035b05819"" OR ""05f82e368"" OR ""0220mzb33"" OR ""04dkp9463"" OR ""041kmwe10"" OR ""04pp8hn57"" OR ""038t36y30"" OR ""00wjc7c48"" OR ""057w15z03"" OR ""046ak2485"" OR ""013meh722"" OR ""01hcx6992"" OR ""02crff812"" OR ""04mhzgx49"" OR ""03vek6s52"" OR ""00za53h95"" OR ""03dbr7087"" OR ""00b30xv10"" OR ""043mz5j54"" OR ""00py81415"" OR ""00jmfr291"" OR ""00f54p054"" OR ""01ej9dk98"" OR ""0384j8v12"" OR ""036rp1748"")) AND publication_type:""journal article"" AND date_published>=now-10y AND field_of_study: ((""Medicine"" OR ""Internal medicine"" OR ""Pharmacology"") AND (""Immunology"" OR ""Rheumatoid arthritis"" OR ""Immune system"" OR ""Inflammation"" OR ""Psoriatic arthritis"" OR ""Psoriasis"" OR ""Rheumatology"" OR ""Arthritis"" OR ""T cell"" OR ""Ankylosing spondylitis"" OR ""Cytotoxic T cell"" OR ""Proinflammatory cytokine"" OR ""Autoimmune disease""))",AND date_published>=now-10y,"AND field_of_study: ((""Medicine"" OR ""Internal medicine"" OR ""Pharmacology"") AND (""Immunology"" OR ""Rheumatoid arthritis"" OR ""Immune system"" OR ""Inflammation"" OR ""Psoriatic arthritis"" OR ""Psoriasis"" OR ""Rheumatology"" OR ""Arthritis"" OR ""T cell"" OR ""Ankylosing spondylitis"" OR ""Cytotoxic T cell"" OR ""Proinflammatory cytokine"" OR ""Autoimmune disease""))",NA,oa_therapy_area,Uni,Immunology,2022,27790,14374,1735,2603,1595,665,20972,6818
immunology (primary search + immunology tags) - uni,"(author.affiliation.name:(""university of cape town"" OR ""south african college"" OR ""shanghai jiao tong university"" OR ""shanghai communications university"" OR ""fudan university"" OR ""sun yat-sen university"" OR ""zhejiang university"" OR ""chekiang university"" OR ""peking university"" OR ""imperial university of peking"" OR ""capital medical university"" OR ""cmu"" OR ""seoul national university"" OR ""seoul daehakgyo"" OR ""peking union medical college"" OR ""beijing xiehe hospital"" OR ""sichuan university"" OR ""sìchuān dàxué"" OR ""nanjing medical university"" OR ""national jiangsu medical college"" OR ""huazhong university of science and technology"" OR ""huázhōng kējì dàxué"" OR ""university college london"" OR ""london university"" OR ""karolinska institutet"" OR ""royal caroline institute"" OR ""university of oxford"" OR ""oxford university"" OR ""university of copenhagen"" OR ""universität kopenhagen"" OR ""université de paris"" OR ""university of paris"" OR ""king's college london"" OR ""kcl"" OR ""university of amsterdam"" OR ""universiteit van amsterdam"" OR ""imperial college london"" OR ""coleg imperial llundain"" OR ""utrecht university"" OR ""universiteit utrecht"" OR ""heidelberg university"" OR ""ruprecht-karls-universität heidelberg"" OR ""university of milan"" OR ""université de milan"" OR ""erasmus university rotterdam"" OR ""erasmus universiteit rotterdam"" OR ""freie universität berlin"" OR ""free university of berlin"" OR ""university of cambridge"" OR ""cambridge university"" OR ""humboldt-universität zu berlin"" OR ""humboldt university of berlin"" OR ""university of zurich"" OR ""universität zürich"" OR ""tel aviv university"" OR ""harvard university"" OR ""universidad de harvard"" OR ""johns hopkins university"" OR ""jhu"" OR ""university of toronto"" OR ""université de toronto"" OR ""university of pennsylvania"" Or ""upenn"" OR ""university of california, san francisco"" OR ""ucsf"" OR ""duke university"" OR ""Universidad de Duke"" OR ""university of michigan"" OR ""umich"" OR ""stanford university"" OR ""leland stanford junior university"" OR ""university of melbourne"" OR ""melbourne university"" OR ""university of sydney"" OR ""sydney university"" OR ""university of são paulo"" OR ""universidade de são paulo"") OR author.affiliation.ror_id_lineage:(""03p74gp79"" OR ""0220qvk04"" OR ""013q1eq08"" OR ""0064kty71"" OR ""00a2xv884"" OR ""02v51f717"" OR ""013xs5b60"" OR ""04h9pn542"" OR ""04jztag35"" OR ""011ashp19"" OR ""059gcgy73"" OR ""00p991c53"" OR ""02jx3x895"" OR ""056d84691"" OR ""052gg0110"" OR ""035b05819"" OR ""05f82e368"" OR ""0220mzb33"" OR ""04dkp9463"" OR ""041kmwe10"" OR ""04pp8hn57"" OR ""038t36y30"" OR ""00wjc7c48"" OR ""057w15z03"" OR ""046ak2485"" OR ""013meh722"" OR ""01hcx6992"" OR ""02crff812"" OR ""04mhzgx49"" OR ""03vek6s52"" OR ""00za53h95"" OR ""03dbr7087"" OR ""00b30xv10"" OR ""043mz5j54"" OR ""00py81415"" OR ""00jmfr291"" OR ""00f54p054"" OR ""01ej9dk98"" OR ""0384j8v12"" OR ""036rp1748"")) AND publication_type:""journal article"" AND date_published>=now-10y AND field_of_study: ((""Medicine"" OR ""Internal medicine"" OR ""Pharmacology"") AND (""Immunology"" OR ""Rheumatoid arthritis"" OR ""Immune system"" OR ""Inflammation"" OR ""Psoriatic arthritis"" OR ""Psoriasis"" OR ""Rheumatology"" OR ""Arthritis"" OR ""T cell"" OR ""Ankylosing spondylitis"" OR ""Cytotoxic T cell"" OR ""Proinflammatory cytokine"" OR ""Autoimmune disease""))",AND date_published>=now-10y,"AND field_of_study: ((""Medicine"" OR ""Internal medicine"" OR ""Pharmacology"") AND (""Immunology"" OR ""Rheumatoid arthritis"" OR ""Immune system"" OR ""Inflammation"" OR ""Psoriatic arthritis"" OR ""Psoriasis"" OR ""Rheumatology"" OR ""Arthritis"" OR ""T cell"" OR ""Ankylosing spondylitis"" OR ""Cytotoxic T cell"" OR ""Proinflammatory cytokine"" OR ""Autoimmune disease""))",NA,oa_therapy_area,Uni,Immunology,2023,10565,5325,178,946,318,670,7437,3128
endocrinology (primary search + endocrinology tags) - uni,"(author.affiliation.name:(""university of cape town"" OR ""south african college"" OR ""shanghai jiao tong university"" OR ""shanghai communications university"" OR ""fudan university"" OR ""sun yat-sen university"" OR ""zhejiang university"" OR ""chekiang university"" OR ""peking university"" OR ""imperial university of peking"" OR ""capital medical university"" OR ""cmu"" OR ""seoul national university"" OR ""seoul daehakgyo"" OR ""peking union medical college"" OR ""beijing xiehe hospital"" OR ""sichuan university"" OR ""sìchuān dàxué"" OR ""nanjing medical university"" OR ""national jiangsu medical college"" OR ""huazhong university of science and technology"" OR ""huázhōng kējì dàxué"" OR ""university college london"" OR ""london university"" OR ""karolinska institutet"" OR ""royal caroline institute"" OR ""university of oxford"" OR ""oxford university"" OR ""university of copenhagen"" OR ""universität kopenhagen"" OR ""université de paris"" OR ""university of paris"" OR ""king's college london"" OR ""kcl"" OR ""university of amsterdam"" OR ""universiteit van amsterdam"" OR ""imperial college london"" OR ""coleg imperial llundain"" OR ""utrecht university"" OR ""universiteit utrecht"" OR ""heidelberg university"" OR ""ruprecht-karls-universität heidelberg"" OR ""university of milan"" OR ""université de milan"" OR ""erasmus university rotterdam"" OR ""erasmus universiteit rotterdam"" OR ""freie universität berlin"" OR ""free university of berlin"" OR ""university of cambridge"" OR ""cambridge university"" OR ""humboldt-universität zu berlin"" OR ""humboldt university of berlin"" OR ""university of zurich"" OR ""universität zürich"" OR ""tel aviv university"" OR ""harvard university"" OR ""universidad de harvard"" OR ""johns hopkins university"" OR ""jhu"" OR ""university of toronto"" OR ""université de toronto"" OR ""university of pennsylvania"" Or ""upenn"" OR ""university of california, san francisco"" OR ""ucsf"" OR ""duke university"" OR ""Universidad de Duke"" OR ""university of michigan"" OR ""umich"" OR ""stanford university"" OR ""leland stanford junior university"" OR ""university of melbourne"" OR ""melbourne university"" OR ""university of sydney"" OR ""sydney university"" OR ""university of são paulo"" OR ""universidade de são paulo"") OR author.affiliation.ror_id_lineage:(""03p74gp79"" OR ""0220qvk04"" OR ""013q1eq08"" OR ""0064kty71"" OR ""00a2xv884"" OR ""02v51f717"" OR ""013xs5b60"" OR ""04h9pn542"" OR ""04jztag35"" OR ""011ashp19"" OR ""059gcgy73"" OR ""00p991c53"" OR ""02jx3x895"" OR ""056d84691"" OR ""052gg0110"" OR ""035b05819"" OR ""05f82e368"" OR ""0220mzb33"" OR ""04dkp9463"" OR ""041kmwe10"" OR ""04pp8hn57"" OR ""038t36y30"" OR ""00wjc7c48"" OR ""057w15z03"" OR ""046ak2485"" OR ""013meh722"" OR ""01hcx6992"" OR ""02crff812"" OR ""04mhzgx49"" OR ""03vek6s52"" OR ""00za53h95"" OR ""03dbr7087"" OR ""00b30xv10"" OR ""043mz5j54"" OR ""00py81415"" OR ""00jmfr291"" OR ""00f54p054"" OR ""01ej9dk98"" OR ""0384j8v12"" OR ""036rp1748"")) AND publication_type:""journal article"" AND date_published>=now-10y AND field_of_study: ((""Medicine"" OR ""Internal medicine"" OR ""Pharmacology"") AND (""Endocrinology"" OR ""Diabetes mellitus"" OR ""Type 2 diabetes"" OR ""Insulin"" OR ""Type 2 Diabetes Mellitus"" OR ""Hypoglycemia"" OR ""Type 1 diabetes"" OR ""Insulin resistance"" OR ""Dyslipidemia"" OR ""Diabetic retinopathy"" OR ""Diabetic nephropathy"" OR ""Endocrine system""))",AND date_published>=now-10y,"AND field_of_study: ((""Medicine"" OR ""Internal medicine"" OR ""Pharmacology"") AND (""Endocrinology"" OR ""Diabetes mellitus"" OR ""Type 2 diabetes"" OR ""Insulin"" OR ""Type 2 Diabetes Mellitus"" OR ""Hypoglycemia"" OR ""Type 1 diabetes"" OR ""Insulin resistance"" OR ""Dyslipidemia"" OR ""Diabetic retinopathy"" OR ""Diabetic nephropathy"" OR ""Endocrine system""))",NA,oa_therapy_area,Uni,Endocrinology,2013,4606,997,1047,352,369,50,2815,1791
endocrinology (primary search + endocrinology tags) - uni,"(author.affiliation.name:(""university of cape town"" OR ""south african college"" OR ""shanghai jiao tong university"" OR ""shanghai communications university"" OR ""fudan university"" OR ""sun yat-sen university"" OR ""zhejiang university"" OR ""chekiang university"" OR ""peking university"" OR ""imperial university of peking"" OR ""capital medical university"" OR ""cmu"" OR ""seoul national university"" OR ""seoul daehakgyo"" OR ""peking union medical college"" OR ""beijing xiehe hospital"" OR ""sichuan university"" OR ""sìchuān dàxué"" OR ""nanjing medical university"" OR ""national jiangsu medical college"" OR ""huazhong university of science and technology"" OR ""huázhōng kējì dàxué"" OR ""university college london"" OR ""london university"" OR ""karolinska institutet"" OR ""royal caroline institute"" OR ""university of oxford"" OR ""oxford university"" OR ""university of copenhagen"" OR ""universität kopenhagen"" OR ""université de paris"" OR ""university of paris"" OR ""king's college london"" OR ""kcl"" OR ""university of amsterdam"" OR ""universiteit van amsterdam"" OR ""imperial college london"" OR ""coleg imperial llundain"" OR ""utrecht university"" OR ""universiteit utrecht"" OR ""heidelberg university"" OR ""ruprecht-karls-universität heidelberg"" OR ""university of milan"" OR ""université de milan"" OR ""erasmus university rotterdam"" OR ""erasmus universiteit rotterdam"" OR ""freie universität berlin"" OR ""free university of berlin"" OR ""university of cambridge"" OR ""cambridge university"" OR ""humboldt-universität zu berlin"" OR ""humboldt university of berlin"" OR ""university of zurich"" OR ""universität zürich"" OR ""tel aviv university"" OR ""harvard university"" OR ""universidad de harvard"" OR ""johns hopkins university"" OR ""jhu"" OR ""university of toronto"" OR ""université de toronto"" OR ""university of pennsylvania"" Or ""upenn"" OR ""university of california, san francisco"" OR ""ucsf"" OR ""duke university"" OR ""Universidad de Duke"" OR ""university of michigan"" OR ""umich"" OR ""stanford university"" OR ""leland stanford junior university"" OR ""university of melbourne"" OR ""melbourne university"" OR ""university of sydney"" OR ""sydney university"" OR ""university of são paulo"" OR ""universidade de são paulo"") OR author.affiliation.ror_id_lineage:(""03p74gp79"" OR ""0220qvk04"" OR ""013q1eq08"" OR ""0064kty71"" OR ""00a2xv884"" OR ""02v51f717"" OR ""013xs5b60"" OR ""04h9pn542"" OR ""04jztag35"" OR ""011ashp19"" OR ""059gcgy73"" OR ""00p991c53"" OR ""02jx3x895"" OR ""056d84691"" OR ""052gg0110"" OR ""035b05819"" OR ""05f82e368"" OR ""0220mzb33"" OR ""04dkp9463"" OR ""041kmwe10"" OR ""04pp8hn57"" OR ""038t36y30"" OR ""00wjc7c48"" OR ""057w15z03"" OR ""046ak2485"" OR ""013meh722"" OR ""01hcx6992"" OR ""02crff812"" OR ""04mhzgx49"" OR ""03vek6s52"" OR ""00za53h95"" OR ""03dbr7087"" OR ""00b30xv10"" OR ""043mz5j54"" OR ""00py81415"" OR ""00jmfr291"" OR ""00f54p054"" OR ""01ej9dk98"" OR ""0384j8v12"" OR ""036rp1748"")) AND publication_type:""journal article"" AND date_published>=now-10y AND field_of_study: ((""Medicine"" OR ""Internal medicine"" OR ""Pharmacology"") AND (""Endocrinology"" OR ""Diabetes mellitus"" OR ""Type 2 diabetes"" OR ""Insulin"" OR ""Type 2 Diabetes Mellitus"" OR ""Hypoglycemia"" OR ""Type 1 diabetes"" OR ""Insulin resistance"" OR ""Dyslipidemia"" OR ""Diabetic retinopathy"" OR ""Diabetic nephropathy"" OR ""Endocrine system""))",AND date_published>=now-10y,"AND field_of_study: ((""Medicine"" OR ""Internal medicine"" OR ""Pharmacology"") AND (""Endocrinology"" OR ""Diabetes mellitus"" OR ""Type 2 diabetes"" OR ""Insulin"" OR ""Type 2 Diabetes Mellitus"" OR ""Hypoglycemia"" OR ""Type 1 diabetes"" OR ""Insulin resistance"" OR ""Dyslipidemia"" OR ""Diabetic retinopathy"" OR ""Diabetic nephropathy"" OR ""Endocrine system""))",NA,oa_therapy_area,Uni,Endocrinology,2014,12565,2851,2842,712,1101,190,7696,4869
endocrinology (primary search + endocrinology tags) - uni,"(author.affiliation.name:(""university of cape town"" OR ""south african college"" OR ""shanghai jiao tong university"" OR ""shanghai communications university"" OR ""fudan university"" OR ""sun yat-sen university"" OR ""zhejiang university"" OR ""chekiang university"" OR ""peking university"" OR ""imperial university of peking"" OR ""capital medical university"" OR ""cmu"" OR ""seoul national university"" OR ""seoul daehakgyo"" OR ""peking union medical college"" OR ""beijing xiehe hospital"" OR ""sichuan university"" OR ""sìchuān dàxué"" OR ""nanjing medical university"" OR ""national jiangsu medical college"" OR ""huazhong university of science and technology"" OR ""huázhōng kējì dàxué"" OR ""university college london"" OR ""london university"" OR ""karolinska institutet"" OR ""royal caroline institute"" OR ""university of oxford"" OR ""oxford university"" OR ""university of copenhagen"" OR ""universität kopenhagen"" OR ""université de paris"" OR ""university of paris"" OR ""king's college london"" OR ""kcl"" OR ""university of amsterdam"" OR ""universiteit van amsterdam"" OR ""imperial college london"" OR ""coleg imperial llundain"" OR ""utrecht university"" OR ""universiteit utrecht"" OR ""heidelberg university"" OR ""ruprecht-karls-universität heidelberg"" OR ""university of milan"" OR ""université de milan"" OR ""erasmus university rotterdam"" OR ""erasmus universiteit rotterdam"" OR ""freie universität berlin"" OR ""free university of berlin"" OR ""university of cambridge"" OR ""cambridge university"" OR ""humboldt-universität zu berlin"" OR ""humboldt university of berlin"" OR ""university of zurich"" OR ""universität zürich"" OR ""tel aviv university"" OR ""harvard university"" OR ""universidad de harvard"" OR ""johns hopkins university"" OR ""jhu"" OR ""university of toronto"" OR ""université de toronto"" OR ""university of pennsylvania"" Or ""upenn"" OR ""university of california, san francisco"" OR ""ucsf"" OR ""duke university"" OR ""Universidad de Duke"" OR ""university of michigan"" OR ""umich"" OR ""stanford university"" OR ""leland stanford junior university"" OR ""university of melbourne"" OR ""melbourne university"" OR ""university of sydney"" OR ""sydney university"" OR ""university of são paulo"" OR ""universidade de são paulo"") OR author.affiliation.ror_id_lineage:(""03p74gp79"" OR ""0220qvk04"" OR ""013q1eq08"" OR ""0064kty71"" OR ""00a2xv884"" OR ""02v51f717"" OR ""013xs5b60"" OR ""04h9pn542"" OR ""04jztag35"" OR ""011ashp19"" OR ""059gcgy73"" OR ""00p991c53"" OR ""02jx3x895"" OR ""056d84691"" OR ""052gg0110"" OR ""035b05819"" OR ""05f82e368"" OR ""0220mzb33"" OR ""04dkp9463"" OR ""041kmwe10"" OR ""04pp8hn57"" OR ""038t36y30"" OR ""00wjc7c48"" OR ""057w15z03"" OR ""046ak2485"" OR ""013meh722"" OR ""01hcx6992"" OR ""02crff812"" OR ""04mhzgx49"" OR ""03vek6s52"" OR ""00za53h95"" OR ""03dbr7087"" OR ""00b30xv10"" OR ""043mz5j54"" OR ""00py81415"" OR ""00jmfr291"" OR ""00f54p054"" OR ""01ej9dk98"" OR ""0384j8v12"" OR ""036rp1748"")) AND publication_type:""journal article"" AND date_published>=now-10y AND field_of_study: ((""Medicine"" OR ""Internal medicine"" OR ""Pharmacology"") AND (""Endocrinology"" OR ""Diabetes mellitus"" OR ""Type 2 diabetes"" OR ""Insulin"" OR ""Type 2 Diabetes Mellitus"" OR ""Hypoglycemia"" OR ""Type 1 diabetes"" OR ""Insulin resistance"" OR ""Dyslipidemia"" OR ""Diabetic retinopathy"" OR ""Diabetic nephropathy"" OR ""Endocrine system""))",AND date_published>=now-10y,"AND field_of_study: ((""Medicine"" OR ""Internal medicine"" OR ""Pharmacology"") AND (""Endocrinology"" OR ""Diabetes mellitus"" OR ""Type 2 diabetes"" OR ""Insulin"" OR ""Type 2 Diabetes Mellitus"" OR ""Hypoglycemia"" OR ""Type 1 diabetes"" OR ""Insulin resistance"" OR ""Dyslipidemia"" OR ""Diabetic retinopathy"" OR ""Diabetic nephropathy"" OR ""Endocrine system""))",NA,oa_therapy_area,Uni,Endocrinology,2015,12652,3184,2858,614,1139,272,8067,4585
endocrinology (primary search + endocrinology tags) - uni,"(author.affiliation.name:(""university of cape town"" OR ""south african college"" OR ""shanghai jiao tong university"" OR ""shanghai communications university"" OR ""fudan university"" OR ""sun yat-sen university"" OR ""zhejiang university"" OR ""chekiang university"" OR ""peking university"" OR ""imperial university of peking"" OR ""capital medical university"" OR ""cmu"" OR ""seoul national university"" OR ""seoul daehakgyo"" OR ""peking union medical college"" OR ""beijing xiehe hospital"" OR ""sichuan university"" OR ""sìchuān dàxué"" OR ""nanjing medical university"" OR ""national jiangsu medical college"" OR ""huazhong university of science and technology"" OR ""huázhōng kējì dàxué"" OR ""university college london"" OR ""london university"" OR ""karolinska institutet"" OR ""royal caroline institute"" OR ""university of oxford"" OR ""oxford university"" OR ""university of copenhagen"" OR ""universität kopenhagen"" OR ""université de paris"" OR ""university of paris"" OR ""king's college london"" OR ""kcl"" OR ""university of amsterdam"" OR ""universiteit van amsterdam"" OR ""imperial college london"" OR ""coleg imperial llundain"" OR ""utrecht university"" OR ""universiteit utrecht"" OR ""heidelberg university"" OR ""ruprecht-karls-universität heidelberg"" OR ""university of milan"" OR ""université de milan"" OR ""erasmus university rotterdam"" OR ""erasmus universiteit rotterdam"" OR ""freie universität berlin"" OR ""free university of berlin"" OR ""university of cambridge"" OR ""cambridge university"" OR ""humboldt-universität zu berlin"" OR ""humboldt university of berlin"" OR ""university of zurich"" OR ""universität zürich"" OR ""tel aviv university"" OR ""harvard university"" OR ""universidad de harvard"" OR ""johns hopkins university"" OR ""jhu"" OR ""university of toronto"" OR ""université de toronto"" OR ""university of pennsylvania"" Or ""upenn"" OR ""university of california, san francisco"" OR ""ucsf"" OR ""duke university"" OR ""Universidad de Duke"" OR ""university of michigan"" OR ""umich"" OR ""stanford university"" OR ""leland stanford junior university"" OR ""university of melbourne"" OR ""melbourne university"" OR ""university of sydney"" OR ""sydney university"" OR ""university of são paulo"" OR ""universidade de são paulo"") OR author.affiliation.ror_id_lineage:(""03p74gp79"" OR ""0220qvk04"" OR ""013q1eq08"" OR ""0064kty71"" OR ""00a2xv884"" OR ""02v51f717"" OR ""013xs5b60"" OR ""04h9pn542"" OR ""04jztag35"" OR ""011ashp19"" OR ""059gcgy73"" OR ""00p991c53"" OR ""02jx3x895"" OR ""056d84691"" OR ""052gg0110"" OR ""035b05819"" OR ""05f82e368"" OR ""0220mzb33"" OR ""04dkp9463"" OR ""041kmwe10"" OR ""04pp8hn57"" OR ""038t36y30"" OR ""00wjc7c48"" OR ""057w15z03"" OR ""046ak2485"" OR ""013meh722"" OR ""01hcx6992"" OR ""02crff812"" OR ""04mhzgx49"" OR ""03vek6s52"" OR ""00za53h95"" OR ""03dbr7087"" OR ""00b30xv10"" OR ""043mz5j54"" OR ""00py81415"" OR ""00jmfr291"" OR ""00f54p054"" OR ""01ej9dk98"" OR ""0384j8v12"" OR ""036rp1748"")) AND publication_type:""journal article"" AND date_published>=now-10y AND field_of_study: ((""Medicine"" OR ""Internal medicine"" OR ""Pharmacology"") AND (""Endocrinology"" OR ""Diabetes mellitus"" OR ""Type 2 diabetes"" OR ""Insulin"" OR ""Type 2 Diabetes Mellitus"" OR ""Hypoglycemia"" OR ""Type 1 diabetes"" OR ""Insulin resistance"" OR ""Dyslipidemia"" OR ""Diabetic retinopathy"" OR ""Diabetic nephropathy"" OR ""Endocrine system""))",AND date_published>=now-10y,"AND field_of_study: ((""Medicine"" OR ""Internal medicine"" OR ""Pharmacology"") AND (""Endocrinology"" OR ""Diabetes mellitus"" OR ""Type 2 diabetes"" OR ""Insulin"" OR ""Type 2 Diabetes Mellitus"" OR ""Hypoglycemia"" OR ""Type 1 diabetes"" OR ""Insulin resistance"" OR ""Dyslipidemia"" OR ""Diabetic retinopathy"" OR ""Diabetic nephropathy"" OR ""Endocrine system""))",NA,oa_therapy_area,Uni,Endocrinology,2016,12514,3470,2893,729,1022,182,8296,4218
endocrinology (primary search + endocrinology tags) - uni,"(author.affiliation.name:(""university of cape town"" OR ""south african college"" OR ""shanghai jiao tong university"" OR ""shanghai communications university"" OR ""fudan university"" OR ""sun yat-sen university"" OR ""zhejiang university"" OR ""chekiang university"" OR ""peking university"" OR ""imperial university of peking"" OR ""capital medical university"" OR ""cmu"" OR ""seoul national university"" OR ""seoul daehakgyo"" OR ""peking union medical college"" OR ""beijing xiehe hospital"" OR ""sichuan university"" OR ""sìchuān dàxué"" OR ""nanjing medical university"" OR ""national jiangsu medical college"" OR ""huazhong university of science and technology"" OR ""huázhōng kējì dàxué"" OR ""university college london"" OR ""london university"" OR ""karolinska institutet"" OR ""royal caroline institute"" OR ""university of oxford"" OR ""oxford university"" OR ""university of copenhagen"" OR ""universität kopenhagen"" OR ""université de paris"" OR ""university of paris"" OR ""king's college london"" OR ""kcl"" OR ""university of amsterdam"" OR ""universiteit van amsterdam"" OR ""imperial college london"" OR ""coleg imperial llundain"" OR ""utrecht university"" OR ""universiteit utrecht"" OR ""heidelberg university"" OR ""ruprecht-karls-universität heidelberg"" OR ""university of milan"" OR ""université de milan"" OR ""erasmus university rotterdam"" OR ""erasmus universiteit rotterdam"" OR ""freie universität berlin"" OR ""free university of berlin"" OR ""university of cambridge"" OR ""cambridge university"" OR ""humboldt-universität zu berlin"" OR ""humboldt university of berlin"" OR ""university of zurich"" OR ""universität zürich"" OR ""tel aviv university"" OR ""harvard university"" OR ""universidad de harvard"" OR ""johns hopkins university"" OR ""jhu"" OR ""university of toronto"" OR ""université de toronto"" OR ""university of pennsylvania"" Or ""upenn"" OR ""university of california, san francisco"" OR ""ucsf"" OR ""duke university"" OR ""Universidad de Duke"" OR ""university of michigan"" OR ""umich"" OR ""stanford university"" OR ""leland stanford junior university"" OR ""university of melbourne"" OR ""melbourne university"" OR ""university of sydney"" OR ""sydney university"" OR ""university of são paulo"" OR ""universidade de são paulo"") OR author.affiliation.ror_id_lineage:(""03p74gp79"" OR ""0220qvk04"" OR ""013q1eq08"" OR ""0064kty71"" OR ""00a2xv884"" OR ""02v51f717"" OR ""013xs5b60"" OR ""04h9pn542"" OR ""04jztag35"" OR ""011ashp19"" OR ""059gcgy73"" OR ""00p991c53"" OR ""02jx3x895"" OR ""056d84691"" OR ""052gg0110"" OR ""035b05819"" OR ""05f82e368"" OR ""0220mzb33"" OR ""04dkp9463"" OR ""041kmwe10"" OR ""04pp8hn57"" OR ""038t36y30"" OR ""00wjc7c48"" OR ""057w15z03"" OR ""046ak2485"" OR ""013meh722"" OR ""01hcx6992"" OR ""02crff812"" OR ""04mhzgx49"" OR ""03vek6s52"" OR ""00za53h95"" OR ""03dbr7087"" OR ""00b30xv10"" OR ""043mz5j54"" OR ""00py81415"" OR ""00jmfr291"" OR ""00f54p054"" OR ""01ej9dk98"" OR ""0384j8v12"" OR ""036rp1748"")) AND publication_type:""journal article"" AND date_published>=now-10y AND field_of_study: ((""Medicine"" OR ""Internal medicine"" OR ""Pharmacology"") AND (""Endocrinology"" OR ""Diabetes mellitus"" OR ""Type 2 diabetes"" OR ""Insulin"" OR ""Type 2 Diabetes Mellitus"" OR ""Hypoglycemia"" OR ""Type 1 diabetes"" OR ""Insulin resistance"" OR ""Dyslipidemia"" OR ""Diabetic retinopathy"" OR ""Diabetic nephropathy"" OR ""Endocrine system""))",AND date_published>=now-10y,"AND field_of_study: ((""Medicine"" OR ""Internal medicine"" OR ""Pharmacology"") AND (""Endocrinology"" OR ""Diabetes mellitus"" OR ""Type 2 diabetes"" OR ""Insulin"" OR ""Type 2 Diabetes Mellitus"" OR ""Hypoglycemia"" OR ""Type 1 diabetes"" OR ""Insulin resistance"" OR ""Dyslipidemia"" OR ""Diabetic retinopathy"" OR ""Diabetic nephropathy"" OR ""Endocrine system""))",NA,oa_therapy_area,Uni,Endocrinology,2017,12480,3918,2740,778,1015,189,8640,3840
endocrinology (primary search + endocrinology tags) - uni,"(author.affiliation.name:(""university of cape town"" OR ""south african college"" OR ""shanghai jiao tong university"" OR ""shanghai communications university"" OR ""fudan university"" OR ""sun yat-sen university"" OR ""zhejiang university"" OR ""chekiang university"" OR ""peking university"" OR ""imperial university of peking"" OR ""capital medical university"" OR ""cmu"" OR ""seoul national university"" OR ""seoul daehakgyo"" OR ""peking union medical college"" OR ""beijing xiehe hospital"" OR ""sichuan university"" OR ""sìchuān dàxué"" OR ""nanjing medical university"" OR ""national jiangsu medical college"" OR ""huazhong university of science and technology"" OR ""huázhōng kējì dàxué"" OR ""university college london"" OR ""london university"" OR ""karolinska institutet"" OR ""royal caroline institute"" OR ""university of oxford"" OR ""oxford university"" OR ""university of copenhagen"" OR ""universität kopenhagen"" OR ""université de paris"" OR ""university of paris"" OR ""king's college london"" OR ""kcl"" OR ""university of amsterdam"" OR ""universiteit van amsterdam"" OR ""imperial college london"" OR ""coleg imperial llundain"" OR ""utrecht university"" OR ""universiteit utrecht"" OR ""heidelberg university"" OR ""ruprecht-karls-universität heidelberg"" OR ""university of milan"" OR ""université de milan"" OR ""erasmus university rotterdam"" OR ""erasmus universiteit rotterdam"" OR ""freie universität berlin"" OR ""free university of berlin"" OR ""university of cambridge"" OR ""cambridge university"" OR ""humboldt-universität zu berlin"" OR ""humboldt university of berlin"" OR ""university of zurich"" OR ""universität zürich"" OR ""tel aviv university"" OR ""harvard university"" OR ""universidad de harvard"" OR ""johns hopkins university"" OR ""jhu"" OR ""university of toronto"" OR ""université de toronto"" OR ""university of pennsylvania"" Or ""upenn"" OR ""university of california, san francisco"" OR ""ucsf"" OR ""duke university"" OR ""Universidad de Duke"" OR ""university of michigan"" OR ""umich"" OR ""stanford university"" OR ""leland stanford junior university"" OR ""university of melbourne"" OR ""melbourne university"" OR ""university of sydney"" OR ""sydney university"" OR ""university of são paulo"" OR ""universidade de são paulo"") OR author.affiliation.ror_id_lineage:(""03p74gp79"" OR ""0220qvk04"" OR ""013q1eq08"" OR ""0064kty71"" OR ""00a2xv884"" OR ""02v51f717"" OR ""013xs5b60"" OR ""04h9pn542"" OR ""04jztag35"" OR ""011ashp19"" OR ""059gcgy73"" OR ""00p991c53"" OR ""02jx3x895"" OR ""056d84691"" OR ""052gg0110"" OR ""035b05819"" OR ""05f82e368"" OR ""0220mzb33"" OR ""04dkp9463"" OR ""041kmwe10"" OR ""04pp8hn57"" OR ""038t36y30"" OR ""00wjc7c48"" OR ""057w15z03"" OR ""046ak2485"" OR ""013meh722"" OR ""01hcx6992"" OR ""02crff812"" OR ""04mhzgx49"" OR ""03vek6s52"" OR ""00za53h95"" OR ""03dbr7087"" OR ""00b30xv10"" OR ""043mz5j54"" OR ""00py81415"" OR ""00jmfr291"" OR ""00f54p054"" OR ""01ej9dk98"" OR ""0384j8v12"" OR ""036rp1748"")) AND publication_type:""journal article"" AND date_published>=now-10y AND field_of_study: ((""Medicine"" OR ""Internal medicine"" OR ""Pharmacology"") AND (""Endocrinology"" OR ""Diabetes mellitus"" OR ""Type 2 diabetes"" OR ""Insulin"" OR ""Type 2 Diabetes Mellitus"" OR ""Hypoglycemia"" OR ""Type 1 diabetes"" OR ""Insulin resistance"" OR ""Dyslipidemia"" OR ""Diabetic retinopathy"" OR ""Diabetic nephropathy"" OR ""Endocrine system""))",AND date_published>=now-10y,"AND field_of_study: ((""Medicine"" OR ""Internal medicine"" OR ""Pharmacology"") AND (""Endocrinology"" OR ""Diabetes mellitus"" OR ""Type 2 diabetes"" OR ""Insulin"" OR ""Type 2 Diabetes Mellitus"" OR ""Hypoglycemia"" OR ""Type 1 diabetes"" OR ""Insulin resistance"" OR ""Dyslipidemia"" OR ""Diabetic retinopathy"" OR ""Diabetic nephropathy"" OR ""Endocrine system""))",NA,oa_therapy_area,Uni,Endocrinology,2018,9986,3021,2023,707,823,145,6719,3267
endocrinology (primary search + endocrinology tags) - uni,"(author.affiliation.name:(""university of cape town"" OR ""south african college"" OR ""shanghai jiao tong university"" OR ""shanghai communications university"" OR ""fudan university"" OR ""sun yat-sen university"" OR ""zhejiang university"" OR ""chekiang university"" OR ""peking university"" OR ""imperial university of peking"" OR ""capital medical university"" OR ""cmu"" OR ""seoul national university"" OR ""seoul daehakgyo"" OR ""peking union medical college"" OR ""beijing xiehe hospital"" OR ""sichuan university"" OR ""sìchuān dàxué"" OR ""nanjing medical university"" OR ""national jiangsu medical college"" OR ""huazhong university of science and technology"" OR ""huázhōng kējì dàxué"" OR ""university college london"" OR ""london university"" OR ""karolinska institutet"" OR ""royal caroline institute"" OR ""university of oxford"" OR ""oxford university"" OR ""university of copenhagen"" OR ""universität kopenhagen"" OR ""université de paris"" OR ""university of paris"" OR ""king's college london"" OR ""kcl"" OR ""university of amsterdam"" OR ""universiteit van amsterdam"" OR ""imperial college london"" OR ""coleg imperial llundain"" OR ""utrecht university"" OR ""universiteit utrecht"" OR ""heidelberg university"" OR ""ruprecht-karls-universität heidelberg"" OR ""university of milan"" OR ""université de milan"" OR ""erasmus university rotterdam"" OR ""erasmus universiteit rotterdam"" OR ""freie universität berlin"" OR ""free university of berlin"" OR ""university of cambridge"" OR ""cambridge university"" OR ""humboldt-universität zu berlin"" OR ""humboldt university of berlin"" OR ""university of zurich"" OR ""universität zürich"" OR ""tel aviv university"" OR ""harvard university"" OR ""universidad de harvard"" OR ""johns hopkins university"" OR ""jhu"" OR ""university of toronto"" OR ""université de toronto"" OR ""university of pennsylvania"" Or ""upenn"" OR ""university of california, san francisco"" OR ""ucsf"" OR ""duke university"" OR ""Universidad de Duke"" OR ""university of michigan"" OR ""umich"" OR ""stanford university"" OR ""leland stanford junior university"" OR ""university of melbourne"" OR ""melbourne university"" OR ""university of sydney"" OR ""sydney university"" OR ""university of são paulo"" OR ""universidade de são paulo"") OR author.affiliation.ror_id_lineage:(""03p74gp79"" OR ""0220qvk04"" OR ""013q1eq08"" OR ""0064kty71"" OR ""00a2xv884"" OR ""02v51f717"" OR ""013xs5b60"" OR ""04h9pn542"" OR ""04jztag35"" OR ""011ashp19"" OR ""059gcgy73"" OR ""00p991c53"" OR ""02jx3x895"" OR ""056d84691"" OR ""052gg0110"" OR ""035b05819"" OR ""05f82e368"" OR ""0220mzb33"" OR ""04dkp9463"" OR ""041kmwe10"" OR ""04pp8hn57"" OR ""038t36y30"" OR ""00wjc7c48"" OR ""057w15z03"" OR ""046ak2485"" OR ""013meh722"" OR ""01hcx6992"" OR ""02crff812"" OR ""04mhzgx49"" OR ""03vek6s52"" OR ""00za53h95"" OR ""03dbr7087"" OR ""00b30xv10"" OR ""043mz5j54"" OR ""00py81415"" OR ""00jmfr291"" OR ""00f54p054"" OR ""01ej9dk98"" OR ""0384j8v12"" OR ""036rp1748"")) AND publication_type:""journal article"" AND date_published>=now-10y AND field_of_study: ((""Medicine"" OR ""Internal medicine"" OR ""Pharmacology"") AND (""Endocrinology"" OR ""Diabetes mellitus"" OR ""Type 2 diabetes"" OR ""Insulin"" OR ""Type 2 Diabetes Mellitus"" OR ""Hypoglycemia"" OR ""Type 1 diabetes"" OR ""Insulin resistance"" OR ""Dyslipidemia"" OR ""Diabetic retinopathy"" OR ""Diabetic nephropathy"" OR ""Endocrine system""))",AND date_published>=now-10y,"AND field_of_study: ((""Medicine"" OR ""Internal medicine"" OR ""Pharmacology"") AND (""Endocrinology"" OR ""Diabetes mellitus"" OR ""Type 2 diabetes"" OR ""Insulin"" OR ""Type 2 Diabetes Mellitus"" OR ""Hypoglycemia"" OR ""Type 1 diabetes"" OR ""Insulin resistance"" OR ""Dyslipidemia"" OR ""Diabetic retinopathy"" OR ""Diabetic nephropathy"" OR ""Endocrine system""))",NA,oa_therapy_area,Uni,Endocrinology,2019,10729,3589,1980,797,798,131,7295,3434
endocrinology (primary search + endocrinology tags) - uni,"(author.affiliation.name:(""university of cape town"" OR ""south african college"" OR ""shanghai jiao tong university"" OR ""shanghai communications university"" OR ""fudan university"" OR ""sun yat-sen university"" OR ""zhejiang university"" OR ""chekiang university"" OR ""peking university"" OR ""imperial university of peking"" OR ""capital medical university"" OR ""cmu"" OR ""seoul national university"" OR ""seoul daehakgyo"" OR ""peking union medical college"" OR ""beijing xiehe hospital"" OR ""sichuan university"" OR ""sìchuān dàxué"" OR ""nanjing medical university"" OR ""national jiangsu medical college"" OR ""huazhong university of science and technology"" OR ""huázhōng kējì dàxué"" OR ""university college london"" OR ""london university"" OR ""karolinska institutet"" OR ""royal caroline institute"" OR ""university of oxford"" OR ""oxford university"" OR ""university of copenhagen"" OR ""universität kopenhagen"" OR ""université de paris"" OR ""university of paris"" OR ""king's college london"" OR ""kcl"" OR ""university of amsterdam"" OR ""universiteit van amsterdam"" OR ""imperial college london"" OR ""coleg imperial llundain"" OR ""utrecht university"" OR ""universiteit utrecht"" OR ""heidelberg university"" OR ""ruprecht-karls-universität heidelberg"" OR ""university of milan"" OR ""université de milan"" OR ""erasmus university rotterdam"" OR ""erasmus universiteit rotterdam"" OR ""freie universität berlin"" OR ""free university of berlin"" OR ""university of cambridge"" OR ""cambridge university"" OR ""humboldt-universität zu berlin"" OR ""humboldt university of berlin"" OR ""university of zurich"" OR ""universität zürich"" OR ""tel aviv university"" OR ""harvard university"" OR ""universidad de harvard"" OR ""johns hopkins university"" OR ""jhu"" OR ""university of toronto"" OR ""université de toronto"" OR ""university of pennsylvania"" Or ""upenn"" OR ""university of california, san francisco"" OR ""ucsf"" OR ""duke university"" OR ""Universidad de Duke"" OR ""university of michigan"" OR ""umich"" OR ""stanford university"" OR ""leland stanford junior university"" OR ""university of melbourne"" OR ""melbourne university"" OR ""university of sydney"" OR ""sydney university"" OR ""university of são paulo"" OR ""universidade de são paulo"") OR author.affiliation.ror_id_lineage:(""03p74gp79"" OR ""0220qvk04"" OR ""013q1eq08"" OR ""0064kty71"" OR ""00a2xv884"" OR ""02v51f717"" OR ""013xs5b60"" OR ""04h9pn542"" OR ""04jztag35"" OR ""011ashp19"" OR ""059gcgy73"" OR ""00p991c53"" OR ""02jx3x895"" OR ""056d84691"" OR ""052gg0110"" OR ""035b05819"" OR ""05f82e368"" OR ""0220mzb33"" OR ""04dkp9463"" OR ""041kmwe10"" OR ""04pp8hn57"" OR ""038t36y30"" OR ""00wjc7c48"" OR ""057w15z03"" OR ""046ak2485"" OR ""013meh722"" OR ""01hcx6992"" OR ""02crff812"" OR ""04mhzgx49"" OR ""03vek6s52"" OR ""00za53h95"" OR ""03dbr7087"" OR ""00b30xv10"" OR ""043mz5j54"" OR ""00py81415"" OR ""00jmfr291"" OR ""00f54p054"" OR ""01ej9dk98"" OR ""0384j8v12"" OR ""036rp1748"")) AND publication_type:""journal article"" AND date_published>=now-10y AND field_of_study: ((""Medicine"" OR ""Internal medicine"" OR ""Pharmacology"") AND (""Endocrinology"" OR ""Diabetes mellitus"" OR ""Type 2 diabetes"" OR ""Insulin"" OR ""Type 2 Diabetes Mellitus"" OR ""Hypoglycemia"" OR ""Type 1 diabetes"" OR ""Insulin resistance"" OR ""Dyslipidemia"" OR ""Diabetic retinopathy"" OR ""Diabetic nephropathy"" OR ""Endocrine system""))",AND date_published>=now-10y,"AND field_of_study: ((""Medicine"" OR ""Internal medicine"" OR ""Pharmacology"") AND (""Endocrinology"" OR ""Diabetes mellitus"" OR ""Type 2 diabetes"" OR ""Insulin"" OR ""Type 2 Diabetes Mellitus"" OR ""Hypoglycemia"" OR ""Type 1 diabetes"" OR ""Insulin resistance"" OR ""Dyslipidemia"" OR ""Diabetic retinopathy"" OR ""Diabetic nephropathy"" OR ""Endocrine system""))",NA,oa_therapy_area,Uni,Endocrinology,2020,12492,4585,2126,1174,715,221,8821,3671
endocrinology (primary search + endocrinology tags) - uni,"(author.affiliation.name:(""university of cape town"" OR ""south african college"" OR ""shanghai jiao tong university"" OR ""shanghai communications university"" OR ""fudan university"" OR ""sun yat-sen university"" OR ""zhejiang university"" OR ""chekiang university"" OR ""peking university"" OR ""imperial university of peking"" OR ""capital medical university"" OR ""cmu"" OR ""seoul national university"" OR ""seoul daehakgyo"" OR ""peking union medical college"" OR ""beijing xiehe hospital"" OR ""sichuan university"" OR ""sìchuān dàxué"" OR ""nanjing medical university"" OR ""national jiangsu medical college"" OR ""huazhong university of science and technology"" OR ""huázhōng kējì dàxué"" OR ""university college london"" OR ""london university"" OR ""karolinska institutet"" OR ""royal caroline institute"" OR ""university of oxford"" OR ""oxford university"" OR ""university of copenhagen"" OR ""universität kopenhagen"" OR ""université de paris"" OR ""university of paris"" OR ""king's college london"" OR ""kcl"" OR ""university of amsterdam"" OR ""universiteit van amsterdam"" OR ""imperial college london"" OR ""coleg imperial llundain"" OR ""utrecht university"" OR ""universiteit utrecht"" OR ""heidelberg university"" OR ""ruprecht-karls-universität heidelberg"" OR ""university of milan"" OR ""université de milan"" OR ""erasmus university rotterdam"" OR ""erasmus universiteit rotterdam"" OR ""freie universität berlin"" OR ""free university of berlin"" OR ""university of cambridge"" OR ""cambridge university"" OR ""humboldt-universität zu berlin"" OR ""humboldt university of berlin"" OR ""university of zurich"" OR ""universität zürich"" OR ""tel aviv university"" OR ""harvard university"" OR ""universidad de harvard"" OR ""johns hopkins university"" OR ""jhu"" OR ""university of toronto"" OR ""université de toronto"" OR ""university of pennsylvania"" Or ""upenn"" OR ""university of california, san francisco"" OR ""ucsf"" OR ""duke university"" OR ""Universidad de Duke"" OR ""university of michigan"" OR ""umich"" OR ""stanford university"" OR ""leland stanford junior university"" OR ""university of melbourne"" OR ""melbourne university"" OR ""university of sydney"" OR ""sydney university"" OR ""university of são paulo"" OR ""universidade de são paulo"") OR author.affiliation.ror_id_lineage:(""03p74gp79"" OR ""0220qvk04"" OR ""013q1eq08"" OR ""0064kty71"" OR ""00a2xv884"" OR ""02v51f717"" OR ""013xs5b60"" OR ""04h9pn542"" OR ""04jztag35"" OR ""011ashp19"" OR ""059gcgy73"" OR ""00p991c53"" OR ""02jx3x895"" OR ""056d84691"" OR ""052gg0110"" OR ""035b05819"" OR ""05f82e368"" OR ""0220mzb33"" OR ""04dkp9463"" OR ""041kmwe10"" OR ""04pp8hn57"" OR ""038t36y30"" OR ""00wjc7c48"" OR ""057w15z03"" OR ""046ak2485"" OR ""013meh722"" OR ""01hcx6992"" OR ""02crff812"" OR ""04mhzgx49"" OR ""03vek6s52"" OR ""00za53h95"" OR ""03dbr7087"" OR ""00b30xv10"" OR ""043mz5j54"" OR ""00py81415"" OR ""00jmfr291"" OR ""00f54p054"" OR ""01ej9dk98"" OR ""0384j8v12"" OR ""036rp1748"")) AND publication_type:""journal article"" AND date_published>=now-10y AND field_of_study: ((""Medicine"" OR ""Internal medicine"" OR ""Pharmacology"") AND (""Endocrinology"" OR ""Diabetes mellitus"" OR ""Type 2 diabetes"" OR ""Insulin"" OR ""Type 2 Diabetes Mellitus"" OR ""Hypoglycemia"" OR ""Type 1 diabetes"" OR ""Insulin resistance"" OR ""Dyslipidemia"" OR ""Diabetic retinopathy"" OR ""Diabetic nephropathy"" OR ""Endocrine system""))",AND date_published>=now-10y,"AND field_of_study: ((""Medicine"" OR ""Internal medicine"" OR ""Pharmacology"") AND (""Endocrinology"" OR ""Diabetes mellitus"" OR ""Type 2 diabetes"" OR ""Insulin"" OR ""Type 2 Diabetes Mellitus"" OR ""Hypoglycemia"" OR ""Type 1 diabetes"" OR ""Insulin resistance"" OR ""Dyslipidemia"" OR ""Diabetic retinopathy"" OR ""Diabetic nephropathy"" OR ""Endocrine system""))",NA,oa_therapy_area,Uni,Endocrinology,2021,12866,5522,853,1402,571,846,9194,3672
endocrinology (primary search + endocrinology tags) - uni,"(author.affiliation.name:(""university of cape town"" OR ""south african college"" OR ""shanghai jiao tong university"" OR ""shanghai communications university"" OR ""fudan university"" OR ""sun yat-sen university"" OR ""zhejiang university"" OR ""chekiang university"" OR ""peking university"" OR ""imperial university of peking"" OR ""capital medical university"" OR ""cmu"" OR ""seoul national university"" OR ""seoul daehakgyo"" OR ""peking union medical college"" OR ""beijing xiehe hospital"" OR ""sichuan university"" OR ""sìchuān dàxué"" OR ""nanjing medical university"" OR ""national jiangsu medical college"" OR ""huazhong university of science and technology"" OR ""huázhōng kējì dàxué"" OR ""university college london"" OR ""london university"" OR ""karolinska institutet"" OR ""royal caroline institute"" OR ""university of oxford"" OR ""oxford university"" OR ""university of copenhagen"" OR ""universität kopenhagen"" OR ""université de paris"" OR ""university of paris"" OR ""king's college london"" OR ""kcl"" OR ""university of amsterdam"" OR ""universiteit van amsterdam"" OR ""imperial college london"" OR ""coleg imperial llundain"" OR ""utrecht university"" OR ""universiteit utrecht"" OR ""heidelberg university"" OR ""ruprecht-karls-universität heidelberg"" OR ""university of milan"" OR ""université de milan"" OR ""erasmus university rotterdam"" OR ""erasmus universiteit rotterdam"" OR ""freie universität berlin"" OR ""free university of berlin"" OR ""university of cambridge"" OR ""cambridge university"" OR ""humboldt-universität zu berlin"" OR ""humboldt university of berlin"" OR ""university of zurich"" OR ""universität zürich"" OR ""tel aviv university"" OR ""harvard university"" OR ""universidad de harvard"" OR ""johns hopkins university"" OR ""jhu"" OR ""university of toronto"" OR ""université de toronto"" OR ""university of pennsylvania"" Or ""upenn"" OR ""university of california, san francisco"" OR ""ucsf"" OR ""duke university"" OR ""Universidad de Duke"" OR ""university of michigan"" OR ""umich"" OR ""stanford university"" OR ""leland stanford junior university"" OR ""university of melbourne"" OR ""melbourne university"" OR ""university of sydney"" OR ""sydney university"" OR ""university of são paulo"" OR ""universidade de são paulo"") OR author.affiliation.ror_id_lineage:(""03p74gp79"" OR ""0220qvk04"" OR ""013q1eq08"" OR ""0064kty71"" OR ""00a2xv884"" OR ""02v51f717"" OR ""013xs5b60"" OR ""04h9pn542"" OR ""04jztag35"" OR ""011ashp19"" OR ""059gcgy73"" OR ""00p991c53"" OR ""02jx3x895"" OR ""056d84691"" OR ""052gg0110"" OR ""035b05819"" OR ""05f82e368"" OR ""0220mzb33"" OR ""04dkp9463"" OR ""041kmwe10"" OR ""04pp8hn57"" OR ""038t36y30"" OR ""00wjc7c48"" OR ""057w15z03"" OR ""046ak2485"" OR ""013meh722"" OR ""01hcx6992"" OR ""02crff812"" OR ""04mhzgx49"" OR ""03vek6s52"" OR ""00za53h95"" OR ""03dbr7087"" OR ""00b30xv10"" OR ""043mz5j54"" OR ""00py81415"" OR ""00jmfr291"" OR ""00f54p054"" OR ""01ej9dk98"" OR ""0384j8v12"" OR ""036rp1748"")) AND publication_type:""journal article"" AND date_published>=now-10y AND field_of_study: ((""Medicine"" OR ""Internal medicine"" OR ""Pharmacology"") AND (""Endocrinology"" OR ""Diabetes mellitus"" OR ""Type 2 diabetes"" OR ""Insulin"" OR ""Type 2 Diabetes Mellitus"" OR ""Hypoglycemia"" OR ""Type 1 diabetes"" OR ""Insulin resistance"" OR ""Dyslipidemia"" OR ""Diabetic retinopathy"" OR ""Diabetic nephropathy"" OR ""Endocrine system""))",AND date_published>=now-10y,"AND field_of_study: ((""Medicine"" OR ""Internal medicine"" OR ""Pharmacology"") AND (""Endocrinology"" OR ""Diabetes mellitus"" OR ""Type 2 diabetes"" OR ""Insulin"" OR ""Type 2 Diabetes Mellitus"" OR ""Hypoglycemia"" OR ""Type 1 diabetes"" OR ""Insulin resistance"" OR ""Dyslipidemia"" OR ""Diabetic retinopathy"" OR ""Diabetic nephropathy"" OR ""Endocrine system""))",NA,oa_therapy_area,Uni,Endocrinology,2022,18032,8564,1179,1782,717,568,12810,5222
endocrinology (primary search + endocrinology tags) - uni,"(author.affiliation.name:(""university of cape town"" OR ""south african college"" OR ""shanghai jiao tong university"" OR ""shanghai communications university"" OR ""fudan university"" OR ""sun yat-sen university"" OR ""zhejiang university"" OR ""chekiang university"" OR ""peking university"" OR ""imperial university of peking"" OR ""capital medical university"" OR ""cmu"" OR ""seoul national university"" OR ""seoul daehakgyo"" OR ""peking union medical college"" OR ""beijing xiehe hospital"" OR ""sichuan university"" OR ""sìchuān dàxué"" OR ""nanjing medical university"" OR ""national jiangsu medical college"" OR ""huazhong university of science and technology"" OR ""huázhōng kējì dàxué"" OR ""university college london"" OR ""london university"" OR ""karolinska institutet"" OR ""royal caroline institute"" OR ""university of oxford"" OR ""oxford university"" OR ""university of copenhagen"" OR ""universität kopenhagen"" OR ""université de paris"" OR ""university of paris"" OR ""king's college london"" OR ""kcl"" OR ""university of amsterdam"" OR ""universiteit van amsterdam"" OR ""imperial college london"" OR ""coleg imperial llundain"" OR ""utrecht university"" OR ""universiteit utrecht"" OR ""heidelberg university"" OR ""ruprecht-karls-universität heidelberg"" OR ""university of milan"" OR ""université de milan"" OR ""erasmus university rotterdam"" OR ""erasmus universiteit rotterdam"" OR ""freie universität berlin"" OR ""free university of berlin"" OR ""university of cambridge"" OR ""cambridge university"" OR ""humboldt-universität zu berlin"" OR ""humboldt university of berlin"" OR ""university of zurich"" OR ""universität zürich"" OR ""tel aviv university"" OR ""harvard university"" OR ""universidad de harvard"" OR ""johns hopkins university"" OR ""jhu"" OR ""university of toronto"" OR ""université de toronto"" OR ""university of pennsylvania"" Or ""upenn"" OR ""university of california, san francisco"" OR ""ucsf"" OR ""duke university"" OR ""Universidad de Duke"" OR ""university of michigan"" OR ""umich"" OR ""stanford university"" OR ""leland stanford junior university"" OR ""university of melbourne"" OR ""melbourne university"" OR ""university of sydney"" OR ""sydney university"" OR ""university of são paulo"" OR ""universidade de são paulo"") OR author.affiliation.ror_id_lineage:(""03p74gp79"" OR ""0220qvk04"" OR ""013q1eq08"" OR ""0064kty71"" OR ""00a2xv884"" OR ""02v51f717"" OR ""013xs5b60"" OR ""04h9pn542"" OR ""04jztag35"" OR ""011ashp19"" OR ""059gcgy73"" OR ""00p991c53"" OR ""02jx3x895"" OR ""056d84691"" OR ""052gg0110"" OR ""035b05819"" OR ""05f82e368"" OR ""0220mzb33"" OR ""04dkp9463"" OR ""041kmwe10"" OR ""04pp8hn57"" OR ""038t36y30"" OR ""00wjc7c48"" OR ""057w15z03"" OR ""046ak2485"" OR ""013meh722"" OR ""01hcx6992"" OR ""02crff812"" OR ""04mhzgx49"" OR ""03vek6s52"" OR ""00za53h95"" OR ""03dbr7087"" OR ""00b30xv10"" OR ""043mz5j54"" OR ""00py81415"" OR ""00jmfr291"" OR ""00f54p054"" OR ""01ej9dk98"" OR ""0384j8v12"" OR ""036rp1748"")) AND publication_type:""journal article"" AND date_published>=now-10y AND field_of_study: ((""Medicine"" OR ""Internal medicine"" OR ""Pharmacology"") AND (""Endocrinology"" OR ""Diabetes mellitus"" OR ""Type 2 diabetes"" OR ""Insulin"" OR ""Type 2 Diabetes Mellitus"" OR ""Hypoglycemia"" OR ""Type 1 diabetes"" OR ""Insulin resistance"" OR ""Dyslipidemia"" OR ""Diabetic retinopathy"" OR ""Diabetic nephropathy"" OR ""Endocrine system""))",AND date_published>=now-10y,"AND field_of_study: ((""Medicine"" OR ""Internal medicine"" OR ""Pharmacology"") AND (""Endocrinology"" OR ""Diabetes mellitus"" OR ""Type 2 diabetes"" OR ""Insulin"" OR ""Type 2 Diabetes Mellitus"" OR ""Hypoglycemia"" OR ""Type 1 diabetes"" OR ""Insulin resistance"" OR ""Dyslipidemia"" OR ""Diabetic retinopathy"" OR ""Diabetic nephropathy"" OR ""Endocrine system""))",NA,oa_therapy_area,Uni,Endocrinology,2023,6868,3135,159,662,135,410,4501,2367
cardiovascular (primary search + cardiovascular tags) - uni,"(author.affiliation.name:(""university of cape town"" OR ""south african college"" OR ""shanghai jiao tong university"" OR ""shanghai communications university"" OR ""fudan university"" OR ""sun yat-sen university"" OR ""zhejiang university"" OR ""chekiang university"" OR ""peking university"" OR ""imperial university of peking"" OR ""capital medical university"" OR ""cmu"" OR ""seoul national university"" OR ""seoul daehakgyo"" OR ""peking union medical college"" OR ""beijing xiehe hospital"" OR ""sichuan university"" OR ""sìchuān dàxué"" OR ""nanjing medical university"" OR ""national jiangsu medical college"" OR ""huazhong university of science and technology"" OR ""huázhōng kējì dàxué"" OR ""university college london"" OR ""london university"" OR ""karolinska institutet"" OR ""royal caroline institute"" OR ""university of oxford"" OR ""oxford university"" OR ""university of copenhagen"" OR ""universität kopenhagen"" OR ""université de paris"" OR ""university of paris"" OR ""king's college london"" OR ""kcl"" OR ""university of amsterdam"" OR ""universiteit van amsterdam"" OR ""imperial college london"" OR ""coleg imperial llundain"" OR ""utrecht university"" OR ""universiteit utrecht"" OR ""heidelberg university"" OR ""ruprecht-karls-universität heidelberg"" OR ""university of milan"" OR ""université de milan"" OR ""erasmus university rotterdam"" OR ""erasmus universiteit rotterdam"" OR ""freie universität berlin"" OR ""free university of berlin"" OR ""university of cambridge"" OR ""cambridge university"" OR ""humboldt-universität zu berlin"" OR ""humboldt university of berlin"" OR ""university of zurich"" OR ""universität zürich"" OR ""tel aviv university"" OR ""harvard university"" OR ""universidad de harvard"" OR ""johns hopkins university"" OR ""jhu"" OR ""university of toronto"" OR ""université de toronto"" OR ""university of pennsylvania"" Or ""upenn"" OR ""university of california, san francisco"" OR ""ucsf"" OR ""duke university"" OR ""Universidad de Duke"" OR ""university of michigan"" OR ""umich"" OR ""stanford university"" OR ""leland stanford junior university"" OR ""university of melbourne"" OR ""melbourne university"" OR ""university of sydney"" OR ""sydney university"" OR ""university of são paulo"" OR ""universidade de são paulo"") OR author.affiliation.ror_id_lineage:(""03p74gp79"" OR ""0220qvk04"" OR ""013q1eq08"" OR ""0064kty71"" OR ""00a2xv884"" OR ""02v51f717"" OR ""013xs5b60"" OR ""04h9pn542"" OR ""04jztag35"" OR ""011ashp19"" OR ""059gcgy73"" OR ""00p991c53"" OR ""02jx3x895"" OR ""056d84691"" OR ""052gg0110"" OR ""035b05819"" OR ""05f82e368"" OR ""0220mzb33"" OR ""04dkp9463"" OR ""041kmwe10"" OR ""04pp8hn57"" OR ""038t36y30"" OR ""00wjc7c48"" OR ""057w15z03"" OR ""046ak2485"" OR ""013meh722"" OR ""01hcx6992"" OR ""02crff812"" OR ""04mhzgx49"" OR ""03vek6s52"" OR ""00za53h95"" OR ""03dbr7087"" OR ""00b30xv10"" OR ""043mz5j54"" OR ""00py81415"" OR ""00jmfr291"" OR ""00f54p054"" OR ""01ej9dk98"" OR ""0384j8v12"" OR ""036rp1748"")) AND publication_type:""journal article"" AND date_published>=now-10y AND field_of_study: ((""Medicine"" OR ""Internal medicine"" OR ""Pharmacology"") AND (""Cardiology"" OR ""Heart failure"" OR ""Atrial fibrillation"" OR ""Myocardial infarction"" OR ""Stroke"" OR ""Blood pressure"" OR ""Acute coronary syndrome"" OR ""Coronary artery disease"" OR ""Thrombosis"" OR ""QT interval"" OR ""Heart rate"" OR ""Heart failure with preserved ejection fraction"" OR ""Cardiomyopathy""))",AND date_published>=now-10y,"AND field_of_study: ((""Medicine"" OR ""Internal medicine"" OR ""Pharmacology"") AND (""Cardiology"" OR ""Heart failure"" OR ""Atrial fibrillation"" OR ""Myocardial infarction"" OR ""Stroke"" OR ""Blood pressure"" OR ""Acute coronary syndrome"" OR ""Coronary artery disease"" OR ""Thrombosis"" OR ""QT interval"" OR ""Heart rate"" OR ""Heart failure with preserved ejection fraction"" OR ""Cardiomyopathy""))",NA,oa_therapy_area,Uni,Cardiovascular,2013,3651,594,669,141,406,148,1958,1693
cardiovascular (primary search + cardiovascular tags) - uni,"(author.affiliation.name:(""university of cape town"" OR ""south african college"" OR ""shanghai jiao tong university"" OR ""shanghai communications university"" OR ""fudan university"" OR ""sun yat-sen university"" OR ""zhejiang university"" OR ""chekiang university"" OR ""peking university"" OR ""imperial university of peking"" OR ""capital medical university"" OR ""cmu"" OR ""seoul national university"" OR ""seoul daehakgyo"" OR ""peking union medical college"" OR ""beijing xiehe hospital"" OR ""sichuan university"" OR ""sìchuān dàxué"" OR ""nanjing medical university"" OR ""national jiangsu medical college"" OR ""huazhong university of science and technology"" OR ""huázhōng kējì dàxué"" OR ""university college london"" OR ""london university"" OR ""karolinska institutet"" OR ""royal caroline institute"" OR ""university of oxford"" OR ""oxford university"" OR ""university of copenhagen"" OR ""universität kopenhagen"" OR ""université de paris"" OR ""university of paris"" OR ""king's college london"" OR ""kcl"" OR ""university of amsterdam"" OR ""universiteit van amsterdam"" OR ""imperial college london"" OR ""coleg imperial llundain"" OR ""utrecht university"" OR ""universiteit utrecht"" OR ""heidelberg university"" OR ""ruprecht-karls-universität heidelberg"" OR ""university of milan"" OR ""université de milan"" OR ""erasmus university rotterdam"" OR ""erasmus universiteit rotterdam"" OR ""freie universität berlin"" OR ""free university of berlin"" OR ""university of cambridge"" OR ""cambridge university"" OR ""humboldt-universität zu berlin"" OR ""humboldt university of berlin"" OR ""university of zurich"" OR ""universität zürich"" OR ""tel aviv university"" OR ""harvard university"" OR ""universidad de harvard"" OR ""johns hopkins university"" OR ""jhu"" OR ""university of toronto"" OR ""université de toronto"" OR ""university of pennsylvania"" Or ""upenn"" OR ""university of california, san francisco"" OR ""ucsf"" OR ""duke university"" OR ""Universidad de Duke"" OR ""university of michigan"" OR ""umich"" OR ""stanford university"" OR ""leland stanford junior university"" OR ""university of melbourne"" OR ""melbourne university"" OR ""university of sydney"" OR ""sydney university"" OR ""university of são paulo"" OR ""universidade de são paulo"") OR author.affiliation.ror_id_lineage:(""03p74gp79"" OR ""0220qvk04"" OR ""013q1eq08"" OR ""0064kty71"" OR ""00a2xv884"" OR ""02v51f717"" OR ""013xs5b60"" OR ""04h9pn542"" OR ""04jztag35"" OR ""011ashp19"" OR ""059gcgy73"" OR ""00p991c53"" OR ""02jx3x895"" OR ""056d84691"" OR ""052gg0110"" OR ""035b05819"" OR ""05f82e368"" OR ""0220mzb33"" OR ""04dkp9463"" OR ""041kmwe10"" OR ""04pp8hn57"" OR ""038t36y30"" OR ""00wjc7c48"" OR ""057w15z03"" OR ""046ak2485"" OR ""013meh722"" OR ""01hcx6992"" OR ""02crff812"" OR ""04mhzgx49"" OR ""03vek6s52"" OR ""00za53h95"" OR ""03dbr7087"" OR ""00b30xv10"" OR ""043mz5j54"" OR ""00py81415"" OR ""00jmfr291"" OR ""00f54p054"" OR ""01ej9dk98"" OR ""0384j8v12"" OR ""036rp1748"")) AND publication_type:""journal article"" AND date_published>=now-10y AND field_of_study: ((""Medicine"" OR ""Internal medicine"" OR ""Pharmacology"") AND (""Cardiology"" OR ""Heart failure"" OR ""Atrial fibrillation"" OR ""Myocardial infarction"" OR ""Stroke"" OR ""Blood pressure"" OR ""Acute coronary syndrome"" OR ""Coronary artery disease"" OR ""Thrombosis"" OR ""QT interval"" OR ""Heart rate"" OR ""Heart failure with preserved ejection fraction"" OR ""Cardiomyopathy""))",AND date_published>=now-10y,"AND field_of_study: ((""Medicine"" OR ""Internal medicine"" OR ""Pharmacology"") AND (""Cardiology"" OR ""Heart failure"" OR ""Atrial fibrillation"" OR ""Myocardial infarction"" OR ""Stroke"" OR ""Blood pressure"" OR ""Acute coronary syndrome"" OR ""Coronary artery disease"" OR ""Thrombosis"" OR ""QT interval"" OR ""Heart rate"" OR ""Heart failure with preserved ejection fraction"" OR ""Cardiomyopathy""))",NA,oa_therapy_area,Uni,Cardiovascular,2014,9794,1714,1779,332,1045,348,5218,4576
cardiovascular (primary search + cardiovascular tags) - uni,"(author.affiliation.name:(""university of cape town"" OR ""south african college"" OR ""shanghai jiao tong university"" OR ""shanghai communications university"" OR ""fudan university"" OR ""sun yat-sen university"" OR ""zhejiang university"" OR ""chekiang university"" OR ""peking university"" OR ""imperial university of peking"" OR ""capital medical university"" OR ""cmu"" OR ""seoul national university"" OR ""seoul daehakgyo"" OR ""peking union medical college"" OR ""beijing xiehe hospital"" OR ""sichuan university"" OR ""sìchuān dàxué"" OR ""nanjing medical university"" OR ""national jiangsu medical college"" OR ""huazhong university of science and technology"" OR ""huázhōng kējì dàxué"" OR ""university college london"" OR ""london university"" OR ""karolinska institutet"" OR ""royal caroline institute"" OR ""university of oxford"" OR ""oxford university"" OR ""university of copenhagen"" OR ""universität kopenhagen"" OR ""université de paris"" OR ""university of paris"" OR ""king's college london"" OR ""kcl"" OR ""university of amsterdam"" OR ""universiteit van amsterdam"" OR ""imperial college london"" OR ""coleg imperial llundain"" OR ""utrecht university"" OR ""universiteit utrecht"" OR ""heidelberg university"" OR ""ruprecht-karls-universität heidelberg"" OR ""university of milan"" OR ""université de milan"" OR ""erasmus university rotterdam"" OR ""erasmus universiteit rotterdam"" OR ""freie universität berlin"" OR ""free university of berlin"" OR ""university of cambridge"" OR ""cambridge university"" OR ""humboldt-universität zu berlin"" OR ""humboldt university of berlin"" OR ""university of zurich"" OR ""universität zürich"" OR ""tel aviv university"" OR ""harvard university"" OR ""universidad de harvard"" OR ""johns hopkins university"" OR ""jhu"" OR ""university of toronto"" OR ""université de toronto"" OR ""university of pennsylvania"" Or ""upenn"" OR ""university of california, san francisco"" OR ""ucsf"" OR ""duke university"" OR ""Universidad de Duke"" OR ""university of michigan"" OR ""umich"" OR ""stanford university"" OR ""leland stanford junior university"" OR ""university of melbourne"" OR ""melbourne university"" OR ""university of sydney"" OR ""sydney university"" OR ""university of são paulo"" OR ""universidade de são paulo"") OR author.affiliation.ror_id_lineage:(""03p74gp79"" OR ""0220qvk04"" OR ""013q1eq08"" OR ""0064kty71"" OR ""00a2xv884"" OR ""02v51f717"" OR ""013xs5b60"" OR ""04h9pn542"" OR ""04jztag35"" OR ""011ashp19"" OR ""059gcgy73"" OR ""00p991c53"" OR ""02jx3x895"" OR ""056d84691"" OR ""052gg0110"" OR ""035b05819"" OR ""05f82e368"" OR ""0220mzb33"" OR ""04dkp9463"" OR ""041kmwe10"" OR ""04pp8hn57"" OR ""038t36y30"" OR ""00wjc7c48"" OR ""057w15z03"" OR ""046ak2485"" OR ""013meh722"" OR ""01hcx6992"" OR ""02crff812"" OR ""04mhzgx49"" OR ""03vek6s52"" OR ""00za53h95"" OR ""03dbr7087"" OR ""00b30xv10"" OR ""043mz5j54"" OR ""00py81415"" OR ""00jmfr291"" OR ""00f54p054"" OR ""01ej9dk98"" OR ""0384j8v12"" OR ""036rp1748"")) AND publication_type:""journal article"" AND date_published>=now-10y AND field_of_study: ((""Medicine"" OR ""Internal medicine"" OR ""Pharmacology"") AND (""Cardiology"" OR ""Heart failure"" OR ""Atrial fibrillation"" OR ""Myocardial infarction"" OR ""Stroke"" OR ""Blood pressure"" OR ""Acute coronary syndrome"" OR ""Coronary artery disease"" OR ""Thrombosis"" OR ""QT interval"" OR ""Heart rate"" OR ""Heart failure with preserved ejection fraction"" OR ""Cardiomyopathy""))",AND date_published>=now-10y,"AND field_of_study: ((""Medicine"" OR ""Internal medicine"" OR ""Pharmacology"") AND (""Cardiology"" OR ""Heart failure"" OR ""Atrial fibrillation"" OR ""Myocardial infarction"" OR ""Stroke"" OR ""Blood pressure"" OR ""Acute coronary syndrome"" OR ""Coronary artery disease"" OR ""Thrombosis"" OR ""QT interval"" OR ""Heart rate"" OR ""Heart failure with preserved ejection fraction"" OR ""Cardiomyopathy""))",NA,oa_therapy_area,Uni,Cardiovascular,2015,10210,2088,1749,485,1013,474,5809,4401
cardiovascular (primary search + cardiovascular tags) - uni,"(author.affiliation.name:(""university of cape town"" OR ""south african college"" OR ""shanghai jiao tong university"" OR ""shanghai communications university"" OR ""fudan university"" OR ""sun yat-sen university"" OR ""zhejiang university"" OR ""chekiang university"" OR ""peking university"" OR ""imperial university of peking"" OR ""capital medical university"" OR ""cmu"" OR ""seoul national university"" OR ""seoul daehakgyo"" OR ""peking union medical college"" OR ""beijing xiehe hospital"" OR ""sichuan university"" OR ""sìchuān dàxué"" OR ""nanjing medical university"" OR ""national jiangsu medical college"" OR ""huazhong university of science and technology"" OR ""huázhōng kējì dàxué"" OR ""university college london"" OR ""london university"" OR ""karolinska institutet"" OR ""royal caroline institute"" OR ""university of oxford"" OR ""oxford university"" OR ""university of copenhagen"" OR ""universität kopenhagen"" OR ""université de paris"" OR ""university of paris"" OR ""king's college london"" OR ""kcl"" OR ""university of amsterdam"" OR ""universiteit van amsterdam"" OR ""imperial college london"" OR ""coleg imperial llundain"" OR ""utrecht university"" OR ""universiteit utrecht"" OR ""heidelberg university"" OR ""ruprecht-karls-universität heidelberg"" OR ""university of milan"" OR ""université de milan"" OR ""erasmus university rotterdam"" OR ""erasmus universiteit rotterdam"" OR ""freie universität berlin"" OR ""free university of berlin"" OR ""university of cambridge"" OR ""cambridge university"" OR ""humboldt-universität zu berlin"" OR ""humboldt university of berlin"" OR ""university of zurich"" OR ""universität zürich"" OR ""tel aviv university"" OR ""harvard university"" OR ""universidad de harvard"" OR ""johns hopkins university"" OR ""jhu"" OR ""university of toronto"" OR ""université de toronto"" OR ""university of pennsylvania"" Or ""upenn"" OR ""university of california, san francisco"" OR ""ucsf"" OR ""duke university"" OR ""Universidad de Duke"" OR ""university of michigan"" OR ""umich"" OR ""stanford university"" OR ""leland stanford junior university"" OR ""university of melbourne"" OR ""melbourne university"" OR ""university of sydney"" OR ""sydney university"" OR ""university of são paulo"" OR ""universidade de são paulo"") OR author.affiliation.ror_id_lineage:(""03p74gp79"" OR ""0220qvk04"" OR ""013q1eq08"" OR ""0064kty71"" OR ""00a2xv884"" OR ""02v51f717"" OR ""013xs5b60"" OR ""04h9pn542"" OR ""04jztag35"" OR ""011ashp19"" OR ""059gcgy73"" OR ""00p991c53"" OR ""02jx3x895"" OR ""056d84691"" OR ""052gg0110"" OR ""035b05819"" OR ""05f82e368"" OR ""0220mzb33"" OR ""04dkp9463"" OR ""041kmwe10"" OR ""04pp8hn57"" OR ""038t36y30"" OR ""00wjc7c48"" OR ""057w15z03"" OR ""046ak2485"" OR ""013meh722"" OR ""01hcx6992"" OR ""02crff812"" OR ""04mhzgx49"" OR ""03vek6s52"" OR ""00za53h95"" OR ""03dbr7087"" OR ""00b30xv10"" OR ""043mz5j54"" OR ""00py81415"" OR ""00jmfr291"" OR ""00f54p054"" OR ""01ej9dk98"" OR ""0384j8v12"" OR ""036rp1748"")) AND publication_type:""journal article"" AND date_published>=now-10y AND field_of_study: ((""Medicine"" OR ""Internal medicine"" OR ""Pharmacology"") AND (""Cardiology"" OR ""Heart failure"" OR ""Atrial fibrillation"" OR ""Myocardial infarction"" OR ""Stroke"" OR ""Blood pressure"" OR ""Acute coronary syndrome"" OR ""Coronary artery disease"" OR ""Thrombosis"" OR ""QT interval"" OR ""Heart rate"" OR ""Heart failure with preserved ejection fraction"" OR ""Cardiomyopathy""))",AND date_published>=now-10y,"AND field_of_study: ((""Medicine"" OR ""Internal medicine"" OR ""Pharmacology"") AND (""Cardiology"" OR ""Heart failure"" OR ""Atrial fibrillation"" OR ""Myocardial infarction"" OR ""Stroke"" OR ""Blood pressure"" OR ""Acute coronary syndrome"" OR ""Coronary artery disease"" OR ""Thrombosis"" OR ""QT interval"" OR ""Heart rate"" OR ""Heart failure with preserved ejection fraction"" OR ""Cardiomyopathy""))",NA,oa_therapy_area,Uni,Cardiovascular,2016,10619,2174,1998,550,1035,420,6177,4442
cardiovascular (primary search + cardiovascular tags) - uni,"(author.affiliation.name:(""university of cape town"" OR ""south african college"" OR ""shanghai jiao tong university"" OR ""shanghai communications university"" OR ""fudan university"" OR ""sun yat-sen university"" OR ""zhejiang university"" OR ""chekiang university"" OR ""peking university"" OR ""imperial university of peking"" OR ""capital medical university"" OR ""cmu"" OR ""seoul national university"" OR ""seoul daehakgyo"" OR ""peking union medical college"" OR ""beijing xiehe hospital"" OR ""sichuan university"" OR ""sìchuān dàxué"" OR ""nanjing medical university"" OR ""national jiangsu medical college"" OR ""huazhong university of science and technology"" OR ""huázhōng kējì dàxué"" OR ""university college london"" OR ""london university"" OR ""karolinska institutet"" OR ""royal caroline institute"" OR ""university of oxford"" OR ""oxford university"" OR ""university of copenhagen"" OR ""universität kopenhagen"" OR ""université de paris"" OR ""university of paris"" OR ""king's college london"" OR ""kcl"" OR ""university of amsterdam"" OR ""universiteit van amsterdam"" OR ""imperial college london"" OR ""coleg imperial llundain"" OR ""utrecht university"" OR ""universiteit utrecht"" OR ""heidelberg university"" OR ""ruprecht-karls-universität heidelberg"" OR ""university of milan"" OR ""université de milan"" OR ""erasmus university rotterdam"" OR ""erasmus universiteit rotterdam"" OR ""freie universität berlin"" OR ""free university of berlin"" OR ""university of cambridge"" OR ""cambridge university"" OR ""humboldt-universität zu berlin"" OR ""humboldt university of berlin"" OR ""university of zurich"" OR ""universität zürich"" OR ""tel aviv university"" OR ""harvard university"" OR ""universidad de harvard"" OR ""johns hopkins university"" OR ""jhu"" OR ""university of toronto"" OR ""université de toronto"" OR ""university of pennsylvania"" Or ""upenn"" OR ""university of california, san francisco"" OR ""ucsf"" OR ""duke university"" OR ""Universidad de Duke"" OR ""university of michigan"" OR ""umich"" OR ""stanford university"" OR ""leland stanford junior university"" OR ""university of melbourne"" OR ""melbourne university"" OR ""university of sydney"" OR ""sydney university"" OR ""university of são paulo"" OR ""universidade de são paulo"") OR author.affiliation.ror_id_lineage:(""03p74gp79"" OR ""0220qvk04"" OR ""013q1eq08"" OR ""0064kty71"" OR ""00a2xv884"" OR ""02v51f717"" OR ""013xs5b60"" OR ""04h9pn542"" OR ""04jztag35"" OR ""011ashp19"" OR ""059gcgy73"" OR ""00p991c53"" OR ""02jx3x895"" OR ""056d84691"" OR ""052gg0110"" OR ""035b05819"" OR ""05f82e368"" OR ""0220mzb33"" OR ""04dkp9463"" OR ""041kmwe10"" OR ""04pp8hn57"" OR ""038t36y30"" OR ""00wjc7c48"" OR ""057w15z03"" OR ""046ak2485"" OR ""013meh722"" OR ""01hcx6992"" OR ""02crff812"" OR ""04mhzgx49"" OR ""03vek6s52"" OR ""00za53h95"" OR ""03dbr7087"" OR ""00b30xv10"" OR ""043mz5j54"" OR ""00py81415"" OR ""00jmfr291"" OR ""00f54p054"" OR ""01ej9dk98"" OR ""0384j8v12"" OR ""036rp1748"")) AND publication_type:""journal article"" AND date_published>=now-10y AND field_of_study: ((""Medicine"" OR ""Internal medicine"" OR ""Pharmacology"") AND (""Cardiology"" OR ""Heart failure"" OR ""Atrial fibrillation"" OR ""Myocardial infarction"" OR ""Stroke"" OR ""Blood pressure"" OR ""Acute coronary syndrome"" OR ""Coronary artery disease"" OR ""Thrombosis"" OR ""QT interval"" OR ""Heart rate"" OR ""Heart failure with preserved ejection fraction"" OR ""Cardiomyopathy""))",AND date_published>=now-10y,"AND field_of_study: ((""Medicine"" OR ""Internal medicine"" OR ""Pharmacology"") AND (""Cardiology"" OR ""Heart failure"" OR ""Atrial fibrillation"" OR ""Myocardial infarction"" OR ""Stroke"" OR ""Blood pressure"" OR ""Acute coronary syndrome"" OR ""Coronary artery disease"" OR ""Thrombosis"" OR ""QT interval"" OR ""Heart rate"" OR ""Heart failure with preserved ejection fraction"" OR ""Cardiomyopathy""))",NA,oa_therapy_area,Uni,Cardiovascular,2017,11062,2553,2229,606,1392,384,7164,3898
cardiovascular (primary search + cardiovascular tags) - uni,"(author.affiliation.name:(""university of cape town"" OR ""south african college"" OR ""shanghai jiao tong university"" OR ""shanghai communications university"" OR ""fudan university"" OR ""sun yat-sen university"" OR ""zhejiang university"" OR ""chekiang university"" OR ""peking university"" OR ""imperial university of peking"" OR ""capital medical university"" OR ""cmu"" OR ""seoul national university"" OR ""seoul daehakgyo"" OR ""peking union medical college"" OR ""beijing xiehe hospital"" OR ""sichuan university"" OR ""sìchuān dàxué"" OR ""nanjing medical university"" OR ""national jiangsu medical college"" OR ""huazhong university of science and technology"" OR ""huázhōng kējì dàxué"" OR ""university college london"" OR ""london university"" OR ""karolinska institutet"" OR ""royal caroline institute"" OR ""university of oxford"" OR ""oxford university"" OR ""university of copenhagen"" OR ""universität kopenhagen"" OR ""université de paris"" OR ""university of paris"" OR ""king's college london"" OR ""kcl"" OR ""university of amsterdam"" OR ""universiteit van amsterdam"" OR ""imperial college london"" OR ""coleg imperial llundain"" OR ""utrecht university"" OR ""universiteit utrecht"" OR ""heidelberg university"" OR ""ruprecht-karls-universität heidelberg"" OR ""university of milan"" OR ""université de milan"" OR ""erasmus university rotterdam"" OR ""erasmus universiteit rotterdam"" OR ""freie universität berlin"" OR ""free university of berlin"" OR ""university of cambridge"" OR ""cambridge university"" OR ""humboldt-universität zu berlin"" OR ""humboldt university of berlin"" OR ""university of zurich"" OR ""universität zürich"" OR ""tel aviv university"" OR ""harvard university"" OR ""universidad de harvard"" OR ""johns hopkins university"" OR ""jhu"" OR ""university of toronto"" OR ""université de toronto"" OR ""university of pennsylvania"" Or ""upenn"" OR ""university of california, san francisco"" OR ""ucsf"" OR ""duke university"" OR ""Universidad de Duke"" OR ""university of michigan"" OR ""umich"" OR ""stanford university"" OR ""leland stanford junior university"" OR ""university of melbourne"" OR ""melbourne university"" OR ""university of sydney"" OR ""sydney university"" OR ""university of são paulo"" OR ""universidade de são paulo"") OR author.affiliation.ror_id_lineage:(""03p74gp79"" OR ""0220qvk04"" OR ""013q1eq08"" OR ""0064kty71"" OR ""00a2xv884"" OR ""02v51f717"" OR ""013xs5b60"" OR ""04h9pn542"" OR ""04jztag35"" OR ""011ashp19"" OR ""059gcgy73"" OR ""00p991c53"" OR ""02jx3x895"" OR ""056d84691"" OR ""052gg0110"" OR ""035b05819"" OR ""05f82e368"" OR ""0220mzb33"" OR ""04dkp9463"" OR ""041kmwe10"" OR ""04pp8hn57"" OR ""038t36y30"" OR ""00wjc7c48"" OR ""057w15z03"" OR ""046ak2485"" OR ""013meh722"" OR ""01hcx6992"" OR ""02crff812"" OR ""04mhzgx49"" OR ""03vek6s52"" OR ""00za53h95"" OR ""03dbr7087"" OR ""00b30xv10"" OR ""043mz5j54"" OR ""00py81415"" OR ""00jmfr291"" OR ""00f54p054"" OR ""01ej9dk98"" OR ""0384j8v12"" OR ""036rp1748"")) AND publication_type:""journal article"" AND date_published>=now-10y AND field_of_study: ((""Medicine"" OR ""Internal medicine"" OR ""Pharmacology"") AND (""Cardiology"" OR ""Heart failure"" OR ""Atrial fibrillation"" OR ""Myocardial infarction"" OR ""Stroke"" OR ""Blood pressure"" OR ""Acute coronary syndrome"" OR ""Coronary artery disease"" OR ""Thrombosis"" OR ""QT interval"" OR ""Heart rate"" OR ""Heart failure with preserved ejection fraction"" OR ""Cardiomyopathy""))",AND date_published>=now-10y,"AND field_of_study: ((""Medicine"" OR ""Internal medicine"" OR ""Pharmacology"") AND (""Cardiology"" OR ""Heart failure"" OR ""Atrial fibrillation"" OR ""Myocardial infarction"" OR ""Stroke"" OR ""Blood pressure"" OR ""Acute coronary syndrome"" OR ""Coronary artery disease"" OR ""Thrombosis"" OR ""QT interval"" OR ""Heart rate"" OR ""Heart failure with preserved ejection fraction"" OR ""Cardiomyopathy""))",NA,oa_therapy_area,Uni,Cardiovascular,2018,12003,2773,2158,761,1444,442,7578,4425
cardiovascular (primary search + cardiovascular tags) - uni,"(author.affiliation.name:(""university of cape town"" OR ""south african college"" OR ""shanghai jiao tong university"" OR ""shanghai communications university"" OR ""fudan university"" OR ""sun yat-sen university"" OR ""zhejiang university"" OR ""chekiang university"" OR ""peking university"" OR ""imperial university of peking"" OR ""capital medical university"" OR ""cmu"" OR ""seoul national university"" OR ""seoul daehakgyo"" OR ""peking union medical college"" OR ""beijing xiehe hospital"" OR ""sichuan university"" OR ""sìchuān dàxué"" OR ""nanjing medical university"" OR ""national jiangsu medical college"" OR ""huazhong university of science and technology"" OR ""huázhōng kējì dàxué"" OR ""university college london"" OR ""london university"" OR ""karolinska institutet"" OR ""royal caroline institute"" OR ""university of oxford"" OR ""oxford university"" OR ""university of copenhagen"" OR ""universität kopenhagen"" OR ""université de paris"" OR ""university of paris"" OR ""king's college london"" OR ""kcl"" OR ""university of amsterdam"" OR ""universiteit van amsterdam"" OR ""imperial college london"" OR ""coleg imperial llundain"" OR ""utrecht university"" OR ""universiteit utrecht"" OR ""heidelberg university"" OR ""ruprecht-karls-universität heidelberg"" OR ""university of milan"" OR ""université de milan"" OR ""erasmus university rotterdam"" OR ""erasmus universiteit rotterdam"" OR ""freie universität berlin"" OR ""free university of berlin"" OR ""university of cambridge"" OR ""cambridge university"" OR ""humboldt-universität zu berlin"" OR ""humboldt university of berlin"" OR ""university of zurich"" OR ""universität zürich"" OR ""tel aviv university"" OR ""harvard university"" OR ""universidad de harvard"" OR ""johns hopkins university"" OR ""jhu"" OR ""university of toronto"" OR ""université de toronto"" OR ""university of pennsylvania"" Or ""upenn"" OR ""university of california, san francisco"" OR ""ucsf"" OR ""duke university"" OR ""Universidad de Duke"" OR ""university of michigan"" OR ""umich"" OR ""stanford university"" OR ""leland stanford junior university"" OR ""university of melbourne"" OR ""melbourne university"" OR ""university of sydney"" OR ""sydney university"" OR ""university of são paulo"" OR ""universidade de são paulo"") OR author.affiliation.ror_id_lineage:(""03p74gp79"" OR ""0220qvk04"" OR ""013q1eq08"" OR ""0064kty71"" OR ""00a2xv884"" OR ""02v51f717"" OR ""013xs5b60"" OR ""04h9pn542"" OR ""04jztag35"" OR ""011ashp19"" OR ""059gcgy73"" OR ""00p991c53"" OR ""02jx3x895"" OR ""056d84691"" OR ""052gg0110"" OR ""035b05819"" OR ""05f82e368"" OR ""0220mzb33"" OR ""04dkp9463"" OR ""041kmwe10"" OR ""04pp8hn57"" OR ""038t36y30"" OR ""00wjc7c48"" OR ""057w15z03"" OR ""046ak2485"" OR ""013meh722"" OR ""01hcx6992"" OR ""02crff812"" OR ""04mhzgx49"" OR ""03vek6s52"" OR ""00za53h95"" OR ""03dbr7087"" OR ""00b30xv10"" OR ""043mz5j54"" OR ""00py81415"" OR ""00jmfr291"" OR ""00f54p054"" OR ""01ej9dk98"" OR ""0384j8v12"" OR ""036rp1748"")) AND publication_type:""journal article"" AND date_published>=now-10y AND field_of_study: ((""Medicine"" OR ""Internal medicine"" OR ""Pharmacology"") AND (""Cardiology"" OR ""Heart failure"" OR ""Atrial fibrillation"" OR ""Myocardial infarction"" OR ""Stroke"" OR ""Blood pressure"" OR ""Acute coronary syndrome"" OR ""Coronary artery disease"" OR ""Thrombosis"" OR ""QT interval"" OR ""Heart rate"" OR ""Heart failure with preserved ejection fraction"" OR ""Cardiomyopathy""))",AND date_published>=now-10y,"AND field_of_study: ((""Medicine"" OR ""Internal medicine"" OR ""Pharmacology"") AND (""Cardiology"" OR ""Heart failure"" OR ""Atrial fibrillation"" OR ""Myocardial infarction"" OR ""Stroke"" OR ""Blood pressure"" OR ""Acute coronary syndrome"" OR ""Coronary artery disease"" OR ""Thrombosis"" OR ""QT interval"" OR ""Heart rate"" OR ""Heart failure with preserved ejection fraction"" OR ""Cardiomyopathy""))",NA,oa_therapy_area,Uni,Cardiovascular,2019,12908,3171,2341,994,1240,421,8167,4741
cardiovascular (primary search + cardiovascular tags) - uni,"(author.affiliation.name:(""university of cape town"" OR ""south african college"" OR ""shanghai jiao tong university"" OR ""shanghai communications university"" OR ""fudan university"" OR ""sun yat-sen university"" OR ""zhejiang university"" OR ""chekiang university"" OR ""peking university"" OR ""imperial university of peking"" OR ""capital medical university"" OR ""cmu"" OR ""seoul national university"" OR ""seoul daehakgyo"" OR ""peking union medical college"" OR ""beijing xiehe hospital"" OR ""sichuan university"" OR ""sìchuān dàxué"" OR ""nanjing medical university"" OR ""national jiangsu medical college"" OR ""huazhong university of science and technology"" OR ""huázhōng kējì dàxué"" OR ""university college london"" OR ""london university"" OR ""karolinska institutet"" OR ""royal caroline institute"" OR ""university of oxford"" OR ""oxford university"" OR ""university of copenhagen"" OR ""universität kopenhagen"" OR ""université de paris"" OR ""university of paris"" OR ""king's college london"" OR ""kcl"" OR ""university of amsterdam"" OR ""universiteit van amsterdam"" OR ""imperial college london"" OR ""coleg imperial llundain"" OR ""utrecht university"" OR ""universiteit utrecht"" OR ""heidelberg university"" OR ""ruprecht-karls-universität heidelberg"" OR ""university of milan"" OR ""université de milan"" OR ""erasmus university rotterdam"" OR ""erasmus universiteit rotterdam"" OR ""freie universität berlin"" OR ""free university of berlin"" OR ""university of cambridge"" OR ""cambridge university"" OR ""humboldt-universität zu berlin"" OR ""humboldt university of berlin"" OR ""university of zurich"" OR ""universität zürich"" OR ""tel aviv university"" OR ""harvard university"" OR ""universidad de harvard"" OR ""johns hopkins university"" OR ""jhu"" OR ""university of toronto"" OR ""université de toronto"" OR ""university of pennsylvania"" Or ""upenn"" OR ""university of california, san francisco"" OR ""ucsf"" OR ""duke university"" OR ""Universidad de Duke"" OR ""university of michigan"" OR ""umich"" OR ""stanford university"" OR ""leland stanford junior university"" OR ""university of melbourne"" OR ""melbourne university"" OR ""university of sydney"" OR ""sydney university"" OR ""university of são paulo"" OR ""universidade de são paulo"") OR author.affiliation.ror_id_lineage:(""03p74gp79"" OR ""0220qvk04"" OR ""013q1eq08"" OR ""0064kty71"" OR ""00a2xv884"" OR ""02v51f717"" OR ""013xs5b60"" OR ""04h9pn542"" OR ""04jztag35"" OR ""011ashp19"" OR ""059gcgy73"" OR ""00p991c53"" OR ""02jx3x895"" OR ""056d84691"" OR ""052gg0110"" OR ""035b05819"" OR ""05f82e368"" OR ""0220mzb33"" OR ""04dkp9463"" OR ""041kmwe10"" OR ""04pp8hn57"" OR ""038t36y30"" OR ""00wjc7c48"" OR ""057w15z03"" OR ""046ak2485"" OR ""013meh722"" OR ""01hcx6992"" OR ""02crff812"" OR ""04mhzgx49"" OR ""03vek6s52"" OR ""00za53h95"" OR ""03dbr7087"" OR ""00b30xv10"" OR ""043mz5j54"" OR ""00py81415"" OR ""00jmfr291"" OR ""00f54p054"" OR ""01ej9dk98"" OR ""0384j8v12"" OR ""036rp1748"")) AND publication_type:""journal article"" AND date_published>=now-10y AND field_of_study: ((""Medicine"" OR ""Internal medicine"" OR ""Pharmacology"") AND (""Cardiology"" OR ""Heart failure"" OR ""Atrial fibrillation"" OR ""Myocardial infarction"" OR ""Stroke"" OR ""Blood pressure"" OR ""Acute coronary syndrome"" OR ""Coronary artery disease"" OR ""Thrombosis"" OR ""QT interval"" OR ""Heart rate"" OR ""Heart failure with preserved ejection fraction"" OR ""Cardiomyopathy""))",AND date_published>=now-10y,"AND field_of_study: ((""Medicine"" OR ""Internal medicine"" OR ""Pharmacology"") AND (""Cardiology"" OR ""Heart failure"" OR ""Atrial fibrillation"" OR ""Myocardial infarction"" OR ""Stroke"" OR ""Blood pressure"" OR ""Acute coronary syndrome"" OR ""Coronary artery disease"" OR ""Thrombosis"" OR ""QT interval"" OR ""Heart rate"" OR ""Heart failure with preserved ejection fraction"" OR ""Cardiomyopathy""))",NA,oa_therapy_area,Uni,Cardiovascular,2020,16143,4579,2601,1426,1630,455,10691,5452
cardiovascular (primary search + cardiovascular tags) - uni,"(author.affiliation.name:(""university of cape town"" OR ""south african college"" OR ""shanghai jiao tong university"" OR ""shanghai communications university"" OR ""fudan university"" OR ""sun yat-sen university"" OR ""zhejiang university"" OR ""chekiang university"" OR ""peking university"" OR ""imperial university of peking"" OR ""capital medical university"" OR ""cmu"" OR ""seoul national university"" OR ""seoul daehakgyo"" OR ""peking union medical college"" OR ""beijing xiehe hospital"" OR ""sichuan university"" OR ""sìchuān dàxué"" OR ""nanjing medical university"" OR ""national jiangsu medical college"" OR ""huazhong university of science and technology"" OR ""huázhōng kējì dàxué"" OR ""university college london"" OR ""london university"" OR ""karolinska institutet"" OR ""royal caroline institute"" OR ""university of oxford"" OR ""oxford university"" OR ""university of copenhagen"" OR ""universität kopenhagen"" OR ""université de paris"" OR ""university of paris"" OR ""king's college london"" OR ""kcl"" OR ""university of amsterdam"" OR ""universiteit van amsterdam"" OR ""imperial college london"" OR ""coleg imperial llundain"" OR ""utrecht university"" OR ""universiteit utrecht"" OR ""heidelberg university"" OR ""ruprecht-karls-universität heidelberg"" OR ""university of milan"" OR ""université de milan"" OR ""erasmus university rotterdam"" OR ""erasmus universiteit rotterdam"" OR ""freie universität berlin"" OR ""free university of berlin"" OR ""university of cambridge"" OR ""cambridge university"" OR ""humboldt-universität zu berlin"" OR ""humboldt university of berlin"" OR ""university of zurich"" OR ""universität zürich"" OR ""tel aviv university"" OR ""harvard university"" OR ""universidad de harvard"" OR ""johns hopkins university"" OR ""jhu"" OR ""university of toronto"" OR ""université de toronto"" OR ""university of pennsylvania"" Or ""upenn"" OR ""university of california, san francisco"" OR ""ucsf"" OR ""duke university"" OR ""Universidad de Duke"" OR ""university of michigan"" OR ""umich"" OR ""stanford university"" OR ""leland stanford junior university"" OR ""university of melbourne"" OR ""melbourne university"" OR ""university of sydney"" OR ""sydney university"" OR ""university of são paulo"" OR ""universidade de são paulo"") OR author.affiliation.ror_id_lineage:(""03p74gp79"" OR ""0220qvk04"" OR ""013q1eq08"" OR ""0064kty71"" OR ""00a2xv884"" OR ""02v51f717"" OR ""013xs5b60"" OR ""04h9pn542"" OR ""04jztag35"" OR ""011ashp19"" OR ""059gcgy73"" OR ""00p991c53"" OR ""02jx3x895"" OR ""056d84691"" OR ""052gg0110"" OR ""035b05819"" OR ""05f82e368"" OR ""0220mzb33"" OR ""04dkp9463"" OR ""041kmwe10"" OR ""04pp8hn57"" OR ""038t36y30"" OR ""00wjc7c48"" OR ""057w15z03"" OR ""046ak2485"" OR ""013meh722"" OR ""01hcx6992"" OR ""02crff812"" OR ""04mhzgx49"" OR ""03vek6s52"" OR ""00za53h95"" OR ""03dbr7087"" OR ""00b30xv10"" OR ""043mz5j54"" OR ""00py81415"" OR ""00jmfr291"" OR ""00f54p054"" OR ""01ej9dk98"" OR ""0384j8v12"" OR ""036rp1748"")) AND publication_type:""journal article"" AND date_published>=now-10y AND field_of_study: ((""Medicine"" OR ""Internal medicine"" OR ""Pharmacology"") AND (""Cardiology"" OR ""Heart failure"" OR ""Atrial fibrillation"" OR ""Myocardial infarction"" OR ""Stroke"" OR ""Blood pressure"" OR ""Acute coronary syndrome"" OR ""Coronary artery disease"" OR ""Thrombosis"" OR ""QT interval"" OR ""Heart rate"" OR ""Heart failure with preserved ejection fraction"" OR ""Cardiomyopathy""))",AND date_published>=now-10y,"AND field_of_study: ((""Medicine"" OR ""Internal medicine"" OR ""Pharmacology"") AND (""Cardiology"" OR ""Heart failure"" OR ""Atrial fibrillation"" OR ""Myocardial infarction"" OR ""Stroke"" OR ""Blood pressure"" OR ""Acute coronary syndrome"" OR ""Coronary artery disease"" OR ""Thrombosis"" OR ""QT interval"" OR ""Heart rate"" OR ""Heart failure with preserved ejection fraction"" OR ""Cardiomyopathy""))",NA,oa_therapy_area,Uni,Cardiovascular,2021,16514,5966,1224,1861,1309,943,11303,5211
cardiovascular (primary search + cardiovascular tags) - uni,"(author.affiliation.name:(""university of cape town"" OR ""south african college"" OR ""shanghai jiao tong university"" OR ""shanghai communications university"" OR ""fudan university"" OR ""sun yat-sen university"" OR ""zhejiang university"" OR ""chekiang university"" OR ""peking university"" OR ""imperial university of peking"" OR ""capital medical university"" OR ""cmu"" OR ""seoul national university"" OR ""seoul daehakgyo"" OR ""peking union medical college"" OR ""beijing xiehe hospital"" OR ""sichuan university"" OR ""sìchuān dàxué"" OR ""nanjing medical university"" OR ""national jiangsu medical college"" OR ""huazhong university of science and technology"" OR ""huázhōng kējì dàxué"" OR ""university college london"" OR ""london university"" OR ""karolinska institutet"" OR ""royal caroline institute"" OR ""university of oxford"" OR ""oxford university"" OR ""university of copenhagen"" OR ""universität kopenhagen"" OR ""université de paris"" OR ""university of paris"" OR ""king's college london"" OR ""kcl"" OR ""university of amsterdam"" OR ""universiteit van amsterdam"" OR ""imperial college london"" OR ""coleg imperial llundain"" OR ""utrecht university"" OR ""universiteit utrecht"" OR ""heidelberg university"" OR ""ruprecht-karls-universität heidelberg"" OR ""university of milan"" OR ""université de milan"" OR ""erasmus university rotterdam"" OR ""erasmus universiteit rotterdam"" OR ""freie universität berlin"" OR ""free university of berlin"" OR ""university of cambridge"" OR ""cambridge university"" OR ""humboldt-universität zu berlin"" OR ""humboldt university of berlin"" OR ""university of zurich"" OR ""universität zürich"" OR ""tel aviv university"" OR ""harvard university"" OR ""universidad de harvard"" OR ""johns hopkins university"" OR ""jhu"" OR ""university of toronto"" OR ""université de toronto"" OR ""university of pennsylvania"" Or ""upenn"" OR ""university of california, san francisco"" OR ""ucsf"" OR ""duke university"" OR ""Universidad de Duke"" OR ""university of michigan"" OR ""umich"" OR ""stanford university"" OR ""leland stanford junior university"" OR ""university of melbourne"" OR ""melbourne university"" OR ""university of sydney"" OR ""sydney university"" OR ""university of são paulo"" OR ""universidade de são paulo"") OR author.affiliation.ror_id_lineage:(""03p74gp79"" OR ""0220qvk04"" OR ""013q1eq08"" OR ""0064kty71"" OR ""00a2xv884"" OR ""02v51f717"" OR ""013xs5b60"" OR ""04h9pn542"" OR ""04jztag35"" OR ""011ashp19"" OR ""059gcgy73"" OR ""00p991c53"" OR ""02jx3x895"" OR ""056d84691"" OR ""052gg0110"" OR ""035b05819"" OR ""05f82e368"" OR ""0220mzb33"" OR ""04dkp9463"" OR ""041kmwe10"" OR ""04pp8hn57"" OR ""038t36y30"" OR ""00wjc7c48"" OR ""057w15z03"" OR ""046ak2485"" OR ""013meh722"" OR ""01hcx6992"" OR ""02crff812"" OR ""04mhzgx49"" OR ""03vek6s52"" OR ""00za53h95"" OR ""03dbr7087"" OR ""00b30xv10"" OR ""043mz5j54"" OR ""00py81415"" OR ""00jmfr291"" OR ""00f54p054"" OR ""01ej9dk98"" OR ""0384j8v12"" OR ""036rp1748"")) AND publication_type:""journal article"" AND date_published>=now-10y AND field_of_study: ((""Medicine"" OR ""Internal medicine"" OR ""Pharmacology"") AND (""Cardiology"" OR ""Heart failure"" OR ""Atrial fibrillation"" OR ""Myocardial infarction"" OR ""Stroke"" OR ""Blood pressure"" OR ""Acute coronary syndrome"" OR ""Coronary artery disease"" OR ""Thrombosis"" OR ""QT interval"" OR ""Heart rate"" OR ""Heart failure with preserved ejection fraction"" OR ""Cardiomyopathy""))",AND date_published>=now-10y,"AND field_of_study: ((""Medicine"" OR ""Internal medicine"" OR ""Pharmacology"") AND (""Cardiology"" OR ""Heart failure"" OR ""Atrial fibrillation"" OR ""Myocardial infarction"" OR ""Stroke"" OR ""Blood pressure"" OR ""Acute coronary syndrome"" OR ""Coronary artery disease"" OR ""Thrombosis"" OR ""QT interval"" OR ""Heart rate"" OR ""Heart failure with preserved ejection fraction"" OR ""Cardiomyopathy""))",NA,oa_therapy_area,Uni,Cardiovascular,2022,15858,6602,1033,1544,1027,651,10857,5001
cardiovascular (primary search + cardiovascular tags) - uni,"(author.affiliation.name:(""university of cape town"" OR ""south african college"" OR ""shanghai jiao tong university"" OR ""shanghai communications university"" OR ""fudan university"" OR ""sun yat-sen university"" OR ""zhejiang university"" OR ""chekiang university"" OR ""peking university"" OR ""imperial university of peking"" OR ""capital medical university"" OR ""cmu"" OR ""seoul national university"" OR ""seoul daehakgyo"" OR ""peking union medical college"" OR ""beijing xiehe hospital"" OR ""sichuan university"" OR ""sìchuān dàxué"" OR ""nanjing medical university"" OR ""national jiangsu medical college"" OR ""huazhong university of science and technology"" OR ""huázhōng kējì dàxué"" OR ""university college london"" OR ""london university"" OR ""karolinska institutet"" OR ""royal caroline institute"" OR ""university of oxford"" OR ""oxford university"" OR ""university of copenhagen"" OR ""universität kopenhagen"" OR ""université de paris"" OR ""university of paris"" OR ""king's college london"" OR ""kcl"" OR ""university of amsterdam"" OR ""universiteit van amsterdam"" OR ""imperial college london"" OR ""coleg imperial llundain"" OR ""utrecht university"" OR ""universiteit utrecht"" OR ""heidelberg university"" OR ""ruprecht-karls-universität heidelberg"" OR ""university of milan"" OR ""université de milan"" OR ""erasmus university rotterdam"" OR ""erasmus universiteit rotterdam"" OR ""freie universität berlin"" OR ""free university of berlin"" OR ""university of cambridge"" OR ""cambridge university"" OR ""humboldt-universität zu berlin"" OR ""humboldt university of berlin"" OR ""university of zurich"" OR ""universität zürich"" OR ""tel aviv university"" OR ""harvard university"" OR ""universidad de harvard"" OR ""johns hopkins university"" OR ""jhu"" OR ""university of toronto"" OR ""université de toronto"" OR ""university of pennsylvania"" Or ""upenn"" OR ""university of california, san francisco"" OR ""ucsf"" OR ""duke university"" OR ""Universidad de Duke"" OR ""university of michigan"" OR ""umich"" OR ""stanford university"" OR ""leland stanford junior university"" OR ""university of melbourne"" OR ""melbourne university"" OR ""university of sydney"" OR ""sydney university"" OR ""university of são paulo"" OR ""universidade de são paulo"") OR author.affiliation.ror_id_lineage:(""03p74gp79"" OR ""0220qvk04"" OR ""013q1eq08"" OR ""0064kty71"" OR ""00a2xv884"" OR ""02v51f717"" OR ""013xs5b60"" OR ""04h9pn542"" OR ""04jztag35"" OR ""011ashp19"" OR ""059gcgy73"" OR ""00p991c53"" OR ""02jx3x895"" OR ""056d84691"" OR ""052gg0110"" OR ""035b05819"" OR ""05f82e368"" OR ""0220mzb33"" OR ""04dkp9463"" OR ""041kmwe10"" OR ""04pp8hn57"" OR ""038t36y30"" OR ""00wjc7c48"" OR ""057w15z03"" OR ""046ak2485"" OR ""013meh722"" OR ""01hcx6992"" OR ""02crff812"" OR ""04mhzgx49"" OR ""03vek6s52"" OR ""00za53h95"" OR ""03dbr7087"" OR ""00b30xv10"" OR ""043mz5j54"" OR ""00py81415"" OR ""00jmfr291"" OR ""00f54p054"" OR ""01ej9dk98"" OR ""0384j8v12"" OR ""036rp1748"")) AND publication_type:""journal article"" AND date_published>=now-10y AND field_of_study: ((""Medicine"" OR ""Internal medicine"" OR ""Pharmacology"") AND (""Cardiology"" OR ""Heart failure"" OR ""Atrial fibrillation"" OR ""Myocardial infarction"" OR ""Stroke"" OR ""Blood pressure"" OR ""Acute coronary syndrome"" OR ""Coronary artery disease"" OR ""Thrombosis"" OR ""QT interval"" OR ""Heart rate"" OR ""Heart failure with preserved ejection fraction"" OR ""Cardiomyopathy""))",AND date_published>=now-10y,"AND field_of_study: ((""Medicine"" OR ""Internal medicine"" OR ""Pharmacology"") AND (""Cardiology"" OR ""Heart failure"" OR ""Atrial fibrillation"" OR ""Myocardial infarction"" OR ""Stroke"" OR ""Blood pressure"" OR ""Acute coronary syndrome"" OR ""Coronary artery disease"" OR ""Thrombosis"" OR ""QT interval"" OR ""Heart rate"" OR ""Heart failure with preserved ejection fraction"" OR ""Cardiomyopathy""))",NA,oa_therapy_area,Uni,Cardiovascular,2023,5977,2313,114,589,148,517,3681,2296
gastroenterology  (primary search + gastroenterology tags) - uni,"(author.affiliation.name:(""university of cape town"" OR ""south african college"" OR ""shanghai jiao tong university"" OR ""shanghai communications university"" OR ""fudan university"" OR ""sun yat-sen university"" OR ""zhejiang university"" OR ""chekiang university"" OR ""peking university"" OR ""imperial university of peking"" OR ""capital medical university"" OR ""cmu"" OR ""seoul national university"" OR ""seoul daehakgyo"" OR ""peking union medical college"" OR ""beijing xiehe hospital"" OR ""sichuan university"" OR ""sìchuān dàxué"" OR ""nanjing medical university"" OR ""national jiangsu medical college"" OR ""huazhong university of science and technology"" OR ""huázhōng kējì dàxué"" OR ""university college london"" OR ""london university"" OR ""karolinska institutet"" OR ""royal caroline institute"" OR ""university of oxford"" OR ""oxford university"" OR ""university of copenhagen"" OR ""universität kopenhagen"" OR ""université de paris"" OR ""university of paris"" OR ""king's college london"" OR ""kcl"" OR ""university of amsterdam"" OR ""universiteit van amsterdam"" OR ""imperial college london"" OR ""coleg imperial llundain"" OR ""utrecht university"" OR ""universiteit utrecht"" OR ""heidelberg university"" OR ""ruprecht-karls-universität heidelberg"" OR ""university of milan"" OR ""université de milan"" OR ""erasmus university rotterdam"" OR ""erasmus universiteit rotterdam"" OR ""freie universität berlin"" OR ""free university of berlin"" OR ""university of cambridge"" OR ""cambridge university"" OR ""humboldt-universität zu berlin"" OR ""humboldt university of berlin"" OR ""university of zurich"" OR ""universität zürich"" OR ""tel aviv university"" OR ""harvard university"" OR ""universidad de harvard"" OR ""johns hopkins university"" OR ""jhu"" OR ""university of toronto"" OR ""université de toronto"" OR ""university of pennsylvania"" Or ""upenn"" OR ""university of california, san francisco"" OR ""ucsf"" OR ""duke university"" OR ""Universidad de Duke"" OR ""university of michigan"" OR ""umich"" OR ""stanford university"" OR ""leland stanford junior university"" OR ""university of melbourne"" OR ""melbourne university"" OR ""university of sydney"" OR ""sydney university"" OR ""university of são paulo"" OR ""universidade de são paulo"") OR author.affiliation.ror_id_lineage:(""03p74gp79"" OR ""0220qvk04"" OR ""013q1eq08"" OR ""0064kty71"" OR ""00a2xv884"" OR ""02v51f717"" OR ""013xs5b60"" OR ""04h9pn542"" OR ""04jztag35"" OR ""011ashp19"" OR ""059gcgy73"" OR ""00p991c53"" OR ""02jx3x895"" OR ""056d84691"" OR ""052gg0110"" OR ""035b05819"" OR ""05f82e368"" OR ""0220mzb33"" OR ""04dkp9463"" OR ""041kmwe10"" OR ""04pp8hn57"" OR ""038t36y30"" OR ""00wjc7c48"" OR ""057w15z03"" OR ""046ak2485"" OR ""013meh722"" OR ""01hcx6992"" OR ""02crff812"" OR ""04mhzgx49"" OR ""03vek6s52"" OR ""00za53h95"" OR ""03dbr7087"" OR ""00b30xv10"" OR ""043mz5j54"" OR ""00py81415"" OR ""00jmfr291"" OR ""00f54p054"" OR ""01ej9dk98"" OR ""0384j8v12"" OR ""036rp1748"")) AND publication_type:""journal article"" AND date_published>=now-10y AND field_of_study: ((""Medicine"" OR ""Internal medicine"" OR ""Pharmacology"") AND (""Gastroenterology"" OR ""Ulcerative colitis"" OR ""Inflammatory bowel disease"" OR ""Crohn's disease""))",AND date_published>=now-10y,"AND field_of_study: ((""Medicine"" OR ""Internal medicine"" OR ""Pharmacology"") AND (""Gastroenterology"" OR ""Ulcerative colitis"" OR ""Inflammatory bowel disease"" OR ""Crohn's disease""))",NA,oa_therapy_area,Uni,Gastroenterology,2013,1669,262,254,98,109,19,742,927
gastroenterology  (primary search + gastroenterology tags) - uni,"(author.affiliation.name:(""university of cape town"" OR ""south african college"" OR ""shanghai jiao tong university"" OR ""shanghai communications university"" OR ""fudan university"" OR ""sun yat-sen university"" OR ""zhejiang university"" OR ""chekiang university"" OR ""peking university"" OR ""imperial university of peking"" OR ""capital medical university"" OR ""cmu"" OR ""seoul national university"" OR ""seoul daehakgyo"" OR ""peking union medical college"" OR ""beijing xiehe hospital"" OR ""sichuan university"" OR ""sìchuān dàxué"" OR ""nanjing medical university"" OR ""national jiangsu medical college"" OR ""huazhong university of science and technology"" OR ""huázhōng kējì dàxué"" OR ""university college london"" OR ""london university"" OR ""karolinska institutet"" OR ""royal caroline institute"" OR ""university of oxford"" OR ""oxford university"" OR ""university of copenhagen"" OR ""universität kopenhagen"" OR ""université de paris"" OR ""university of paris"" OR ""king's college london"" OR ""kcl"" OR ""university of amsterdam"" OR ""universiteit van amsterdam"" OR ""imperial college london"" OR ""coleg imperial llundain"" OR ""utrecht university"" OR ""universiteit utrecht"" OR ""heidelberg university"" OR ""ruprecht-karls-universität heidelberg"" OR ""university of milan"" OR ""université de milan"" OR ""erasmus university rotterdam"" OR ""erasmus universiteit rotterdam"" OR ""freie universität berlin"" OR ""free university of berlin"" OR ""university of cambridge"" OR ""cambridge university"" OR ""humboldt-universität zu berlin"" OR ""humboldt university of berlin"" OR ""university of zurich"" OR ""universität zürich"" OR ""tel aviv university"" OR ""harvard university"" OR ""universidad de harvard"" OR ""johns hopkins university"" OR ""jhu"" OR ""university of toronto"" OR ""université de toronto"" OR ""university of pennsylvania"" Or ""upenn"" OR ""university of california, san francisco"" OR ""ucsf"" OR ""duke university"" OR ""Universidad de Duke"" OR ""university of michigan"" OR ""umich"" OR ""stanford university"" OR ""leland stanford junior university"" OR ""university of melbourne"" OR ""melbourne university"" OR ""university of sydney"" OR ""sydney university"" OR ""university of são paulo"" OR ""universidade de são paulo"") OR author.affiliation.ror_id_lineage:(""03p74gp79"" OR ""0220qvk04"" OR ""013q1eq08"" OR ""0064kty71"" OR ""00a2xv884"" OR ""02v51f717"" OR ""013xs5b60"" OR ""04h9pn542"" OR ""04jztag35"" OR ""011ashp19"" OR ""059gcgy73"" OR ""00p991c53"" OR ""02jx3x895"" OR ""056d84691"" OR ""052gg0110"" OR ""035b05819"" OR ""05f82e368"" OR ""0220mzb33"" OR ""04dkp9463"" OR ""041kmwe10"" OR ""04pp8hn57"" OR ""038t36y30"" OR ""00wjc7c48"" OR ""057w15z03"" OR ""046ak2485"" OR ""013meh722"" OR ""01hcx6992"" OR ""02crff812"" OR ""04mhzgx49"" OR ""03vek6s52"" OR ""00za53h95"" OR ""03dbr7087"" OR ""00b30xv10"" OR ""043mz5j54"" OR ""00py81415"" OR ""00jmfr291"" OR ""00f54p054"" OR ""01ej9dk98"" OR ""0384j8v12"" OR ""036rp1748"")) AND publication_type:""journal article"" AND date_published>=now-10y AND field_of_study: ((""Medicine"" OR ""Internal medicine"" OR ""Pharmacology"") AND (""Gastroenterology"" OR ""Ulcerative colitis"" OR ""Inflammatory bowel disease"" OR ""Crohn's disease""))",AND date_published>=now-10y,"AND field_of_study: ((""Medicine"" OR ""Internal medicine"" OR ""Pharmacology"") AND (""Gastroenterology"" OR ""Ulcerative colitis"" OR ""Inflammatory bowel disease"" OR ""Crohn's disease""))",NA,oa_therapy_area,Uni,Gastroenterology,2014,4529,842,679,278,431,82,2312,2217
gastroenterology  (primary search + gastroenterology tags) - uni,"(author.affiliation.name:(""university of cape town"" OR ""south african college"" OR ""shanghai jiao tong university"" OR ""shanghai communications university"" OR ""fudan university"" OR ""sun yat-sen university"" OR ""zhejiang university"" OR ""chekiang university"" OR ""peking university"" OR ""imperial university of peking"" OR ""capital medical university"" OR ""cmu"" OR ""seoul national university"" OR ""seoul daehakgyo"" OR ""peking union medical college"" OR ""beijing xiehe hospital"" OR ""sichuan university"" OR ""sìchuān dàxué"" OR ""nanjing medical university"" OR ""national jiangsu medical college"" OR ""huazhong university of science and technology"" OR ""huázhōng kējì dàxué"" OR ""university college london"" OR ""london university"" OR ""karolinska institutet"" OR ""royal caroline institute"" OR ""university of oxford"" OR ""oxford university"" OR ""university of copenhagen"" OR ""universität kopenhagen"" OR ""université de paris"" OR ""university of paris"" OR ""king's college london"" OR ""kcl"" OR ""university of amsterdam"" OR ""universiteit van amsterdam"" OR ""imperial college london"" OR ""coleg imperial llundain"" OR ""utrecht university"" OR ""universiteit utrecht"" OR ""heidelberg university"" OR ""ruprecht-karls-universität heidelberg"" OR ""university of milan"" OR ""université de milan"" OR ""erasmus university rotterdam"" OR ""erasmus universiteit rotterdam"" OR ""freie universität berlin"" OR ""free university of berlin"" OR ""university of cambridge"" OR ""cambridge university"" OR ""humboldt-universität zu berlin"" OR ""humboldt university of berlin"" OR ""university of zurich"" OR ""universität zürich"" OR ""tel aviv university"" OR ""harvard university"" OR ""universidad de harvard"" OR ""johns hopkins university"" OR ""jhu"" OR ""university of toronto"" OR ""université de toronto"" OR ""university of pennsylvania"" Or ""upenn"" OR ""university of california, san francisco"" OR ""ucsf"" OR ""duke university"" OR ""Universidad de Duke"" OR ""university of michigan"" OR ""umich"" OR ""stanford university"" OR ""leland stanford junior university"" OR ""university of melbourne"" OR ""melbourne university"" OR ""university of sydney"" OR ""sydney university"" OR ""university of são paulo"" OR ""universidade de são paulo"") OR author.affiliation.ror_id_lineage:(""03p74gp79"" OR ""0220qvk04"" OR ""013q1eq08"" OR ""0064kty71"" OR ""00a2xv884"" OR ""02v51f717"" OR ""013xs5b60"" OR ""04h9pn542"" OR ""04jztag35"" OR ""011ashp19"" OR ""059gcgy73"" OR ""00p991c53"" OR ""02jx3x895"" OR ""056d84691"" OR ""052gg0110"" OR ""035b05819"" OR ""05f82e368"" OR ""0220mzb33"" OR ""04dkp9463"" OR ""041kmwe10"" OR ""04pp8hn57"" OR ""038t36y30"" OR ""00wjc7c48"" OR ""057w15z03"" OR ""046ak2485"" OR ""013meh722"" OR ""01hcx6992"" OR ""02crff812"" OR ""04mhzgx49"" OR ""03vek6s52"" OR ""00za53h95"" OR ""03dbr7087"" OR ""00b30xv10"" OR ""043mz5j54"" OR ""00py81415"" OR ""00jmfr291"" OR ""00f54p054"" OR ""01ej9dk98"" OR ""0384j8v12"" OR ""036rp1748"")) AND publication_type:""journal article"" AND date_published>=now-10y AND field_of_study: ((""Medicine"" OR ""Internal medicine"" OR ""Pharmacology"") AND (""Gastroenterology"" OR ""Ulcerative colitis"" OR ""Inflammatory bowel disease"" OR ""Crohn's disease""))",AND date_published>=now-10y,"AND field_of_study: ((""Medicine"" OR ""Internal medicine"" OR ""Pharmacology"") AND (""Gastroenterology"" OR ""Ulcerative colitis"" OR ""Inflammatory bowel disease"" OR ""Crohn's disease""))",NA,oa_therapy_area,Uni,Gastroenterology,2015,4929,1047,761,297,452,157,2714,2215
gastroenterology  (primary search + gastroenterology tags) - uni,"(author.affiliation.name:(""university of cape town"" OR ""south african college"" OR ""shanghai jiao tong university"" OR ""shanghai communications university"" OR ""fudan university"" OR ""sun yat-sen university"" OR ""zhejiang university"" OR ""chekiang university"" OR ""peking university"" OR ""imperial university of peking"" OR ""capital medical university"" OR ""cmu"" OR ""seoul national university"" OR ""seoul daehakgyo"" OR ""peking union medical college"" OR ""beijing xiehe hospital"" OR ""sichuan university"" OR ""sìchuān dàxué"" OR ""nanjing medical university"" OR ""national jiangsu medical college"" OR ""huazhong university of science and technology"" OR ""huázhōng kējì dàxué"" OR ""university college london"" OR ""london university"" OR ""karolinska institutet"" OR ""royal caroline institute"" OR ""university of oxford"" OR ""oxford university"" OR ""university of copenhagen"" OR ""universität kopenhagen"" OR ""université de paris"" OR ""university of paris"" OR ""king's college london"" OR ""kcl"" OR ""university of amsterdam"" OR ""universiteit van amsterdam"" OR ""imperial college london"" OR ""coleg imperial llundain"" OR ""utrecht university"" OR ""universiteit utrecht"" OR ""heidelberg university"" OR ""ruprecht-karls-universität heidelberg"" OR ""university of milan"" OR ""université de milan"" OR ""erasmus university rotterdam"" OR ""erasmus universiteit rotterdam"" OR ""freie universität berlin"" OR ""free university of berlin"" OR ""university of cambridge"" OR ""cambridge university"" OR ""humboldt-universität zu berlin"" OR ""humboldt university of berlin"" OR ""university of zurich"" OR ""universität zürich"" OR ""tel aviv university"" OR ""harvard university"" OR ""universidad de harvard"" OR ""johns hopkins university"" OR ""jhu"" OR ""university of toronto"" OR ""université de toronto"" OR ""university of pennsylvania"" Or ""upenn"" OR ""university of california, san francisco"" OR ""ucsf"" OR ""duke university"" OR ""Universidad de Duke"" OR ""university of michigan"" OR ""umich"" OR ""stanford university"" OR ""leland stanford junior university"" OR ""university of melbourne"" OR ""melbourne university"" OR ""university of sydney"" OR ""sydney university"" OR ""university of são paulo"" OR ""universidade de são paulo"") OR author.affiliation.ror_id_lineage:(""03p74gp79"" OR ""0220qvk04"" OR ""013q1eq08"" OR ""0064kty71"" OR ""00a2xv884"" OR ""02v51f717"" OR ""013xs5b60"" OR ""04h9pn542"" OR ""04jztag35"" OR ""011ashp19"" OR ""059gcgy73"" OR ""00p991c53"" OR ""02jx3x895"" OR ""056d84691"" OR ""052gg0110"" OR ""035b05819"" OR ""05f82e368"" OR ""0220mzb33"" OR ""04dkp9463"" OR ""041kmwe10"" OR ""04pp8hn57"" OR ""038t36y30"" OR ""00wjc7c48"" OR ""057w15z03"" OR ""046ak2485"" OR ""013meh722"" OR ""01hcx6992"" OR ""02crff812"" OR ""04mhzgx49"" OR ""03vek6s52"" OR ""00za53h95"" OR ""03dbr7087"" OR ""00b30xv10"" OR ""043mz5j54"" OR ""00py81415"" OR ""00jmfr291"" OR ""00f54p054"" OR ""01ej9dk98"" OR ""0384j8v12"" OR ""036rp1748"")) AND publication_type:""journal article"" AND date_published>=now-10y AND field_of_study: ((""Medicine"" OR ""Internal medicine"" OR ""Pharmacology"") AND (""Gastroenterology"" OR ""Ulcerative colitis"" OR ""Inflammatory bowel disease"" OR ""Crohn's disease""))",AND date_published>=now-10y,"AND field_of_study: ((""Medicine"" OR ""Internal medicine"" OR ""Pharmacology"") AND (""Gastroenterology"" OR ""Ulcerative colitis"" OR ""Inflammatory bowel disease"" OR ""Crohn's disease""))",NA,oa_therapy_area,Uni,Gastroenterology,2016,4947,1183,769,250,462,61,2725,2222
gastroenterology  (primary search + gastroenterology tags) - uni,"(author.affiliation.name:(""university of cape town"" OR ""south african college"" OR ""shanghai jiao tong university"" OR ""shanghai communications university"" OR ""fudan university"" OR ""sun yat-sen university"" OR ""zhejiang university"" OR ""chekiang university"" OR ""peking university"" OR ""imperial university of peking"" OR ""capital medical university"" OR ""cmu"" OR ""seoul national university"" OR ""seoul daehakgyo"" OR ""peking union medical college"" OR ""beijing xiehe hospital"" OR ""sichuan university"" OR ""sìchuān dàxué"" OR ""nanjing medical university"" OR ""national jiangsu medical college"" OR ""huazhong university of science and technology"" OR ""huázhōng kējì dàxué"" OR ""university college london"" OR ""london university"" OR ""karolinska institutet"" OR ""royal caroline institute"" OR ""university of oxford"" OR ""oxford university"" OR ""university of copenhagen"" OR ""universität kopenhagen"" OR ""université de paris"" OR ""university of paris"" OR ""king's college london"" OR ""kcl"" OR ""university of amsterdam"" OR ""universiteit van amsterdam"" OR ""imperial college london"" OR ""coleg imperial llundain"" OR ""utrecht university"" OR ""universiteit utrecht"" OR ""heidelberg university"" OR ""ruprecht-karls-universität heidelberg"" OR ""university of milan"" OR ""université de milan"" OR ""erasmus university rotterdam"" OR ""erasmus universiteit rotterdam"" OR ""freie universität berlin"" OR ""free university of berlin"" OR ""university of cambridge"" OR ""cambridge university"" OR ""humboldt-universität zu berlin"" OR ""humboldt university of berlin"" OR ""university of zurich"" OR ""universität zürich"" OR ""tel aviv university"" OR ""harvard university"" OR ""universidad de harvard"" OR ""johns hopkins university"" OR ""jhu"" OR ""university of toronto"" OR ""université de toronto"" OR ""university of pennsylvania"" Or ""upenn"" OR ""university of california, san francisco"" OR ""ucsf"" OR ""duke university"" OR ""Universidad de Duke"" OR ""university of michigan"" OR ""umich"" OR ""stanford university"" OR ""leland stanford junior university"" OR ""university of melbourne"" OR ""melbourne university"" OR ""university of sydney"" OR ""sydney university"" OR ""university of são paulo"" OR ""universidade de são paulo"") OR author.affiliation.ror_id_lineage:(""03p74gp79"" OR ""0220qvk04"" OR ""013q1eq08"" OR ""0064kty71"" OR ""00a2xv884"" OR ""02v51f717"" OR ""013xs5b60"" OR ""04h9pn542"" OR ""04jztag35"" OR ""011ashp19"" OR ""059gcgy73"" OR ""00p991c53"" OR ""02jx3x895"" OR ""056d84691"" OR ""052gg0110"" OR ""035b05819"" OR ""05f82e368"" OR ""0220mzb33"" OR ""04dkp9463"" OR ""041kmwe10"" OR ""04pp8hn57"" OR ""038t36y30"" OR ""00wjc7c48"" OR ""057w15z03"" OR ""046ak2485"" OR ""013meh722"" OR ""01hcx6992"" OR ""02crff812"" OR ""04mhzgx49"" OR ""03vek6s52"" OR ""00za53h95"" OR ""03dbr7087"" OR ""00b30xv10"" OR ""043mz5j54"" OR ""00py81415"" OR ""00jmfr291"" OR ""00f54p054"" OR ""01ej9dk98"" OR ""0384j8v12"" OR ""036rp1748"")) AND publication_type:""journal article"" AND date_published>=now-10y AND field_of_study: ((""Medicine"" OR ""Internal medicine"" OR ""Pharmacology"") AND (""Gastroenterology"" OR ""Ulcerative colitis"" OR ""Inflammatory bowel disease"" OR ""Crohn's disease""))",AND date_published>=now-10y,"AND field_of_study: ((""Medicine"" OR ""Internal medicine"" OR ""Pharmacology"") AND (""Gastroenterology"" OR ""Ulcerative colitis"" OR ""Inflammatory bowel disease"" OR ""Crohn's disease""))",NA,oa_therapy_area,Uni,Gastroenterology,2017,5554,1375,924,329,547,96,3271,2283
gastroenterology  (primary search + gastroenterology tags) - uni,"(author.affiliation.name:(""university of cape town"" OR ""south african college"" OR ""shanghai jiao tong university"" OR ""shanghai communications university"" OR ""fudan university"" OR ""sun yat-sen university"" OR ""zhejiang university"" OR ""chekiang university"" OR ""peking university"" OR ""imperial university of peking"" OR ""capital medical university"" OR ""cmu"" OR ""seoul national university"" OR ""seoul daehakgyo"" OR ""peking union medical college"" OR ""beijing xiehe hospital"" OR ""sichuan university"" OR ""sìchuān dàxué"" OR ""nanjing medical university"" OR ""national jiangsu medical college"" OR ""huazhong university of science and technology"" OR ""huázhōng kējì dàxué"" OR ""university college london"" OR ""london university"" OR ""karolinska institutet"" OR ""royal caroline institute"" OR ""university of oxford"" OR ""oxford university"" OR ""university of copenhagen"" OR ""universität kopenhagen"" OR ""université de paris"" OR ""university of paris"" OR ""king's college london"" OR ""kcl"" OR ""university of amsterdam"" OR ""universiteit van amsterdam"" OR ""imperial college london"" OR ""coleg imperial llundain"" OR ""utrecht university"" OR ""universiteit utrecht"" OR ""heidelberg university"" OR ""ruprecht-karls-universität heidelberg"" OR ""university of milan"" OR ""université de milan"" OR ""erasmus university rotterdam"" OR ""erasmus universiteit rotterdam"" OR ""freie universität berlin"" OR ""free university of berlin"" OR ""university of cambridge"" OR ""cambridge university"" OR ""humboldt-universität zu berlin"" OR ""humboldt university of berlin"" OR ""university of zurich"" OR ""universität zürich"" OR ""tel aviv university"" OR ""harvard university"" OR ""universidad de harvard"" OR ""johns hopkins university"" OR ""jhu"" OR ""university of toronto"" OR ""université de toronto"" OR ""university of pennsylvania"" Or ""upenn"" OR ""university of california, san francisco"" OR ""ucsf"" OR ""duke university"" OR ""Universidad de Duke"" OR ""university of michigan"" OR ""umich"" OR ""stanford university"" OR ""leland stanford junior university"" OR ""university of melbourne"" OR ""melbourne university"" OR ""university of sydney"" OR ""sydney university"" OR ""university of são paulo"" OR ""universidade de são paulo"") OR author.affiliation.ror_id_lineage:(""03p74gp79"" OR ""0220qvk04"" OR ""013q1eq08"" OR ""0064kty71"" OR ""00a2xv884"" OR ""02v51f717"" OR ""013xs5b60"" OR ""04h9pn542"" OR ""04jztag35"" OR ""011ashp19"" OR ""059gcgy73"" OR ""00p991c53"" OR ""02jx3x895"" OR ""056d84691"" OR ""052gg0110"" OR ""035b05819"" OR ""05f82e368"" OR ""0220mzb33"" OR ""04dkp9463"" OR ""041kmwe10"" OR ""04pp8hn57"" OR ""038t36y30"" OR ""00wjc7c48"" OR ""057w15z03"" OR ""046ak2485"" OR ""013meh722"" OR ""01hcx6992"" OR ""02crff812"" OR ""04mhzgx49"" OR ""03vek6s52"" OR ""00za53h95"" OR ""03dbr7087"" OR ""00b30xv10"" OR ""043mz5j54"" OR ""00py81415"" OR ""00jmfr291"" OR ""00f54p054"" OR ""01ej9dk98"" OR ""0384j8v12"" OR ""036rp1748"")) AND publication_type:""journal article"" AND date_published>=now-10y AND field_of_study: ((""Medicine"" OR ""Internal medicine"" OR ""Pharmacology"") AND (""Gastroenterology"" OR ""Ulcerative colitis"" OR ""Inflammatory bowel disease"" OR ""Crohn's disease""))",AND date_published>=now-10y,"AND field_of_study: ((""Medicine"" OR ""Internal medicine"" OR ""Pharmacology"") AND (""Gastroenterology"" OR ""Ulcerative colitis"" OR ""Inflammatory bowel disease"" OR ""Crohn's disease""))",NA,oa_therapy_area,Uni,Gastroenterology,2018,6442,1681,963,443,699,124,3910,2532
gastroenterology  (primary search + gastroenterology tags) - uni,"(author.affiliation.name:(""university of cape town"" OR ""south african college"" OR ""shanghai jiao tong university"" OR ""shanghai communications university"" OR ""fudan university"" OR ""sun yat-sen university"" OR ""zhejiang university"" OR ""chekiang university"" OR ""peking university"" OR ""imperial university of peking"" OR ""capital medical university"" OR ""cmu"" OR ""seoul national university"" OR ""seoul daehakgyo"" OR ""peking union medical college"" OR ""beijing xiehe hospital"" OR ""sichuan university"" OR ""sìchuān dàxué"" OR ""nanjing medical university"" OR ""national jiangsu medical college"" OR ""huazhong university of science and technology"" OR ""huázhōng kējì dàxué"" OR ""university college london"" OR ""london university"" OR ""karolinska institutet"" OR ""royal caroline institute"" OR ""university of oxford"" OR ""oxford university"" OR ""university of copenhagen"" OR ""universität kopenhagen"" OR ""université de paris"" OR ""university of paris"" OR ""king's college london"" OR ""kcl"" OR ""university of amsterdam"" OR ""universiteit van amsterdam"" OR ""imperial college london"" OR ""coleg imperial llundain"" OR ""utrecht university"" OR ""universiteit utrecht"" OR ""heidelberg university"" OR ""ruprecht-karls-universität heidelberg"" OR ""university of milan"" OR ""université de milan"" OR ""erasmus university rotterdam"" OR ""erasmus universiteit rotterdam"" OR ""freie universität berlin"" OR ""free university of berlin"" OR ""university of cambridge"" OR ""cambridge university"" OR ""humboldt-universität zu berlin"" OR ""humboldt university of berlin"" OR ""university of zurich"" OR ""universität zürich"" OR ""tel aviv university"" OR ""harvard university"" OR ""universidad de harvard"" OR ""johns hopkins university"" OR ""jhu"" OR ""university of toronto"" OR ""université de toronto"" OR ""university of pennsylvania"" Or ""upenn"" OR ""university of california, san francisco"" OR ""ucsf"" OR ""duke university"" OR ""Universidad de Duke"" OR ""university of michigan"" OR ""umich"" OR ""stanford university"" OR ""leland stanford junior university"" OR ""university of melbourne"" OR ""melbourne university"" OR ""university of sydney"" OR ""sydney university"" OR ""university of são paulo"" OR ""universidade de são paulo"") OR author.affiliation.ror_id_lineage:(""03p74gp79"" OR ""0220qvk04"" OR ""013q1eq08"" OR ""0064kty71"" OR ""00a2xv884"" OR ""02v51f717"" OR ""013xs5b60"" OR ""04h9pn542"" OR ""04jztag35"" OR ""011ashp19"" OR ""059gcgy73"" OR ""00p991c53"" OR ""02jx3x895"" OR ""056d84691"" OR ""052gg0110"" OR ""035b05819"" OR ""05f82e368"" OR ""0220mzb33"" OR ""04dkp9463"" OR ""041kmwe10"" OR ""04pp8hn57"" OR ""038t36y30"" OR ""00wjc7c48"" OR ""057w15z03"" OR ""046ak2485"" OR ""013meh722"" OR ""01hcx6992"" OR ""02crff812"" OR ""04mhzgx49"" OR ""03vek6s52"" OR ""00za53h95"" OR ""03dbr7087"" OR ""00b30xv10"" OR ""043mz5j54"" OR ""00py81415"" OR ""00jmfr291"" OR ""00f54p054"" OR ""01ej9dk98"" OR ""0384j8v12"" OR ""036rp1748"")) AND publication_type:""journal article"" AND date_published>=now-10y AND field_of_study: ((""Medicine"" OR ""Internal medicine"" OR ""Pharmacology"") AND (""Gastroenterology"" OR ""Ulcerative colitis"" OR ""Inflammatory bowel disease"" OR ""Crohn's disease""))",AND date_published>=now-10y,"AND field_of_study: ((""Medicine"" OR ""Internal medicine"" OR ""Pharmacology"") AND (""Gastroenterology"" OR ""Ulcerative colitis"" OR ""Inflammatory bowel disease"" OR ""Crohn's disease""))",NA,oa_therapy_area,Uni,Gastroenterology,2019,7055,2068,958,568,594,125,4313,2742
gastroenterology  (primary search + gastroenterology tags) - uni,"(author.affiliation.name:(""university of cape town"" OR ""south african college"" OR ""shanghai jiao tong university"" OR ""shanghai communications university"" OR ""fudan university"" OR ""sun yat-sen university"" OR ""zhejiang university"" OR ""chekiang university"" OR ""peking university"" OR ""imperial university of peking"" OR ""capital medical university"" OR ""cmu"" OR ""seoul national university"" OR ""seoul daehakgyo"" OR ""peking union medical college"" OR ""beijing xiehe hospital"" OR ""sichuan university"" OR ""sìchuān dàxué"" OR ""nanjing medical university"" OR ""national jiangsu medical college"" OR ""huazhong university of science and technology"" OR ""huázhōng kējì dàxué"" OR ""university college london"" OR ""london university"" OR ""karolinska institutet"" OR ""royal caroline institute"" OR ""university of oxford"" OR ""oxford university"" OR ""university of copenhagen"" OR ""universität kopenhagen"" OR ""université de paris"" OR ""university of paris"" OR ""king's college london"" OR ""kcl"" OR ""university of amsterdam"" OR ""universiteit van amsterdam"" OR ""imperial college london"" OR ""coleg imperial llundain"" OR ""utrecht university"" OR ""universiteit utrecht"" OR ""heidelberg university"" OR ""ruprecht-karls-universität heidelberg"" OR ""university of milan"" OR ""université de milan"" OR ""erasmus university rotterdam"" OR ""erasmus universiteit rotterdam"" OR ""freie universität berlin"" OR ""free university of berlin"" OR ""university of cambridge"" OR ""cambridge university"" OR ""humboldt-universität zu berlin"" OR ""humboldt university of berlin"" OR ""university of zurich"" OR ""universität zürich"" OR ""tel aviv university"" OR ""harvard university"" OR ""universidad de harvard"" OR ""johns hopkins university"" OR ""jhu"" OR ""university of toronto"" OR ""université de toronto"" OR ""university of pennsylvania"" Or ""upenn"" OR ""university of california, san francisco"" OR ""ucsf"" OR ""duke university"" OR ""Universidad de Duke"" OR ""university of michigan"" OR ""umich"" OR ""stanford university"" OR ""leland stanford junior university"" OR ""university of melbourne"" OR ""melbourne university"" OR ""university of sydney"" OR ""sydney university"" OR ""university of são paulo"" OR ""universidade de são paulo"") OR author.affiliation.ror_id_lineage:(""03p74gp79"" OR ""0220qvk04"" OR ""013q1eq08"" OR ""0064kty71"" OR ""00a2xv884"" OR ""02v51f717"" OR ""013xs5b60"" OR ""04h9pn542"" OR ""04jztag35"" OR ""011ashp19"" OR ""059gcgy73"" OR ""00p991c53"" OR ""02jx3x895"" OR ""056d84691"" OR ""052gg0110"" OR ""035b05819"" OR ""05f82e368"" OR ""0220mzb33"" OR ""04dkp9463"" OR ""041kmwe10"" OR ""04pp8hn57"" OR ""038t36y30"" OR ""00wjc7c48"" OR ""057w15z03"" OR ""046ak2485"" OR ""013meh722"" OR ""01hcx6992"" OR ""02crff812"" OR ""04mhzgx49"" OR ""03vek6s52"" OR ""00za53h95"" OR ""03dbr7087"" OR ""00b30xv10"" OR ""043mz5j54"" OR ""00py81415"" OR ""00jmfr291"" OR ""00f54p054"" OR ""01ej9dk98"" OR ""0384j8v12"" OR ""036rp1748"")) AND publication_type:""journal article"" AND date_published>=now-10y AND field_of_study: ((""Medicine"" OR ""Internal medicine"" OR ""Pharmacology"") AND (""Gastroenterology"" OR ""Ulcerative colitis"" OR ""Inflammatory bowel disease"" OR ""Crohn's disease""))",AND date_published>=now-10y,"AND field_of_study: ((""Medicine"" OR ""Internal medicine"" OR ""Pharmacology"") AND (""Gastroenterology"" OR ""Ulcerative colitis"" OR ""Inflammatory bowel disease"" OR ""Crohn's disease""))",NA,oa_therapy_area,Uni,Gastroenterology,2020,8702,3027,1067,778,669,188,5729,2973
gastroenterology  (primary search + gastroenterology tags) - uni,"(author.affiliation.name:(""university of cape town"" OR ""south african college"" OR ""shanghai jiao tong university"" OR ""shanghai communications university"" OR ""fudan university"" OR ""sun yat-sen university"" OR ""zhejiang university"" OR ""chekiang university"" OR ""peking university"" OR ""imperial university of peking"" OR ""capital medical university"" OR ""cmu"" OR ""seoul national university"" OR ""seoul daehakgyo"" OR ""peking union medical college"" OR ""beijing xiehe hospital"" OR ""sichuan university"" OR ""sìchuān dàxué"" OR ""nanjing medical university"" OR ""national jiangsu medical college"" OR ""huazhong university of science and technology"" OR ""huázhōng kējì dàxué"" OR ""university college london"" OR ""london university"" OR ""karolinska institutet"" OR ""royal caroline institute"" OR ""university of oxford"" OR ""oxford university"" OR ""university of copenhagen"" OR ""universität kopenhagen"" OR ""université de paris"" OR ""university of paris"" OR ""king's college london"" OR ""kcl"" OR ""university of amsterdam"" OR ""universiteit van amsterdam"" OR ""imperial college london"" OR ""coleg imperial llundain"" OR ""utrecht university"" OR ""universiteit utrecht"" OR ""heidelberg university"" OR ""ruprecht-karls-universität heidelberg"" OR ""university of milan"" OR ""université de milan"" OR ""erasmus university rotterdam"" OR ""erasmus universiteit rotterdam"" OR ""freie universität berlin"" OR ""free university of berlin"" OR ""university of cambridge"" OR ""cambridge university"" OR ""humboldt-universität zu berlin"" OR ""humboldt university of berlin"" OR ""university of zurich"" OR ""universität zürich"" OR ""tel aviv university"" OR ""harvard university"" OR ""universidad de harvard"" OR ""johns hopkins university"" OR ""jhu"" OR ""university of toronto"" OR ""université de toronto"" OR ""university of pennsylvania"" Or ""upenn"" OR ""university of california, san francisco"" OR ""ucsf"" OR ""duke university"" OR ""Universidad de Duke"" OR ""university of michigan"" OR ""umich"" OR ""stanford university"" OR ""leland stanford junior university"" OR ""university of melbourne"" OR ""melbourne university"" OR ""university of sydney"" OR ""sydney university"" OR ""university of são paulo"" OR ""universidade de são paulo"") OR author.affiliation.ror_id_lineage:(""03p74gp79"" OR ""0220qvk04"" OR ""013q1eq08"" OR ""0064kty71"" OR ""00a2xv884"" OR ""02v51f717"" OR ""013xs5b60"" OR ""04h9pn542"" OR ""04jztag35"" OR ""011ashp19"" OR ""059gcgy73"" OR ""00p991c53"" OR ""02jx3x895"" OR ""056d84691"" OR ""052gg0110"" OR ""035b05819"" OR ""05f82e368"" OR ""0220mzb33"" OR ""04dkp9463"" OR ""041kmwe10"" OR ""04pp8hn57"" OR ""038t36y30"" OR ""00wjc7c48"" OR ""057w15z03"" OR ""046ak2485"" OR ""013meh722"" OR ""01hcx6992"" OR ""02crff812"" OR ""04mhzgx49"" OR ""03vek6s52"" OR ""00za53h95"" OR ""03dbr7087"" OR ""00b30xv10"" OR ""043mz5j54"" OR ""00py81415"" OR ""00jmfr291"" OR ""00f54p054"" OR ""01ej9dk98"" OR ""0384j8v12"" OR ""036rp1748"")) AND publication_type:""journal article"" AND date_published>=now-10y AND field_of_study: ((""Medicine"" OR ""Internal medicine"" OR ""Pharmacology"") AND (""Gastroenterology"" OR ""Ulcerative colitis"" OR ""Inflammatory bowel disease"" OR ""Crohn's disease""))",AND date_published>=now-10y,"AND field_of_study: ((""Medicine"" OR ""Internal medicine"" OR ""Pharmacology"") AND (""Gastroenterology"" OR ""Ulcerative colitis"" OR ""Inflammatory bowel disease"" OR ""Crohn's disease""))",NA,oa_therapy_area,Uni,Gastroenterology,2021,9070,3740,571,996,569,390,6266,2804
gastroenterology  (primary search + gastroenterology tags) - uni,"(author.affiliation.name:(""university of cape town"" OR ""south african college"" OR ""shanghai jiao tong university"" OR ""shanghai communications university"" OR ""fudan university"" OR ""sun yat-sen university"" OR ""zhejiang university"" OR ""chekiang university"" OR ""peking university"" OR ""imperial university of peking"" OR ""capital medical university"" OR ""cmu"" OR ""seoul national university"" OR ""seoul daehakgyo"" OR ""peking union medical college"" OR ""beijing xiehe hospital"" OR ""sichuan university"" OR ""sìchuān dàxué"" OR ""nanjing medical university"" OR ""national jiangsu medical college"" OR ""huazhong university of science and technology"" OR ""huázhōng kējì dàxué"" OR ""university college london"" OR ""london university"" OR ""karolinska institutet"" OR ""royal caroline institute"" OR ""university of oxford"" OR ""oxford university"" OR ""university of copenhagen"" OR ""universität kopenhagen"" OR ""université de paris"" OR ""university of paris"" OR ""king's college london"" OR ""kcl"" OR ""university of amsterdam"" OR ""universiteit van amsterdam"" OR ""imperial college london"" OR ""coleg imperial llundain"" OR ""utrecht university"" OR ""universiteit utrecht"" OR ""heidelberg university"" OR ""ruprecht-karls-universität heidelberg"" OR ""university of milan"" OR ""université de milan"" OR ""erasmus university rotterdam"" OR ""erasmus universiteit rotterdam"" OR ""freie universität berlin"" OR ""free university of berlin"" OR ""university of cambridge"" OR ""cambridge university"" OR ""humboldt-universität zu berlin"" OR ""humboldt university of berlin"" OR ""university of zurich"" OR ""universität zürich"" OR ""tel aviv university"" OR ""harvard university"" OR ""universidad de harvard"" OR ""johns hopkins university"" OR ""jhu"" OR ""university of toronto"" OR ""université de toronto"" OR ""university of pennsylvania"" Or ""upenn"" OR ""university of california, san francisco"" OR ""ucsf"" OR ""duke university"" OR ""Universidad de Duke"" OR ""university of michigan"" OR ""umich"" OR ""stanford university"" OR ""leland stanford junior university"" OR ""university of melbourne"" OR ""melbourne university"" OR ""university of sydney"" OR ""sydney university"" OR ""university of são paulo"" OR ""universidade de são paulo"") OR author.affiliation.ror_id_lineage:(""03p74gp79"" OR ""0220qvk04"" OR ""013q1eq08"" OR ""0064kty71"" OR ""00a2xv884"" OR ""02v51f717"" OR ""013xs5b60"" OR ""04h9pn542"" OR ""04jztag35"" OR ""011ashp19"" OR ""059gcgy73"" OR ""00p991c53"" OR ""02jx3x895"" OR ""056d84691"" OR ""052gg0110"" OR ""035b05819"" OR ""05f82e368"" OR ""0220mzb33"" OR ""04dkp9463"" OR ""041kmwe10"" OR ""04pp8hn57"" OR ""038t36y30"" OR ""00wjc7c48"" OR ""057w15z03"" OR ""046ak2485"" OR ""013meh722"" OR ""01hcx6992"" OR ""02crff812"" OR ""04mhzgx49"" OR ""03vek6s52"" OR ""00za53h95"" OR ""03dbr7087"" OR ""00b30xv10"" OR ""043mz5j54"" OR ""00py81415"" OR ""00jmfr291"" OR ""00f54p054"" OR ""01ej9dk98"" OR ""0384j8v12"" OR ""036rp1748"")) AND publication_type:""journal article"" AND date_published>=now-10y AND field_of_study: ((""Medicine"" OR ""Internal medicine"" OR ""Pharmacology"") AND (""Gastroenterology"" OR ""Ulcerative colitis"" OR ""Inflammatory bowel disease"" OR ""Crohn's disease""))",AND date_published>=now-10y,"AND field_of_study: ((""Medicine"" OR ""Internal medicine"" OR ""Pharmacology"") AND (""Gastroenterology"" OR ""Ulcerative colitis"" OR ""Inflammatory bowel disease"" OR ""Crohn's disease""))",NA,oa_therapy_area,Uni,Gastroenterology,2022,11301,4996,590,1042,646,281,7555,3746
gastroenterology  (primary search + gastroenterology tags) - uni,"(author.affiliation.name:(""university of cape town"" OR ""south african college"" OR ""shanghai jiao tong university"" OR ""shanghai communications university"" OR ""fudan university"" OR ""sun yat-sen university"" OR ""zhejiang university"" OR ""chekiang university"" OR ""peking university"" OR ""imperial university of peking"" OR ""capital medical university"" OR ""cmu"" OR ""seoul national university"" OR ""seoul daehakgyo"" OR ""peking union medical college"" OR ""beijing xiehe hospital"" OR ""sichuan university"" OR ""sìchuān dàxué"" OR ""nanjing medical university"" OR ""national jiangsu medical college"" OR ""huazhong university of science and technology"" OR ""huázhōng kējì dàxué"" OR ""university college london"" OR ""london university"" OR ""karolinska institutet"" OR ""royal caroline institute"" OR ""university of oxford"" OR ""oxford university"" OR ""university of copenhagen"" OR ""universität kopenhagen"" OR ""université de paris"" OR ""university of paris"" OR ""king's college london"" OR ""kcl"" OR ""university of amsterdam"" OR ""universiteit van amsterdam"" OR ""imperial college london"" OR ""coleg imperial llundain"" OR ""utrecht university"" OR ""universiteit utrecht"" OR ""heidelberg university"" OR ""ruprecht-karls-universität heidelberg"" OR ""university of milan"" OR ""université de milan"" OR ""erasmus university rotterdam"" OR ""erasmus universiteit rotterdam"" OR ""freie universität berlin"" OR ""free university of berlin"" OR ""university of cambridge"" OR ""cambridge university"" OR ""humboldt-universität zu berlin"" OR ""humboldt university of berlin"" OR ""university of zurich"" OR ""universität zürich"" OR ""tel aviv university"" OR ""harvard university"" OR ""universidad de harvard"" OR ""johns hopkins university"" OR ""jhu"" OR ""university of toronto"" OR ""université de toronto"" OR ""university of pennsylvania"" Or ""upenn"" OR ""university of california, san francisco"" OR ""ucsf"" OR ""duke university"" OR ""Universidad de Duke"" OR ""university of michigan"" OR ""umich"" OR ""stanford university"" OR ""leland stanford junior university"" OR ""university of melbourne"" OR ""melbourne university"" OR ""university of sydney"" OR ""sydney university"" OR ""university of são paulo"" OR ""universidade de são paulo"") OR author.affiliation.ror_id_lineage:(""03p74gp79"" OR ""0220qvk04"" OR ""013q1eq08"" OR ""0064kty71"" OR ""00a2xv884"" OR ""02v51f717"" OR ""013xs5b60"" OR ""04h9pn542"" OR ""04jztag35"" OR ""011ashp19"" OR ""059gcgy73"" OR ""00p991c53"" OR ""02jx3x895"" OR ""056d84691"" OR ""052gg0110"" OR ""035b05819"" OR ""05f82e368"" OR ""0220mzb33"" OR ""04dkp9463"" OR ""041kmwe10"" OR ""04pp8hn57"" OR ""038t36y30"" OR ""00wjc7c48"" OR ""057w15z03"" OR ""046ak2485"" OR ""013meh722"" OR ""01hcx6992"" OR ""02crff812"" OR ""04mhzgx49"" OR ""03vek6s52"" OR ""00za53h95"" OR ""03dbr7087"" OR ""00b30xv10"" OR ""043mz5j54"" OR ""00py81415"" OR ""00jmfr291"" OR ""00f54p054"" OR ""01ej9dk98"" OR ""0384j8v12"" OR ""036rp1748"")) AND publication_type:""journal article"" AND date_published>=now-10y AND field_of_study: ((""Medicine"" OR ""Internal medicine"" OR ""Pharmacology"") AND (""Gastroenterology"" OR ""Ulcerative colitis"" OR ""Inflammatory bowel disease"" OR ""Crohn's disease""))",AND date_published>=now-10y,"AND field_of_study: ((""Medicine"" OR ""Internal medicine"" OR ""Pharmacology"") AND (""Gastroenterology"" OR ""Ulcerative colitis"" OR ""Inflammatory bowel disease"" OR ""Crohn's disease""))",NA,oa_therapy_area,Uni,Gastroenterology,2023,4311,1853,49,396,235,264,2797,1514
microbiology (inc infections)  (primary search + microbiology tags) - uni,"(author.affiliation.name:(""university of cape town"" OR ""south african college"" OR ""shanghai jiao tong university"" OR ""shanghai communications university"" OR ""fudan university"" OR ""sun yat-sen university"" OR ""zhejiang university"" OR ""chekiang university"" OR ""peking university"" OR ""imperial university of peking"" OR ""capital medical university"" OR ""cmu"" OR ""seoul national university"" OR ""seoul daehakgyo"" OR ""peking union medical college"" OR ""beijing xiehe hospital"" OR ""sichuan university"" OR ""sìchuān dàxué"" OR ""nanjing medical university"" OR ""national jiangsu medical college"" OR ""huazhong university of science and technology"" OR ""huázhōng kējì dàxué"" OR ""university college london"" OR ""london university"" OR ""karolinska institutet"" OR ""royal caroline institute"" OR ""university of oxford"" OR ""oxford university"" OR ""university of copenhagen"" OR ""universität kopenhagen"" OR ""université de paris"" OR ""university of paris"" OR ""king's college london"" OR ""kcl"" OR ""university of amsterdam"" OR ""universiteit van amsterdam"" OR ""imperial college london"" OR ""coleg imperial llundain"" OR ""utrecht university"" OR ""universiteit utrecht"" OR ""heidelberg university"" OR ""ruprecht-karls-universität heidelberg"" OR ""university of milan"" OR ""université de milan"" OR ""erasmus university rotterdam"" OR ""erasmus universiteit rotterdam"" OR ""freie universität berlin"" OR ""free university of berlin"" OR ""university of cambridge"" OR ""cambridge university"" OR ""humboldt-universität zu berlin"" OR ""humboldt university of berlin"" OR ""university of zurich"" OR ""universität zürich"" OR ""tel aviv university"" OR ""harvard university"" OR ""universidad de harvard"" OR ""johns hopkins university"" OR ""jhu"" OR ""university of toronto"" OR ""université de toronto"" OR ""university of pennsylvania"" Or ""upenn"" OR ""university of california, san francisco"" OR ""ucsf"" OR ""duke university"" OR ""Universidad de Duke"" OR ""university of michigan"" OR ""umich"" OR ""stanford university"" OR ""leland stanford junior university"" OR ""university of melbourne"" OR ""melbourne university"" OR ""university of sydney"" OR ""sydney university"" OR ""university of são paulo"" OR ""universidade de são paulo"") OR author.affiliation.ror_id_lineage:(""03p74gp79"" OR ""0220qvk04"" OR ""013q1eq08"" OR ""0064kty71"" OR ""00a2xv884"" OR ""02v51f717"" OR ""013xs5b60"" OR ""04h9pn542"" OR ""04jztag35"" OR ""011ashp19"" OR ""059gcgy73"" OR ""00p991c53"" OR ""02jx3x895"" OR ""056d84691"" OR ""052gg0110"" OR ""035b05819"" OR ""05f82e368"" OR ""0220mzb33"" OR ""04dkp9463"" OR ""041kmwe10"" OR ""04pp8hn57"" OR ""038t36y30"" OR ""00wjc7c48"" OR ""057w15z03"" OR ""046ak2485"" OR ""013meh722"" OR ""01hcx6992"" OR ""02crff812"" OR ""04mhzgx49"" OR ""03vek6s52"" OR ""00za53h95"" OR ""03dbr7087"" OR ""00b30xv10"" OR ""043mz5j54"" OR ""00py81415"" OR ""00jmfr291"" OR ""00f54p054"" OR ""01ej9dk98"" OR ""0384j8v12"" OR ""036rp1748"")) AND publication_type:""journal article"" AND date_published>=now-10y AND field_of_study: ((""Medicine"" OR ""Internal medicine"" OR ""Pharmacology"") AND (""Virology"" OR ""Virus"" OR ""Microbiology"" OR ""Infectious disease (medical specialty)"" OR ""Viral load"" OR ""Pneumonia"" OR ""Human immunodeficiency virus (HIV)"" OR ""Hepatitis C virus"" OR ""Hepatitis C"" OR ""Immunization"" OR ""Bacteria"" OR ""Tuberculosis"" OR ""Antibiotic resistance"" OR ""Hepatitis B virus""))",AND date_published>=now-10y,"AND field_of_study: ((""Medicine"" OR ""Internal medicine"" OR ""Pharmacology"") AND (""Virology"" OR ""Virus"" OR ""Microbiology"" OR ""Infectious disease (medical specialty)"" OR ""Viral load"" OR ""Pneumonia"" OR ""Human immunodeficiency virus (HIV)"" OR ""Hepatitis C virus"" OR ""Hepatitis C"" OR ""Immunization"" OR ""Bacteria"" OR ""Tuberculosis"" OR ""Antibiotic resistance"" OR ""Hepatitis B virus""))",NA,oa_therapy_area,Uni,Microbiology,2013,1259,394,271,54,87,13,819,440
microbiology (inc infections)  (primary search + microbiology tags) - uni,"(author.affiliation.name:(""university of cape town"" OR ""south african college"" OR ""shanghai jiao tong university"" OR ""shanghai communications university"" OR ""fudan university"" OR ""sun yat-sen university"" OR ""zhejiang university"" OR ""chekiang university"" OR ""peking university"" OR ""imperial university of peking"" OR ""capital medical university"" OR ""cmu"" OR ""seoul national university"" OR ""seoul daehakgyo"" OR ""peking union medical college"" OR ""beijing xiehe hospital"" OR ""sichuan university"" OR ""sìchuān dàxué"" OR ""nanjing medical university"" OR ""national jiangsu medical college"" OR ""huazhong university of science and technology"" OR ""huázhōng kējì dàxué"" OR ""university college london"" OR ""london university"" OR ""karolinska institutet"" OR ""royal caroline institute"" OR ""university of oxford"" OR ""oxford university"" OR ""university of copenhagen"" OR ""universität kopenhagen"" OR ""université de paris"" OR ""university of paris"" OR ""king's college london"" OR ""kcl"" OR ""university of amsterdam"" OR ""universiteit van amsterdam"" OR ""imperial college london"" OR ""coleg imperial llundain"" OR ""utrecht university"" OR ""universiteit utrecht"" OR ""heidelberg university"" OR ""ruprecht-karls-universität heidelberg"" OR ""university of milan"" OR ""université de milan"" OR ""erasmus university rotterdam"" OR ""erasmus universiteit rotterdam"" OR ""freie universität berlin"" OR ""free university of berlin"" OR ""university of cambridge"" OR ""cambridge university"" OR ""humboldt-universität zu berlin"" OR ""humboldt university of berlin"" OR ""university of zurich"" OR ""universität zürich"" OR ""tel aviv university"" OR ""harvard university"" OR ""universidad de harvard"" OR ""johns hopkins university"" OR ""jhu"" OR ""university of toronto"" OR ""université de toronto"" OR ""university of pennsylvania"" Or ""upenn"" OR ""university of california, san francisco"" OR ""ucsf"" OR ""duke university"" OR ""Universidad de Duke"" OR ""university of michigan"" OR ""umich"" OR ""stanford university"" OR ""leland stanford junior university"" OR ""university of melbourne"" OR ""melbourne university"" OR ""university of sydney"" OR ""sydney university"" OR ""university of são paulo"" OR ""universidade de são paulo"") OR author.affiliation.ror_id_lineage:(""03p74gp79"" OR ""0220qvk04"" OR ""013q1eq08"" OR ""0064kty71"" OR ""00a2xv884"" OR ""02v51f717"" OR ""013xs5b60"" OR ""04h9pn542"" OR ""04jztag35"" OR ""011ashp19"" OR ""059gcgy73"" OR ""00p991c53"" OR ""02jx3x895"" OR ""056d84691"" OR ""052gg0110"" OR ""035b05819"" OR ""05f82e368"" OR ""0220mzb33"" OR ""04dkp9463"" OR ""041kmwe10"" OR ""04pp8hn57"" OR ""038t36y30"" OR ""00wjc7c48"" OR ""057w15z03"" OR ""046ak2485"" OR ""013meh722"" OR ""01hcx6992"" OR ""02crff812"" OR ""04mhzgx49"" OR ""03vek6s52"" OR ""00za53h95"" OR ""03dbr7087"" OR ""00b30xv10"" OR ""043mz5j54"" OR ""00py81415"" OR ""00jmfr291"" OR ""00f54p054"" OR ""01ej9dk98"" OR ""0384j8v12"" OR ""036rp1748"")) AND publication_type:""journal article"" AND date_published>=now-10y AND field_of_study: ((""Medicine"" OR ""Internal medicine"" OR ""Pharmacology"") AND (""Virology"" OR ""Virus"" OR ""Microbiology"" OR ""Infectious disease (medical specialty)"" OR ""Viral load"" OR ""Pneumonia"" OR ""Human immunodeficiency virus (HIV)"" OR ""Hepatitis C virus"" OR ""Hepatitis C"" OR ""Immunization"" OR ""Bacteria"" OR ""Tuberculosis"" OR ""Antibiotic resistance"" OR ""Hepatitis B virus""))",AND date_published>=now-10y,"AND field_of_study: ((""Medicine"" OR ""Internal medicine"" OR ""Pharmacology"") AND (""Virology"" OR ""Virus"" OR ""Microbiology"" OR ""Infectious disease (medical specialty)"" OR ""Viral load"" OR ""Pneumonia"" OR ""Human immunodeficiency virus (HIV)"" OR ""Hepatitis C virus"" OR ""Hepatitis C"" OR ""Immunization"" OR ""Bacteria"" OR ""Tuberculosis"" OR ""Antibiotic resistance"" OR ""Hepatitis B virus""))",NA,oa_therapy_area,Uni,Microbiology,2014,3384,1056,798,166,243,66,2329,1055
microbiology (inc infections)  (primary search + microbiology tags) - uni,"(author.affiliation.name:(""university of cape town"" OR ""south african college"" OR ""shanghai jiao tong university"" OR ""shanghai communications university"" OR ""fudan university"" OR ""sun yat-sen university"" OR ""zhejiang university"" OR ""chekiang university"" OR ""peking university"" OR ""imperial university of peking"" OR ""capital medical university"" OR ""cmu"" OR ""seoul national university"" OR ""seoul daehakgyo"" OR ""peking union medical college"" OR ""beijing xiehe hospital"" OR ""sichuan university"" OR ""sìchuān dàxué"" OR ""nanjing medical university"" OR ""national jiangsu medical college"" OR ""huazhong university of science and technology"" OR ""huázhōng kējì dàxué"" OR ""university college london"" OR ""london university"" OR ""karolinska institutet"" OR ""royal caroline institute"" OR ""university of oxford"" OR ""oxford university"" OR ""university of copenhagen"" OR ""universität kopenhagen"" OR ""université de paris"" OR ""university of paris"" OR ""king's college london"" OR ""kcl"" OR ""university of amsterdam"" OR ""universiteit van amsterdam"" OR ""imperial college london"" OR ""coleg imperial llundain"" OR ""utrecht university"" OR ""universiteit utrecht"" OR ""heidelberg university"" OR ""ruprecht-karls-universität heidelberg"" OR ""university of milan"" OR ""université de milan"" OR ""erasmus university rotterdam"" OR ""erasmus universiteit rotterdam"" OR ""freie universität berlin"" OR ""free university of berlin"" OR ""university of cambridge"" OR ""cambridge university"" OR ""humboldt-universität zu berlin"" OR ""humboldt university of berlin"" OR ""university of zurich"" OR ""universität zürich"" OR ""tel aviv university"" OR ""harvard university"" OR ""universidad de harvard"" OR ""johns hopkins university"" OR ""jhu"" OR ""university of toronto"" OR ""université de toronto"" OR ""university of pennsylvania"" Or ""upenn"" OR ""university of california, san francisco"" OR ""ucsf"" OR ""duke university"" OR ""Universidad de Duke"" OR ""university of michigan"" OR ""umich"" OR ""stanford university"" OR ""leland stanford junior university"" OR ""university of melbourne"" OR ""melbourne university"" OR ""university of sydney"" OR ""sydney university"" OR ""university of são paulo"" OR ""universidade de são paulo"") OR author.affiliation.ror_id_lineage:(""03p74gp79"" OR ""0220qvk04"" OR ""013q1eq08"" OR ""0064kty71"" OR ""00a2xv884"" OR ""02v51f717"" OR ""013xs5b60"" OR ""04h9pn542"" OR ""04jztag35"" OR ""011ashp19"" OR ""059gcgy73"" OR ""00p991c53"" OR ""02jx3x895"" OR ""056d84691"" OR ""052gg0110"" OR ""035b05819"" OR ""05f82e368"" OR ""0220mzb33"" OR ""04dkp9463"" OR ""041kmwe10"" OR ""04pp8hn57"" OR ""038t36y30"" OR ""00wjc7c48"" OR ""057w15z03"" OR ""046ak2485"" OR ""013meh722"" OR ""01hcx6992"" OR ""02crff812"" OR ""04mhzgx49"" OR ""03vek6s52"" OR ""00za53h95"" OR ""03dbr7087"" OR ""00b30xv10"" OR ""043mz5j54"" OR ""00py81415"" OR ""00jmfr291"" OR ""00f54p054"" OR ""01ej9dk98"" OR ""0384j8v12"" OR ""036rp1748"")) AND publication_type:""journal article"" AND date_published>=now-10y AND field_of_study: ((""Medicine"" OR ""Internal medicine"" OR ""Pharmacology"") AND (""Virology"" OR ""Virus"" OR ""Microbiology"" OR ""Infectious disease (medical specialty)"" OR ""Viral load"" OR ""Pneumonia"" OR ""Human immunodeficiency virus (HIV)"" OR ""Hepatitis C virus"" OR ""Hepatitis C"" OR ""Immunization"" OR ""Bacteria"" OR ""Tuberculosis"" OR ""Antibiotic resistance"" OR ""Hepatitis B virus""))",AND date_published>=now-10y,"AND field_of_study: ((""Medicine"" OR ""Internal medicine"" OR ""Pharmacology"") AND (""Virology"" OR ""Virus"" OR ""Microbiology"" OR ""Infectious disease (medical specialty)"" OR ""Viral load"" OR ""Pneumonia"" OR ""Human immunodeficiency virus (HIV)"" OR ""Hepatitis C virus"" OR ""Hepatitis C"" OR ""Immunization"" OR ""Bacteria"" OR ""Tuberculosis"" OR ""Antibiotic resistance"" OR ""Hepatitis B virus""))",NA,oa_therapy_area,Uni,Microbiology,2015,3751,1108,839,237,326,71,2581,1170
microbiology (inc infections)  (primary search + microbiology tags) - uni,"(author.affiliation.name:(""university of cape town"" OR ""south african college"" OR ""shanghai jiao tong university"" OR ""shanghai communications university"" OR ""fudan university"" OR ""sun yat-sen university"" OR ""zhejiang university"" OR ""chekiang university"" OR ""peking university"" OR ""imperial university of peking"" OR ""capital medical university"" OR ""cmu"" OR ""seoul national university"" OR ""seoul daehakgyo"" OR ""peking union medical college"" OR ""beijing xiehe hospital"" OR ""sichuan university"" OR ""sìchuān dàxué"" OR ""nanjing medical university"" OR ""national jiangsu medical college"" OR ""huazhong university of science and technology"" OR ""huázhōng kējì dàxué"" OR ""university college london"" OR ""london university"" OR ""karolinska institutet"" OR ""royal caroline institute"" OR ""university of oxford"" OR ""oxford university"" OR ""university of copenhagen"" OR ""universität kopenhagen"" OR ""université de paris"" OR ""university of paris"" OR ""king's college london"" OR ""kcl"" OR ""university of amsterdam"" OR ""universiteit van amsterdam"" OR ""imperial college london"" OR ""coleg imperial llundain"" OR ""utrecht university"" OR ""universiteit utrecht"" OR ""heidelberg university"" OR ""ruprecht-karls-universität heidelberg"" OR ""university of milan"" OR ""université de milan"" OR ""erasmus university rotterdam"" OR ""erasmus universiteit rotterdam"" OR ""freie universität berlin"" OR ""free university of berlin"" OR ""university of cambridge"" OR ""cambridge university"" OR ""humboldt-universität zu berlin"" OR ""humboldt university of berlin"" OR ""university of zurich"" OR ""universität zürich"" OR ""tel aviv university"" OR ""harvard university"" OR ""universidad de harvard"" OR ""johns hopkins university"" OR ""jhu"" OR ""university of toronto"" OR ""université de toronto"" OR ""university of pennsylvania"" Or ""upenn"" OR ""university of california, san francisco"" OR ""ucsf"" OR ""duke university"" OR ""Universidad de Duke"" OR ""university of michigan"" OR ""umich"" OR ""stanford university"" OR ""leland stanford junior university"" OR ""university of melbourne"" OR ""melbourne university"" OR ""university of sydney"" OR ""sydney university"" OR ""university of são paulo"" OR ""universidade de são paulo"") OR author.affiliation.ror_id_lineage:(""03p74gp79"" OR ""0220qvk04"" OR ""013q1eq08"" OR ""0064kty71"" OR ""00a2xv884"" OR ""02v51f717"" OR ""013xs5b60"" OR ""04h9pn542"" OR ""04jztag35"" OR ""011ashp19"" OR ""059gcgy73"" OR ""00p991c53"" OR ""02jx3x895"" OR ""056d84691"" OR ""052gg0110"" OR ""035b05819"" OR ""05f82e368"" OR ""0220mzb33"" OR ""04dkp9463"" OR ""041kmwe10"" OR ""04pp8hn57"" OR ""038t36y30"" OR ""00wjc7c48"" OR ""057w15z03"" OR ""046ak2485"" OR ""013meh722"" OR ""01hcx6992"" OR ""02crff812"" OR ""04mhzgx49"" OR ""03vek6s52"" OR ""00za53h95"" OR ""03dbr7087"" OR ""00b30xv10"" OR ""043mz5j54"" OR ""00py81415"" OR ""00jmfr291"" OR ""00f54p054"" OR ""01ej9dk98"" OR ""0384j8v12"" OR ""036rp1748"")) AND publication_type:""journal article"" AND date_published>=now-10y AND field_of_study: ((""Medicine"" OR ""Internal medicine"" OR ""Pharmacology"") AND (""Virology"" OR ""Virus"" OR ""Microbiology"" OR ""Infectious disease (medical specialty)"" OR ""Viral load"" OR ""Pneumonia"" OR ""Human immunodeficiency virus (HIV)"" OR ""Hepatitis C virus"" OR ""Hepatitis C"" OR ""Immunization"" OR ""Bacteria"" OR ""Tuberculosis"" OR ""Antibiotic resistance"" OR ""Hepatitis B virus""))",AND date_published>=now-10y,"AND field_of_study: ((""Medicine"" OR ""Internal medicine"" OR ""Pharmacology"") AND (""Virology"" OR ""Virus"" OR ""Microbiology"" OR ""Infectious disease (medical specialty)"" OR ""Viral load"" OR ""Pneumonia"" OR ""Human immunodeficiency virus (HIV)"" OR ""Hepatitis C virus"" OR ""Hepatitis C"" OR ""Immunization"" OR ""Bacteria"" OR ""Tuberculosis"" OR ""Antibiotic resistance"" OR ""Hepatitis B virus""))",NA,oa_therapy_area,Uni,Microbiology,2016,3982,1358,913,268,298,34,2871,1111
microbiology (inc infections)  (primary search + microbiology tags) - uni,"(author.affiliation.name:(""university of cape town"" OR ""south african college"" OR ""shanghai jiao tong university"" OR ""shanghai communications university"" OR ""fudan university"" OR ""sun yat-sen university"" OR ""zhejiang university"" OR ""chekiang university"" OR ""peking university"" OR ""imperial university of peking"" OR ""capital medical university"" OR ""cmu"" OR ""seoul national university"" OR ""seoul daehakgyo"" OR ""peking union medical college"" OR ""beijing xiehe hospital"" OR ""sichuan university"" OR ""sìchuān dàxué"" OR ""nanjing medical university"" OR ""national jiangsu medical college"" OR ""huazhong university of science and technology"" OR ""huázhōng kējì dàxué"" OR ""university college london"" OR ""london university"" OR ""karolinska institutet"" OR ""royal caroline institute"" OR ""university of oxford"" OR ""oxford university"" OR ""university of copenhagen"" OR ""universität kopenhagen"" OR ""université de paris"" OR ""university of paris"" OR ""king's college london"" OR ""kcl"" OR ""university of amsterdam"" OR ""universiteit van amsterdam"" OR ""imperial college london"" OR ""coleg imperial llundain"" OR ""utrecht university"" OR ""universiteit utrecht"" OR ""heidelberg university"" OR ""ruprecht-karls-universität heidelberg"" OR ""university of milan"" OR ""université de milan"" OR ""erasmus university rotterdam"" OR ""erasmus universiteit rotterdam"" OR ""freie universität berlin"" OR ""free university of berlin"" OR ""university of cambridge"" OR ""cambridge university"" OR ""humboldt-universität zu berlin"" OR ""humboldt university of berlin"" OR ""university of zurich"" OR ""universität zürich"" OR ""tel aviv university"" OR ""harvard university"" OR ""universidad de harvard"" OR ""johns hopkins university"" OR ""jhu"" OR ""university of toronto"" OR ""université de toronto"" OR ""university of pennsylvania"" Or ""upenn"" OR ""university of california, san francisco"" OR ""ucsf"" OR ""duke university"" OR ""Universidad de Duke"" OR ""university of michigan"" OR ""umich"" OR ""stanford university"" OR ""leland stanford junior university"" OR ""university of melbourne"" OR ""melbourne university"" OR ""university of sydney"" OR ""sydney university"" OR ""university of são paulo"" OR ""universidade de são paulo"") OR author.affiliation.ror_id_lineage:(""03p74gp79"" OR ""0220qvk04"" OR ""013q1eq08"" OR ""0064kty71"" OR ""00a2xv884"" OR ""02v51f717"" OR ""013xs5b60"" OR ""04h9pn542"" OR ""04jztag35"" OR ""011ashp19"" OR ""059gcgy73"" OR ""00p991c53"" OR ""02jx3x895"" OR ""056d84691"" OR ""052gg0110"" OR ""035b05819"" OR ""05f82e368"" OR ""0220mzb33"" OR ""04dkp9463"" OR ""041kmwe10"" OR ""04pp8hn57"" OR ""038t36y30"" OR ""00wjc7c48"" OR ""057w15z03"" OR ""046ak2485"" OR ""013meh722"" OR ""01hcx6992"" OR ""02crff812"" OR ""04mhzgx49"" OR ""03vek6s52"" OR ""00za53h95"" OR ""03dbr7087"" OR ""00b30xv10"" OR ""043mz5j54"" OR ""00py81415"" OR ""00jmfr291"" OR ""00f54p054"" OR ""01ej9dk98"" OR ""0384j8v12"" OR ""036rp1748"")) AND publication_type:""journal article"" AND date_published>=now-10y AND field_of_study: ((""Medicine"" OR ""Internal medicine"" OR ""Pharmacology"") AND (""Virology"" OR ""Virus"" OR ""Microbiology"" OR ""Infectious disease (medical specialty)"" OR ""Viral load"" OR ""Pneumonia"" OR ""Human immunodeficiency virus (HIV)"" OR ""Hepatitis C virus"" OR ""Hepatitis C"" OR ""Immunization"" OR ""Bacteria"" OR ""Tuberculosis"" OR ""Antibiotic resistance"" OR ""Hepatitis B virus""))",AND date_published>=now-10y,"AND field_of_study: ((""Medicine"" OR ""Internal medicine"" OR ""Pharmacology"") AND (""Virology"" OR ""Virus"" OR ""Microbiology"" OR ""Infectious disease (medical specialty)"" OR ""Viral load"" OR ""Pneumonia"" OR ""Human immunodeficiency virus (HIV)"" OR ""Hepatitis C virus"" OR ""Hepatitis C"" OR ""Immunization"" OR ""Bacteria"" OR ""Tuberculosis"" OR ""Antibiotic resistance"" OR ""Hepatitis B virus""))",NA,oa_therapy_area,Uni,Microbiology,2017,4447,1529,1032,338,347,50,3296,1151
microbiology (inc infections)  (primary search + microbiology tags) - uni,"(author.affiliation.name:(""university of cape town"" OR ""south african college"" OR ""shanghai jiao tong university"" OR ""shanghai communications university"" OR ""fudan university"" OR ""sun yat-sen university"" OR ""zhejiang university"" OR ""chekiang university"" OR ""peking university"" OR ""imperial university of peking"" OR ""capital medical university"" OR ""cmu"" OR ""seoul national university"" OR ""seoul daehakgyo"" OR ""peking union medical college"" OR ""beijing xiehe hospital"" OR ""sichuan university"" OR ""sìchuān dàxué"" OR ""nanjing medical university"" OR ""national jiangsu medical college"" OR ""huazhong university of science and technology"" OR ""huázhōng kējì dàxué"" OR ""university college london"" OR ""london university"" OR ""karolinska institutet"" OR ""royal caroline institute"" OR ""university of oxford"" OR ""oxford university"" OR ""university of copenhagen"" OR ""universität kopenhagen"" OR ""université de paris"" OR ""university of paris"" OR ""king's college london"" OR ""kcl"" OR ""university of amsterdam"" OR ""universiteit van amsterdam"" OR ""imperial college london"" OR ""coleg imperial llundain"" OR ""utrecht university"" OR ""universiteit utrecht"" OR ""heidelberg university"" OR ""ruprecht-karls-universität heidelberg"" OR ""university of milan"" OR ""université de milan"" OR ""erasmus university rotterdam"" OR ""erasmus universiteit rotterdam"" OR ""freie universität berlin"" OR ""free university of berlin"" OR ""university of cambridge"" OR ""cambridge university"" OR ""humboldt-universität zu berlin"" OR ""humboldt university of berlin"" OR ""university of zurich"" OR ""universität zürich"" OR ""tel aviv university"" OR ""harvard university"" OR ""universidad de harvard"" OR ""johns hopkins university"" OR ""jhu"" OR ""university of toronto"" OR ""université de toronto"" OR ""university of pennsylvania"" Or ""upenn"" OR ""university of california, san francisco"" OR ""ucsf"" OR ""duke university"" OR ""Universidad de Duke"" OR ""university of michigan"" OR ""umich"" OR ""stanford university"" OR ""leland stanford junior university"" OR ""university of melbourne"" OR ""melbourne university"" OR ""university of sydney"" OR ""sydney university"" OR ""university of são paulo"" OR ""universidade de são paulo"") OR author.affiliation.ror_id_lineage:(""03p74gp79"" OR ""0220qvk04"" OR ""013q1eq08"" OR ""0064kty71"" OR ""00a2xv884"" OR ""02v51f717"" OR ""013xs5b60"" OR ""04h9pn542"" OR ""04jztag35"" OR ""011ashp19"" OR ""059gcgy73"" OR ""00p991c53"" OR ""02jx3x895"" OR ""056d84691"" OR ""052gg0110"" OR ""035b05819"" OR ""05f82e368"" OR ""0220mzb33"" OR ""04dkp9463"" OR ""041kmwe10"" OR ""04pp8hn57"" OR ""038t36y30"" OR ""00wjc7c48"" OR ""057w15z03"" OR ""046ak2485"" OR ""013meh722"" OR ""01hcx6992"" OR ""02crff812"" OR ""04mhzgx49"" OR ""03vek6s52"" OR ""00za53h95"" OR ""03dbr7087"" OR ""00b30xv10"" OR ""043mz5j54"" OR ""00py81415"" OR ""00jmfr291"" OR ""00f54p054"" OR ""01ej9dk98"" OR ""0384j8v12"" OR ""036rp1748"")) AND publication_type:""journal article"" AND date_published>=now-10y AND field_of_study: ((""Medicine"" OR ""Internal medicine"" OR ""Pharmacology"") AND (""Virology"" OR ""Virus"" OR ""Microbiology"" OR ""Infectious disease (medical specialty)"" OR ""Viral load"" OR ""Pneumonia"" OR ""Human immunodeficiency virus (HIV)"" OR ""Hepatitis C virus"" OR ""Hepatitis C"" OR ""Immunization"" OR ""Bacteria"" OR ""Tuberculosis"" OR ""Antibiotic resistance"" OR ""Hepatitis B virus""))",AND date_published>=now-10y,"AND field_of_study: ((""Medicine"" OR ""Internal medicine"" OR ""Pharmacology"") AND (""Virology"" OR ""Virus"" OR ""Microbiology"" OR ""Infectious disease (medical specialty)"" OR ""Viral load"" OR ""Pneumonia"" OR ""Human immunodeficiency virus (HIV)"" OR ""Hepatitis C virus"" OR ""Hepatitis C"" OR ""Immunization"" OR ""Bacteria"" OR ""Tuberculosis"" OR ""Antibiotic resistance"" OR ""Hepatitis B virus""))",NA,oa_therapy_area,Uni,Microbiology,2018,4473,1563,1083,328,315,52,3341,1132
microbiology (inc infections)  (primary search + microbiology tags) - uni,"(author.affiliation.name:(""university of cape town"" OR ""south african college"" OR ""shanghai jiao tong university"" OR ""shanghai communications university"" OR ""fudan university"" OR ""sun yat-sen university"" OR ""zhejiang university"" OR ""chekiang university"" OR ""peking university"" OR ""imperial university of peking"" OR ""capital medical university"" OR ""cmu"" OR ""seoul national university"" OR ""seoul daehakgyo"" OR ""peking union medical college"" OR ""beijing xiehe hospital"" OR ""sichuan university"" OR ""sìchuān dàxué"" OR ""nanjing medical university"" OR ""national jiangsu medical college"" OR ""huazhong university of science and technology"" OR ""huázhōng kējì dàxué"" OR ""university college london"" OR ""london university"" OR ""karolinska institutet"" OR ""royal caroline institute"" OR ""university of oxford"" OR ""oxford university"" OR ""university of copenhagen"" OR ""universität kopenhagen"" OR ""université de paris"" OR ""university of paris"" OR ""king's college london"" OR ""kcl"" OR ""university of amsterdam"" OR ""universiteit van amsterdam"" OR ""imperial college london"" OR ""coleg imperial llundain"" OR ""utrecht university"" OR ""universiteit utrecht"" OR ""heidelberg university"" OR ""ruprecht-karls-universität heidelberg"" OR ""university of milan"" OR ""université de milan"" OR ""erasmus university rotterdam"" OR ""erasmus universiteit rotterdam"" OR ""freie universität berlin"" OR ""free university of berlin"" OR ""university of cambridge"" OR ""cambridge university"" OR ""humboldt-universität zu berlin"" OR ""humboldt university of berlin"" OR ""university of zurich"" OR ""universität zürich"" OR ""tel aviv university"" OR ""harvard university"" OR ""universidad de harvard"" OR ""johns hopkins university"" OR ""jhu"" OR ""university of toronto"" OR ""université de toronto"" OR ""university of pennsylvania"" Or ""upenn"" OR ""university of california, san francisco"" OR ""ucsf"" OR ""duke university"" OR ""Universidad de Duke"" OR ""university of michigan"" OR ""umich"" OR ""stanford university"" OR ""leland stanford junior university"" OR ""university of melbourne"" OR ""melbourne university"" OR ""university of sydney"" OR ""sydney university"" OR ""university of são paulo"" OR ""universidade de são paulo"") OR author.affiliation.ror_id_lineage:(""03p74gp79"" OR ""0220qvk04"" OR ""013q1eq08"" OR ""0064kty71"" OR ""00a2xv884"" OR ""02v51f717"" OR ""013xs5b60"" OR ""04h9pn542"" OR ""04jztag35"" OR ""011ashp19"" OR ""059gcgy73"" OR ""00p991c53"" OR ""02jx3x895"" OR ""056d84691"" OR ""052gg0110"" OR ""035b05819"" OR ""05f82e368"" OR ""0220mzb33"" OR ""04dkp9463"" OR ""041kmwe10"" OR ""04pp8hn57"" OR ""038t36y30"" OR ""00wjc7c48"" OR ""057w15z03"" OR ""046ak2485"" OR ""013meh722"" OR ""01hcx6992"" OR ""02crff812"" OR ""04mhzgx49"" OR ""03vek6s52"" OR ""00za53h95"" OR ""03dbr7087"" OR ""00b30xv10"" OR ""043mz5j54"" OR ""00py81415"" OR ""00jmfr291"" OR ""00f54p054"" OR ""01ej9dk98"" OR ""0384j8v12"" OR ""036rp1748"")) AND publication_type:""journal article"" AND date_published>=now-10y AND field_of_study: ((""Medicine"" OR ""Internal medicine"" OR ""Pharmacology"") AND (""Virology"" OR ""Virus"" OR ""Microbiology"" OR ""Infectious disease (medical specialty)"" OR ""Viral load"" OR ""Pneumonia"" OR ""Human immunodeficiency virus (HIV)"" OR ""Hepatitis C virus"" OR ""Hepatitis C"" OR ""Immunization"" OR ""Bacteria"" OR ""Tuberculosis"" OR ""Antibiotic resistance"" OR ""Hepatitis B virus""))",AND date_published>=now-10y,"AND field_of_study: ((""Medicine"" OR ""Internal medicine"" OR ""Pharmacology"") AND (""Virology"" OR ""Virus"" OR ""Microbiology"" OR ""Infectious disease (medical specialty)"" OR ""Viral load"" OR ""Pneumonia"" OR ""Human immunodeficiency virus (HIV)"" OR ""Hepatitis C virus"" OR ""Hepatitis C"" OR ""Immunization"" OR ""Bacteria"" OR ""Tuberculosis"" OR ""Antibiotic resistance"" OR ""Hepatitis B virus""))",NA,oa_therapy_area,Uni,Microbiology,2019,4968,1901,1047,440,294,46,3728,1240
microbiology (inc infections)  (primary search + microbiology tags) - uni,"(author.affiliation.name:(""university of cape town"" OR ""south african college"" OR ""shanghai jiao tong university"" OR ""shanghai communications university"" OR ""fudan university"" OR ""sun yat-sen university"" OR ""zhejiang university"" OR ""chekiang university"" OR ""peking university"" OR ""imperial university of peking"" OR ""capital medical university"" OR ""cmu"" OR ""seoul national university"" OR ""seoul daehakgyo"" OR ""peking union medical college"" OR ""beijing xiehe hospital"" OR ""sichuan university"" OR ""sìchuān dàxué"" OR ""nanjing medical university"" OR ""national jiangsu medical college"" OR ""huazhong university of science and technology"" OR ""huázhōng kējì dàxué"" OR ""university college london"" OR ""london university"" OR ""karolinska institutet"" OR ""royal caroline institute"" OR ""university of oxford"" OR ""oxford university"" OR ""university of copenhagen"" OR ""universität kopenhagen"" OR ""université de paris"" OR ""university of paris"" OR ""king's college london"" OR ""kcl"" OR ""university of amsterdam"" OR ""universiteit van amsterdam"" OR ""imperial college london"" OR ""coleg imperial llundain"" OR ""utrecht university"" OR ""universiteit utrecht"" OR ""heidelberg university"" OR ""ruprecht-karls-universität heidelberg"" OR ""university of milan"" OR ""université de milan"" OR ""erasmus university rotterdam"" OR ""erasmus universiteit rotterdam"" OR ""freie universität berlin"" OR ""free university of berlin"" OR ""university of cambridge"" OR ""cambridge university"" OR ""humboldt-universität zu berlin"" OR ""humboldt university of berlin"" OR ""university of zurich"" OR ""universität zürich"" OR ""tel aviv university"" OR ""harvard university"" OR ""universidad de harvard"" OR ""johns hopkins university"" OR ""jhu"" OR ""university of toronto"" OR ""université de toronto"" OR ""university of pennsylvania"" Or ""upenn"" OR ""university of california, san francisco"" OR ""ucsf"" OR ""duke university"" OR ""Universidad de Duke"" OR ""university of michigan"" OR ""umich"" OR ""stanford university"" OR ""leland stanford junior university"" OR ""university of melbourne"" OR ""melbourne university"" OR ""university of sydney"" OR ""sydney university"" OR ""university of são paulo"" OR ""universidade de são paulo"") OR author.affiliation.ror_id_lineage:(""03p74gp79"" OR ""0220qvk04"" OR ""013q1eq08"" OR ""0064kty71"" OR ""00a2xv884"" OR ""02v51f717"" OR ""013xs5b60"" OR ""04h9pn542"" OR ""04jztag35"" OR ""011ashp19"" OR ""059gcgy73"" OR ""00p991c53"" OR ""02jx3x895"" OR ""056d84691"" OR ""052gg0110"" OR ""035b05819"" OR ""05f82e368"" OR ""0220mzb33"" OR ""04dkp9463"" OR ""041kmwe10"" OR ""04pp8hn57"" OR ""038t36y30"" OR ""00wjc7c48"" OR ""057w15z03"" OR ""046ak2485"" OR ""013meh722"" OR ""01hcx6992"" OR ""02crff812"" OR ""04mhzgx49"" OR ""03vek6s52"" OR ""00za53h95"" OR ""03dbr7087"" OR ""00b30xv10"" OR ""043mz5j54"" OR ""00py81415"" OR ""00jmfr291"" OR ""00f54p054"" OR ""01ej9dk98"" OR ""0384j8v12"" OR ""036rp1748"")) AND publication_type:""journal article"" AND date_published>=now-10y AND field_of_study: ((""Medicine"" OR ""Internal medicine"" OR ""Pharmacology"") AND (""Virology"" OR ""Virus"" OR ""Microbiology"" OR ""Infectious disease (medical specialty)"" OR ""Viral load"" OR ""Pneumonia"" OR ""Human immunodeficiency virus (HIV)"" OR ""Hepatitis C virus"" OR ""Hepatitis C"" OR ""Immunization"" OR ""Bacteria"" OR ""Tuberculosis"" OR ""Antibiotic resistance"" OR ""Hepatitis B virus""))",AND date_published>=now-10y,"AND field_of_study: ((""Medicine"" OR ""Internal medicine"" OR ""Pharmacology"") AND (""Virology"" OR ""Virus"" OR ""Microbiology"" OR ""Infectious disease (medical specialty)"" OR ""Viral load"" OR ""Pneumonia"" OR ""Human immunodeficiency virus (HIV)"" OR ""Hepatitis C virus"" OR ""Hepatitis C"" OR ""Immunization"" OR ""Bacteria"" OR ""Tuberculosis"" OR ""Antibiotic resistance"" OR ""Hepatitis B virus""))",NA,oa_therapy_area,Uni,Microbiology,2020,9256,3090,2966,840,603,150,7649,1607
microbiology (inc infections)  (primary search + microbiology tags) - uni,"(author.affiliation.name:(""university of cape town"" OR ""south african college"" OR ""shanghai jiao tong university"" OR ""shanghai communications university"" OR ""fudan university"" OR ""sun yat-sen university"" OR ""zhejiang university"" OR ""chekiang university"" OR ""peking university"" OR ""imperial university of peking"" OR ""capital medical university"" OR ""cmu"" OR ""seoul national university"" OR ""seoul daehakgyo"" OR ""peking union medical college"" OR ""beijing xiehe hospital"" OR ""sichuan university"" OR ""sìchuān dàxué"" OR ""nanjing medical university"" OR ""national jiangsu medical college"" OR ""huazhong university of science and technology"" OR ""huázhōng kējì dàxué"" OR ""university college london"" OR ""london university"" OR ""karolinska institutet"" OR ""royal caroline institute"" OR ""university of oxford"" OR ""oxford university"" OR ""university of copenhagen"" OR ""universität kopenhagen"" OR ""université de paris"" OR ""university of paris"" OR ""king's college london"" OR ""kcl"" OR ""university of amsterdam"" OR ""universiteit van amsterdam"" OR ""imperial college london"" OR ""coleg imperial llundain"" OR ""utrecht university"" OR ""universiteit utrecht"" OR ""heidelberg university"" OR ""ruprecht-karls-universität heidelberg"" OR ""university of milan"" OR ""université de milan"" OR ""erasmus university rotterdam"" OR ""erasmus universiteit rotterdam"" OR ""freie universität berlin"" OR ""free university of berlin"" OR ""university of cambridge"" OR ""cambridge university"" OR ""humboldt-universität zu berlin"" OR ""humboldt university of berlin"" OR ""university of zurich"" OR ""universität zürich"" OR ""tel aviv university"" OR ""harvard university"" OR ""universidad de harvard"" OR ""johns hopkins university"" OR ""jhu"" OR ""university of toronto"" OR ""université de toronto"" OR ""university of pennsylvania"" Or ""upenn"" OR ""university of california, san francisco"" OR ""ucsf"" OR ""duke university"" OR ""Universidad de Duke"" OR ""university of michigan"" OR ""umich"" OR ""stanford university"" OR ""leland stanford junior university"" OR ""university of melbourne"" OR ""melbourne university"" OR ""university of sydney"" OR ""sydney university"" OR ""university of são paulo"" OR ""universidade de são paulo"") OR author.affiliation.ror_id_lineage:(""03p74gp79"" OR ""0220qvk04"" OR ""013q1eq08"" OR ""0064kty71"" OR ""00a2xv884"" OR ""02v51f717"" OR ""013xs5b60"" OR ""04h9pn542"" OR ""04jztag35"" OR ""011ashp19"" OR ""059gcgy73"" OR ""00p991c53"" OR ""02jx3x895"" OR ""056d84691"" OR ""052gg0110"" OR ""035b05819"" OR ""05f82e368"" OR ""0220mzb33"" OR ""04dkp9463"" OR ""041kmwe10"" OR ""04pp8hn57"" OR ""038t36y30"" OR ""00wjc7c48"" OR ""057w15z03"" OR ""046ak2485"" OR ""013meh722"" OR ""01hcx6992"" OR ""02crff812"" OR ""04mhzgx49"" OR ""03vek6s52"" OR ""00za53h95"" OR ""03dbr7087"" OR ""00b30xv10"" OR ""043mz5j54"" OR ""00py81415"" OR ""00jmfr291"" OR ""00f54p054"" OR ""01ej9dk98"" OR ""0384j8v12"" OR ""036rp1748"")) AND publication_type:""journal article"" AND date_published>=now-10y AND field_of_study: ((""Medicine"" OR ""Internal medicine"" OR ""Pharmacology"") AND (""Virology"" OR ""Virus"" OR ""Microbiology"" OR ""Infectious disease (medical specialty)"" OR ""Viral load"" OR ""Pneumonia"" OR ""Human immunodeficiency virus (HIV)"" OR ""Hepatitis C virus"" OR ""Hepatitis C"" OR ""Immunization"" OR ""Bacteria"" OR ""Tuberculosis"" OR ""Antibiotic resistance"" OR ""Hepatitis B virus""))",AND date_published>=now-10y,"AND field_of_study: ((""Medicine"" OR ""Internal medicine"" OR ""Pharmacology"") AND (""Virology"" OR ""Virus"" OR ""Microbiology"" OR ""Infectious disease (medical specialty)"" OR ""Viral load"" OR ""Pneumonia"" OR ""Human immunodeficiency virus (HIV)"" OR ""Hepatitis C virus"" OR ""Hepatitis C"" OR ""Immunization"" OR ""Bacteria"" OR ""Tuberculosis"" OR ""Antibiotic resistance"" OR ""Hepatitis B virus""))",NA,oa_therapy_area,Uni,Microbiology,2021,9602,4245,1779,883,559,410,7876,1726
microbiology (inc infections)  (primary search + microbiology tags) - uni,"(author.affiliation.name:(""university of cape town"" OR ""south african college"" OR ""shanghai jiao tong university"" OR ""shanghai communications university"" OR ""fudan university"" OR ""sun yat-sen university"" OR ""zhejiang university"" OR ""chekiang university"" OR ""peking university"" OR ""imperial university of peking"" OR ""capital medical university"" OR ""cmu"" OR ""seoul national university"" OR ""seoul daehakgyo"" OR ""peking union medical college"" OR ""beijing xiehe hospital"" OR ""sichuan university"" OR ""sìchuān dàxué"" OR ""nanjing medical university"" OR ""national jiangsu medical college"" OR ""huazhong university of science and technology"" OR ""huázhōng kējì dàxué"" OR ""university college london"" OR ""london university"" OR ""karolinska institutet"" OR ""royal caroline institute"" OR ""university of oxford"" OR ""oxford university"" OR ""university of copenhagen"" OR ""universität kopenhagen"" OR ""université de paris"" OR ""university of paris"" OR ""king's college london"" OR ""kcl"" OR ""university of amsterdam"" OR ""universiteit van amsterdam"" OR ""imperial college london"" OR ""coleg imperial llundain"" OR ""utrecht university"" OR ""universiteit utrecht"" OR ""heidelberg university"" OR ""ruprecht-karls-universität heidelberg"" OR ""university of milan"" OR ""université de milan"" OR ""erasmus university rotterdam"" OR ""erasmus universiteit rotterdam"" OR ""freie universität berlin"" OR ""free university of berlin"" OR ""university of cambridge"" OR ""cambridge university"" OR ""humboldt-universität zu berlin"" OR ""humboldt university of berlin"" OR ""university of zurich"" OR ""universität zürich"" OR ""tel aviv university"" OR ""harvard university"" OR ""universidad de harvard"" OR ""johns hopkins university"" OR ""jhu"" OR ""university of toronto"" OR ""université de toronto"" OR ""university of pennsylvania"" Or ""upenn"" OR ""university of california, san francisco"" OR ""ucsf"" OR ""duke university"" OR ""Universidad de Duke"" OR ""university of michigan"" OR ""umich"" OR ""stanford university"" OR ""leland stanford junior university"" OR ""university of melbourne"" OR ""melbourne university"" OR ""university of sydney"" OR ""sydney university"" OR ""university of são paulo"" OR ""universidade de são paulo"") OR author.affiliation.ror_id_lineage:(""03p74gp79"" OR ""0220qvk04"" OR ""013q1eq08"" OR ""0064kty71"" OR ""00a2xv884"" OR ""02v51f717"" OR ""013xs5b60"" OR ""04h9pn542"" OR ""04jztag35"" OR ""011ashp19"" OR ""059gcgy73"" OR ""00p991c53"" OR ""02jx3x895"" OR ""056d84691"" OR ""052gg0110"" OR ""035b05819"" OR ""05f82e368"" OR ""0220mzb33"" OR ""04dkp9463"" OR ""041kmwe10"" OR ""04pp8hn57"" OR ""038t36y30"" OR ""00wjc7c48"" OR ""057w15z03"" OR ""046ak2485"" OR ""013meh722"" OR ""01hcx6992"" OR ""02crff812"" OR ""04mhzgx49"" OR ""03vek6s52"" OR ""00za53h95"" OR ""03dbr7087"" OR ""00b30xv10"" OR ""043mz5j54"" OR ""00py81415"" OR ""00jmfr291"" OR ""00f54p054"" OR ""01ej9dk98"" OR ""0384j8v12"" OR ""036rp1748"")) AND publication_type:""journal article"" AND date_published>=now-10y AND field_of_study: ((""Medicine"" OR ""Internal medicine"" OR ""Pharmacology"") AND (""Virology"" OR ""Virus"" OR ""Microbiology"" OR ""Infectious disease (medical specialty)"" OR ""Viral load"" OR ""Pneumonia"" OR ""Human immunodeficiency virus (HIV)"" OR ""Hepatitis C virus"" OR ""Hepatitis C"" OR ""Immunization"" OR ""Bacteria"" OR ""Tuberculosis"" OR ""Antibiotic resistance"" OR ""Hepatitis B virus""))",AND date_published>=now-10y,"AND field_of_study: ((""Medicine"" OR ""Internal medicine"" OR ""Pharmacology"") AND (""Virology"" OR ""Virus"" OR ""Microbiology"" OR ""Infectious disease (medical specialty)"" OR ""Viral load"" OR ""Pneumonia"" OR ""Human immunodeficiency virus (HIV)"" OR ""Hepatitis C virus"" OR ""Hepatitis C"" OR ""Immunization"" OR ""Bacteria"" OR ""Tuberculosis"" OR ""Antibiotic resistance"" OR ""Hepatitis B virus""))",NA,oa_therapy_area,Uni,Microbiology,2022,24631,12552,2653,2605,2042,497,20349,4282
microbiology (inc infections)  (primary search + microbiology tags) - uni,"(author.affiliation.name:(""university of cape town"" OR ""south african college"" OR ""shanghai jiao tong university"" OR ""shanghai communications university"" OR ""fudan university"" OR ""sun yat-sen university"" OR ""zhejiang university"" OR ""chekiang university"" OR ""peking university"" OR ""imperial university of peking"" OR ""capital medical university"" OR ""cmu"" OR ""seoul national university"" OR ""seoul daehakgyo"" OR ""peking union medical college"" OR ""beijing xiehe hospital"" OR ""sichuan university"" OR ""sìchuān dàxué"" OR ""nanjing medical university"" OR ""national jiangsu medical college"" OR ""huazhong university of science and technology"" OR ""huázhōng kējì dàxué"" OR ""university college london"" OR ""london university"" OR ""karolinska institutet"" OR ""royal caroline institute"" OR ""university of oxford"" OR ""oxford university"" OR ""university of copenhagen"" OR ""universität kopenhagen"" OR ""université de paris"" OR ""university of paris"" OR ""king's college london"" OR ""kcl"" OR ""university of amsterdam"" OR ""universiteit van amsterdam"" OR ""imperial college london"" OR ""coleg imperial llundain"" OR ""utrecht university"" OR ""universiteit utrecht"" OR ""heidelberg university"" OR ""ruprecht-karls-universität heidelberg"" OR ""university of milan"" OR ""université de milan"" OR ""erasmus university rotterdam"" OR ""erasmus universiteit rotterdam"" OR ""freie universität berlin"" OR ""free university of berlin"" OR ""university of cambridge"" OR ""cambridge university"" OR ""humboldt-universität zu berlin"" OR ""humboldt university of berlin"" OR ""university of zurich"" OR ""universität zürich"" OR ""tel aviv university"" OR ""harvard university"" OR ""universidad de harvard"" OR ""johns hopkins university"" OR ""jhu"" OR ""university of toronto"" OR ""université de toronto"" OR ""university of pennsylvania"" Or ""upenn"" OR ""university of california, san francisco"" OR ""ucsf"" OR ""duke university"" OR ""Universidad de Duke"" OR ""university of michigan"" OR ""umich"" OR ""stanford university"" OR ""leland stanford junior university"" OR ""university of melbourne"" OR ""melbourne university"" OR ""university of sydney"" OR ""sydney university"" OR ""university of são paulo"" OR ""universidade de são paulo"") OR author.affiliation.ror_id_lineage:(""03p74gp79"" OR ""0220qvk04"" OR ""013q1eq08"" OR ""0064kty71"" OR ""00a2xv884"" OR ""02v51f717"" OR ""013xs5b60"" OR ""04h9pn542"" OR ""04jztag35"" OR ""011ashp19"" OR ""059gcgy73"" OR ""00p991c53"" OR ""02jx3x895"" OR ""056d84691"" OR ""052gg0110"" OR ""035b05819"" OR ""05f82e368"" OR ""0220mzb33"" OR ""04dkp9463"" OR ""041kmwe10"" OR ""04pp8hn57"" OR ""038t36y30"" OR ""00wjc7c48"" OR ""057w15z03"" OR ""046ak2485"" OR ""013meh722"" OR ""01hcx6992"" OR ""02crff812"" OR ""04mhzgx49"" OR ""03vek6s52"" OR ""00za53h95"" OR ""03dbr7087"" OR ""00b30xv10"" OR ""043mz5j54"" OR ""00py81415"" OR ""00jmfr291"" OR ""00f54p054"" OR ""01ej9dk98"" OR ""0384j8v12"" OR ""036rp1748"")) AND publication_type:""journal article"" AND date_published>=now-10y AND field_of_study: ((""Medicine"" OR ""Internal medicine"" OR ""Pharmacology"") AND (""Virology"" OR ""Virus"" OR ""Microbiology"" OR ""Infectious disease (medical specialty)"" OR ""Viral load"" OR ""Pneumonia"" OR ""Human immunodeficiency virus (HIV)"" OR ""Hepatitis C virus"" OR ""Hepatitis C"" OR ""Immunization"" OR ""Bacteria"" OR ""Tuberculosis"" OR ""Antibiotic resistance"" OR ""Hepatitis B virus""))",AND date_published>=now-10y,"AND field_of_study: ((""Medicine"" OR ""Internal medicine"" OR ""Pharmacology"") AND (""Virology"" OR ""Virus"" OR ""Microbiology"" OR ""Infectious disease (medical specialty)"" OR ""Viral load"" OR ""Pneumonia"" OR ""Human immunodeficiency virus (HIV)"" OR ""Hepatitis C virus"" OR ""Hepatitis C"" OR ""Immunization"" OR ""Bacteria"" OR ""Tuberculosis"" OR ""Antibiotic resistance"" OR ""Hepatitis B virus""))",NA,oa_therapy_area,Uni,Microbiology,2023,8548,4321,359,874,437,680,6671,1877
psychiatry (primary search + psychiatry tags) - uni,"(author.affiliation.name:(""university of cape town"" OR ""south african college"" OR ""shanghai jiao tong university"" OR ""shanghai communications university"" OR ""fudan university"" OR ""sun yat-sen university"" OR ""zhejiang university"" OR ""chekiang university"" OR ""peking university"" OR ""imperial university of peking"" OR ""capital medical university"" OR ""cmu"" OR ""seoul national university"" OR ""seoul daehakgyo"" OR ""peking union medical college"" OR ""beijing xiehe hospital"" OR ""sichuan university"" OR ""sìchuān dàxué"" OR ""nanjing medical university"" OR ""national jiangsu medical college"" OR ""huazhong university of science and technology"" OR ""huázhōng kējì dàxué"" OR ""university college london"" OR ""london university"" OR ""karolinska institutet"" OR ""royal caroline institute"" OR ""university of oxford"" OR ""oxford university"" OR ""university of copenhagen"" OR ""universität kopenhagen"" OR ""université de paris"" OR ""university of paris"" OR ""king's college london"" OR ""kcl"" OR ""university of amsterdam"" OR ""universiteit van amsterdam"" OR ""imperial college london"" OR ""coleg imperial llundain"" OR ""utrecht university"" OR ""universiteit utrecht"" OR ""heidelberg university"" OR ""ruprecht-karls-universität heidelberg"" OR ""university of milan"" OR ""université de milan"" OR ""erasmus university rotterdam"" OR ""erasmus universiteit rotterdam"" OR ""freie universität berlin"" OR ""free university of berlin"" OR ""university of cambridge"" OR ""cambridge university"" OR ""humboldt-universität zu berlin"" OR ""humboldt university of berlin"" OR ""university of zurich"" OR ""universität zürich"" OR ""tel aviv university"" OR ""harvard university"" OR ""universidad de harvard"" OR ""johns hopkins university"" OR ""jhu"" OR ""university of toronto"" OR ""université de toronto"" OR ""university of pennsylvania"" Or ""upenn"" OR ""university of california, san francisco"" OR ""ucsf"" OR ""duke university"" OR ""Universidad de Duke"" OR ""university of michigan"" OR ""umich"" OR ""stanford university"" OR ""leland stanford junior university"" OR ""university of melbourne"" OR ""melbourne university"" OR ""university of sydney"" OR ""sydney university"" OR ""university of são paulo"" OR ""universidade de são paulo"") OR author.affiliation.ror_id_lineage:(""03p74gp79"" OR ""0220qvk04"" OR ""013q1eq08"" OR ""0064kty71"" OR ""00a2xv884"" OR ""02v51f717"" OR ""013xs5b60"" OR ""04h9pn542"" OR ""04jztag35"" OR ""011ashp19"" OR ""059gcgy73"" OR ""00p991c53"" OR ""02jx3x895"" OR ""056d84691"" OR ""052gg0110"" OR ""035b05819"" OR ""05f82e368"" OR ""0220mzb33"" OR ""04dkp9463"" OR ""041kmwe10"" OR ""04pp8hn57"" OR ""038t36y30"" OR ""00wjc7c48"" OR ""057w15z03"" OR ""046ak2485"" OR ""013meh722"" OR ""01hcx6992"" OR ""02crff812"" OR ""04mhzgx49"" OR ""03vek6s52"" OR ""00za53h95"" OR ""03dbr7087"" OR ""00b30xv10"" OR ""043mz5j54"" OR ""00py81415"" OR ""00jmfr291"" OR ""00f54p054"" OR ""01ej9dk98"" OR ""0384j8v12"" OR ""036rp1748"")) AND publication_type:""journal article"" AND date_published>=now-10y AND field_of_study: ((""Medicine"" OR ""Internal medicine"" OR ""Pharmacology"") AND (""Psychiatry"" OR ""Psychology"" OR ""Psychological intervention"" OR ""Dementia"" OR ""Clinical psychology"" OR ""Anxiety"" OR ""Major depressive disorder"" OR ""Schizophrenia"" OR ""Alzheimer's disease""))",AND date_published>=now-10y,"AND field_of_study: ((""Medicine"" OR ""Internal medicine"" OR ""Pharmacology"") AND (""Psychiatry"" OR ""Psychology"" OR ""Psychological intervention"" OR ""Dementia"" OR ""Clinical psychology"" OR ""Anxiety"" OR ""Major depressive disorder"" OR ""Schizophrenia"" OR ""Alzheimer's disease""))",NA,oa_therapy_area,Uni,Psychiatry,2013,2812,699,718,120,157,36,1730,1082
psychiatry (primary search + psychiatry tags) - uni,"(author.affiliation.name:(""university of cape town"" OR ""south african college"" OR ""shanghai jiao tong university"" OR ""shanghai communications university"" OR ""fudan university"" OR ""sun yat-sen university"" OR ""zhejiang university"" OR ""chekiang university"" OR ""peking university"" OR ""imperial university of peking"" OR ""capital medical university"" OR ""cmu"" OR ""seoul national university"" OR ""seoul daehakgyo"" OR ""peking union medical college"" OR ""beijing xiehe hospital"" OR ""sichuan university"" OR ""sìchuān dàxué"" OR ""nanjing medical university"" OR ""national jiangsu medical college"" OR ""huazhong university of science and technology"" OR ""huázhōng kējì dàxué"" OR ""university college london"" OR ""london university"" OR ""karolinska institutet"" OR ""royal caroline institute"" OR ""university of oxford"" OR ""oxford university"" OR ""university of copenhagen"" OR ""universität kopenhagen"" OR ""université de paris"" OR ""university of paris"" OR ""king's college london"" OR ""kcl"" OR ""university of amsterdam"" OR ""universiteit van amsterdam"" OR ""imperial college london"" OR ""coleg imperial llundain"" OR ""utrecht university"" OR ""universiteit utrecht"" OR ""heidelberg university"" OR ""ruprecht-karls-universität heidelberg"" OR ""university of milan"" OR ""université de milan"" OR ""erasmus university rotterdam"" OR ""erasmus universiteit rotterdam"" OR ""freie universität berlin"" OR ""free university of berlin"" OR ""university of cambridge"" OR ""cambridge university"" OR ""humboldt-universität zu berlin"" OR ""humboldt university of berlin"" OR ""university of zurich"" OR ""universität zürich"" OR ""tel aviv university"" OR ""harvard university"" OR ""universidad de harvard"" OR ""johns hopkins university"" OR ""jhu"" OR ""university of toronto"" OR ""université de toronto"" OR ""university of pennsylvania"" Or ""upenn"" OR ""university of california, san francisco"" OR ""ucsf"" OR ""duke university"" OR ""Universidad de Duke"" OR ""university of michigan"" OR ""umich"" OR ""stanford university"" OR ""leland stanford junior university"" OR ""university of melbourne"" OR ""melbourne university"" OR ""university of sydney"" OR ""sydney university"" OR ""university of são paulo"" OR ""universidade de são paulo"") OR author.affiliation.ror_id_lineage:(""03p74gp79"" OR ""0220qvk04"" OR ""013q1eq08"" OR ""0064kty71"" OR ""00a2xv884"" OR ""02v51f717"" OR ""013xs5b60"" OR ""04h9pn542"" OR ""04jztag35"" OR ""011ashp19"" OR ""059gcgy73"" OR ""00p991c53"" OR ""02jx3x895"" OR ""056d84691"" OR ""052gg0110"" OR ""035b05819"" OR ""05f82e368"" OR ""0220mzb33"" OR ""04dkp9463"" OR ""041kmwe10"" OR ""04pp8hn57"" OR ""038t36y30"" OR ""00wjc7c48"" OR ""057w15z03"" OR ""046ak2485"" OR ""013meh722"" OR ""01hcx6992"" OR ""02crff812"" OR ""04mhzgx49"" OR ""03vek6s52"" OR ""00za53h95"" OR ""03dbr7087"" OR ""00b30xv10"" OR ""043mz5j54"" OR ""00py81415"" OR ""00jmfr291"" OR ""00f54p054"" OR ""01ej9dk98"" OR ""0384j8v12"" OR ""036rp1748"")) AND publication_type:""journal article"" AND date_published>=now-10y AND field_of_study: ((""Medicine"" OR ""Internal medicine"" OR ""Pharmacology"") AND (""Psychiatry"" OR ""Psychology"" OR ""Psychological intervention"" OR ""Dementia"" OR ""Clinical psychology"" OR ""Anxiety"" OR ""Major depressive disorder"" OR ""Schizophrenia"" OR ""Alzheimer's disease""))",AND date_published>=now-10y,"AND field_of_study: ((""Medicine"" OR ""Internal medicine"" OR ""Pharmacology"") AND (""Psychiatry"" OR ""Psychology"" OR ""Psychological intervention"" OR ""Dementia"" OR ""Clinical psychology"" OR ""Anxiety"" OR ""Major depressive disorder"" OR ""Schizophrenia"" OR ""Alzheimer's disease""))",NA,oa_therapy_area,Uni,Psychiatry,2014,7602,1858,1941,346,403,85,4633,2969
psychiatry (primary search + psychiatry tags) - uni,"(author.affiliation.name:(""university of cape town"" OR ""south african college"" OR ""shanghai jiao tong university"" OR ""shanghai communications university"" OR ""fudan university"" OR ""sun yat-sen university"" OR ""zhejiang university"" OR ""chekiang university"" OR ""peking university"" OR ""imperial university of peking"" OR ""capital medical university"" OR ""cmu"" OR ""seoul national university"" OR ""seoul daehakgyo"" OR ""peking union medical college"" OR ""beijing xiehe hospital"" OR ""sichuan university"" OR ""sìchuān dàxué"" OR ""nanjing medical university"" OR ""national jiangsu medical college"" OR ""huazhong university of science and technology"" OR ""huázhōng kējì dàxué"" OR ""university college london"" OR ""london university"" OR ""karolinska institutet"" OR ""royal caroline institute"" OR ""university of oxford"" OR ""oxford university"" OR ""university of copenhagen"" OR ""universität kopenhagen"" OR ""université de paris"" OR ""university of paris"" OR ""king's college london"" OR ""kcl"" OR ""university of amsterdam"" OR ""universiteit van amsterdam"" OR ""imperial college london"" OR ""coleg imperial llundain"" OR ""utrecht university"" OR ""universiteit utrecht"" OR ""heidelberg university"" OR ""ruprecht-karls-universität heidelberg"" OR ""university of milan"" OR ""université de milan"" OR ""erasmus university rotterdam"" OR ""erasmus universiteit rotterdam"" OR ""freie universität berlin"" OR ""free university of berlin"" OR ""university of cambridge"" OR ""cambridge university"" OR ""humboldt-universität zu berlin"" OR ""humboldt university of berlin"" OR ""university of zurich"" OR ""universität zürich"" OR ""tel aviv university"" OR ""harvard university"" OR ""universidad de harvard"" OR ""johns hopkins university"" OR ""jhu"" OR ""university of toronto"" OR ""université de toronto"" OR ""university of pennsylvania"" Or ""upenn"" OR ""university of california, san francisco"" OR ""ucsf"" OR ""duke university"" OR ""Universidad de Duke"" OR ""university of michigan"" OR ""umich"" OR ""stanford university"" OR ""leland stanford junior university"" OR ""university of melbourne"" OR ""melbourne university"" OR ""university of sydney"" OR ""sydney university"" OR ""university of são paulo"" OR ""universidade de são paulo"") OR author.affiliation.ror_id_lineage:(""03p74gp79"" OR ""0220qvk04"" OR ""013q1eq08"" OR ""0064kty71"" OR ""00a2xv884"" OR ""02v51f717"" OR ""013xs5b60"" OR ""04h9pn542"" OR ""04jztag35"" OR ""011ashp19"" OR ""059gcgy73"" OR ""00p991c53"" OR ""02jx3x895"" OR ""056d84691"" OR ""052gg0110"" OR ""035b05819"" OR ""05f82e368"" OR ""0220mzb33"" OR ""04dkp9463"" OR ""041kmwe10"" OR ""04pp8hn57"" OR ""038t36y30"" OR ""00wjc7c48"" OR ""057w15z03"" OR ""046ak2485"" OR ""013meh722"" OR ""01hcx6992"" OR ""02crff812"" OR ""04mhzgx49"" OR ""03vek6s52"" OR ""00za53h95"" OR ""03dbr7087"" OR ""00b30xv10"" OR ""043mz5j54"" OR ""00py81415"" OR ""00jmfr291"" OR ""00f54p054"" OR ""01ej9dk98"" OR ""0384j8v12"" OR ""036rp1748"")) AND publication_type:""journal article"" AND date_published>=now-10y AND field_of_study: ((""Medicine"" OR ""Internal medicine"" OR ""Pharmacology"") AND (""Psychiatry"" OR ""Psychology"" OR ""Psychological intervention"" OR ""Dementia"" OR ""Clinical psychology"" OR ""Anxiety"" OR ""Major depressive disorder"" OR ""Schizophrenia"" OR ""Alzheimer's disease""))",AND date_published>=now-10y,"AND field_of_study: ((""Medicine"" OR ""Internal medicine"" OR ""Pharmacology"") AND (""Psychiatry"" OR ""Psychology"" OR ""Psychological intervention"" OR ""Dementia"" OR ""Clinical psychology"" OR ""Anxiety"" OR ""Major depressive disorder"" OR ""Schizophrenia"" OR ""Alzheimer's disease""))",NA,oa_therapy_area,Uni,Psychiatry,2015,8322,2021,2049,445,542,117,5174,3148
psychiatry (primary search + psychiatry tags) - uni,"(author.affiliation.name:(""university of cape town"" OR ""south african college"" OR ""shanghai jiao tong university"" OR ""shanghai communications university"" OR ""fudan university"" OR ""sun yat-sen university"" OR ""zhejiang university"" OR ""chekiang university"" OR ""peking university"" OR ""imperial university of peking"" OR ""capital medical university"" OR ""cmu"" OR ""seoul national university"" OR ""seoul daehakgyo"" OR ""peking union medical college"" OR ""beijing xiehe hospital"" OR ""sichuan university"" OR ""sìchuān dàxué"" OR ""nanjing medical university"" OR ""national jiangsu medical college"" OR ""huazhong university of science and technology"" OR ""huázhōng kējì dàxué"" OR ""university college london"" OR ""london university"" OR ""karolinska institutet"" OR ""royal caroline institute"" OR ""university of oxford"" OR ""oxford university"" OR ""university of copenhagen"" OR ""universität kopenhagen"" OR ""université de paris"" OR ""university of paris"" OR ""king's college london"" OR ""kcl"" OR ""university of amsterdam"" OR ""universiteit van amsterdam"" OR ""imperial college london"" OR ""coleg imperial llundain"" OR ""utrecht university"" OR ""universiteit utrecht"" OR ""heidelberg university"" OR ""ruprecht-karls-universität heidelberg"" OR ""university of milan"" OR ""université de milan"" OR ""erasmus university rotterdam"" OR ""erasmus universiteit rotterdam"" OR ""freie universität berlin"" OR ""free university of berlin"" OR ""university of cambridge"" OR ""cambridge university"" OR ""humboldt-universität zu berlin"" OR ""humboldt university of berlin"" OR ""university of zurich"" OR ""universität zürich"" OR ""tel aviv university"" OR ""harvard university"" OR ""universidad de harvard"" OR ""johns hopkins university"" OR ""jhu"" OR ""university of toronto"" OR ""université de toronto"" OR ""university of pennsylvania"" Or ""upenn"" OR ""university of california, san francisco"" OR ""ucsf"" OR ""duke university"" OR ""Universidad de Duke"" OR ""university of michigan"" OR ""umich"" OR ""stanford university"" OR ""leland stanford junior university"" OR ""university of melbourne"" OR ""melbourne university"" OR ""university of sydney"" OR ""sydney university"" OR ""university of são paulo"" OR ""universidade de são paulo"") OR author.affiliation.ror_id_lineage:(""03p74gp79"" OR ""0220qvk04"" OR ""013q1eq08"" OR ""0064kty71"" OR ""00a2xv884"" OR ""02v51f717"" OR ""013xs5b60"" OR ""04h9pn542"" OR ""04jztag35"" OR ""011ashp19"" OR ""059gcgy73"" OR ""00p991c53"" OR ""02jx3x895"" OR ""056d84691"" OR ""052gg0110"" OR ""035b05819"" OR ""05f82e368"" OR ""0220mzb33"" OR ""04dkp9463"" OR ""041kmwe10"" OR ""04pp8hn57"" OR ""038t36y30"" OR ""00wjc7c48"" OR ""057w15z03"" OR ""046ak2485"" OR ""013meh722"" OR ""01hcx6992"" OR ""02crff812"" OR ""04mhzgx49"" OR ""03vek6s52"" OR ""00za53h95"" OR ""03dbr7087"" OR ""00b30xv10"" OR ""043mz5j54"" OR ""00py81415"" OR ""00jmfr291"" OR ""00f54p054"" OR ""01ej9dk98"" OR ""0384j8v12"" OR ""036rp1748"")) AND publication_type:""journal article"" AND date_published>=now-10y AND field_of_study: ((""Medicine"" OR ""Internal medicine"" OR ""Pharmacology"") AND (""Psychiatry"" OR ""Psychology"" OR ""Psychological intervention"" OR ""Dementia"" OR ""Clinical psychology"" OR ""Anxiety"" OR ""Major depressive disorder"" OR ""Schizophrenia"" OR ""Alzheimer's disease""))",AND date_published>=now-10y,"AND field_of_study: ((""Medicine"" OR ""Internal medicine"" OR ""Pharmacology"") AND (""Psychiatry"" OR ""Psychology"" OR ""Psychological intervention"" OR ""Dementia"" OR ""Clinical psychology"" OR ""Anxiety"" OR ""Major depressive disorder"" OR ""Schizophrenia"" OR ""Alzheimer's disease""))",NA,oa_therapy_area,Uni,Psychiatry,2016,9060,2385,2426,551,507,111,5980,3080
psychiatry (primary search + psychiatry tags) - uni,"(author.affiliation.name:(""university of cape town"" OR ""south african college"" OR ""shanghai jiao tong university"" OR ""shanghai communications university"" OR ""fudan university"" OR ""sun yat-sen university"" OR ""zhejiang university"" OR ""chekiang university"" OR ""peking university"" OR ""imperial university of peking"" OR ""capital medical university"" OR ""cmu"" OR ""seoul national university"" OR ""seoul daehakgyo"" OR ""peking union medical college"" OR ""beijing xiehe hospital"" OR ""sichuan university"" OR ""sìchuān dàxué"" OR ""nanjing medical university"" OR ""national jiangsu medical college"" OR ""huazhong university of science and technology"" OR ""huázhōng kējì dàxué"" OR ""university college london"" OR ""london university"" OR ""karolinska institutet"" OR ""royal caroline institute"" OR ""university of oxford"" OR ""oxford university"" OR ""university of copenhagen"" OR ""universität kopenhagen"" OR ""université de paris"" OR ""university of paris"" OR ""king's college london"" OR ""kcl"" OR ""university of amsterdam"" OR ""universiteit van amsterdam"" OR ""imperial college london"" OR ""coleg imperial llundain"" OR ""utrecht university"" OR ""universiteit utrecht"" OR ""heidelberg university"" OR ""ruprecht-karls-universität heidelberg"" OR ""university of milan"" OR ""université de milan"" OR ""erasmus university rotterdam"" OR ""erasmus universiteit rotterdam"" OR ""freie universität berlin"" OR ""free university of berlin"" OR ""university of cambridge"" OR ""cambridge university"" OR ""humboldt-universität zu berlin"" OR ""humboldt university of berlin"" OR ""university of zurich"" OR ""universität zürich"" OR ""tel aviv university"" OR ""harvard university"" OR ""universidad de harvard"" OR ""johns hopkins university"" OR ""jhu"" OR ""university of toronto"" OR ""université de toronto"" OR ""university of pennsylvania"" Or ""upenn"" OR ""university of california, san francisco"" OR ""ucsf"" OR ""duke university"" OR ""Universidad de Duke"" OR ""university of michigan"" OR ""umich"" OR ""stanford university"" OR ""leland stanford junior university"" OR ""university of melbourne"" OR ""melbourne university"" OR ""university of sydney"" OR ""sydney university"" OR ""university of são paulo"" OR ""universidade de são paulo"") OR author.affiliation.ror_id_lineage:(""03p74gp79"" OR ""0220qvk04"" OR ""013q1eq08"" OR ""0064kty71"" OR ""00a2xv884"" OR ""02v51f717"" OR ""013xs5b60"" OR ""04h9pn542"" OR ""04jztag35"" OR ""011ashp19"" OR ""059gcgy73"" OR ""00p991c53"" OR ""02jx3x895"" OR ""056d84691"" OR ""052gg0110"" OR ""035b05819"" OR ""05f82e368"" OR ""0220mzb33"" OR ""04dkp9463"" OR ""041kmwe10"" OR ""04pp8hn57"" OR ""038t36y30"" OR ""00wjc7c48"" OR ""057w15z03"" OR ""046ak2485"" OR ""013meh722"" OR ""01hcx6992"" OR ""02crff812"" OR ""04mhzgx49"" OR ""03vek6s52"" OR ""00za53h95"" OR ""03dbr7087"" OR ""00b30xv10"" OR ""043mz5j54"" OR ""00py81415"" OR ""00jmfr291"" OR ""00f54p054"" OR ""01ej9dk98"" OR ""0384j8v12"" OR ""036rp1748"")) AND publication_type:""journal article"" AND date_published>=now-10y AND field_of_study: ((""Medicine"" OR ""Internal medicine"" OR ""Pharmacology"") AND (""Psychiatry"" OR ""Psychology"" OR ""Psychological intervention"" OR ""Dementia"" OR ""Clinical psychology"" OR ""Anxiety"" OR ""Major depressive disorder"" OR ""Schizophrenia"" OR ""Alzheimer's disease""))",AND date_published>=now-10y,"AND field_of_study: ((""Medicine"" OR ""Internal medicine"" OR ""Pharmacology"") AND (""Psychiatry"" OR ""Psychology"" OR ""Psychological intervention"" OR ""Dementia"" OR ""Clinical psychology"" OR ""Anxiety"" OR ""Major depressive disorder"" OR ""Schizophrenia"" OR ""Alzheimer's disease""))",NA,oa_therapy_area,Uni,Psychiatry,2017,9696,2700,2621,610,591,114,6636,3060
psychiatry (primary search + psychiatry tags) - uni,"(author.affiliation.name:(""university of cape town"" OR ""south african college"" OR ""shanghai jiao tong university"" OR ""shanghai communications university"" OR ""fudan university"" OR ""sun yat-sen university"" OR ""zhejiang university"" OR ""chekiang university"" OR ""peking university"" OR ""imperial university of peking"" OR ""capital medical university"" OR ""cmu"" OR ""seoul national university"" OR ""seoul daehakgyo"" OR ""peking union medical college"" OR ""beijing xiehe hospital"" OR ""sichuan university"" OR ""sìchuān dàxué"" OR ""nanjing medical university"" OR ""national jiangsu medical college"" OR ""huazhong university of science and technology"" OR ""huázhōng kējì dàxué"" OR ""university college london"" OR ""london university"" OR ""karolinska institutet"" OR ""royal caroline institute"" OR ""university of oxford"" OR ""oxford university"" OR ""university of copenhagen"" OR ""universität kopenhagen"" OR ""université de paris"" OR ""university of paris"" OR ""king's college london"" OR ""kcl"" OR ""university of amsterdam"" OR ""universiteit van amsterdam"" OR ""imperial college london"" OR ""coleg imperial llundain"" OR ""utrecht university"" OR ""universiteit utrecht"" OR ""heidelberg university"" OR ""ruprecht-karls-universität heidelberg"" OR ""university of milan"" OR ""université de milan"" OR ""erasmus university rotterdam"" OR ""erasmus universiteit rotterdam"" OR ""freie universität berlin"" OR ""free university of berlin"" OR ""university of cambridge"" OR ""cambridge university"" OR ""humboldt-universität zu berlin"" OR ""humboldt university of berlin"" OR ""university of zurich"" OR ""universität zürich"" OR ""tel aviv university"" OR ""harvard university"" OR ""universidad de harvard"" OR ""johns hopkins university"" OR ""jhu"" OR ""university of toronto"" OR ""université de toronto"" OR ""university of pennsylvania"" Or ""upenn"" OR ""university of california, san francisco"" OR ""ucsf"" OR ""duke university"" OR ""Universidad de Duke"" OR ""university of michigan"" OR ""umich"" OR ""stanford university"" OR ""leland stanford junior university"" OR ""university of melbourne"" OR ""melbourne university"" OR ""university of sydney"" OR ""sydney university"" OR ""university of são paulo"" OR ""universidade de são paulo"") OR author.affiliation.ror_id_lineage:(""03p74gp79"" OR ""0220qvk04"" OR ""013q1eq08"" OR ""0064kty71"" OR ""00a2xv884"" OR ""02v51f717"" OR ""013xs5b60"" OR ""04h9pn542"" OR ""04jztag35"" OR ""011ashp19"" OR ""059gcgy73"" OR ""00p991c53"" OR ""02jx3x895"" OR ""056d84691"" OR ""052gg0110"" OR ""035b05819"" OR ""05f82e368"" OR ""0220mzb33"" OR ""04dkp9463"" OR ""041kmwe10"" OR ""04pp8hn57"" OR ""038t36y30"" OR ""00wjc7c48"" OR ""057w15z03"" OR ""046ak2485"" OR ""013meh722"" OR ""01hcx6992"" OR ""02crff812"" OR ""04mhzgx49"" OR ""03vek6s52"" OR ""00za53h95"" OR ""03dbr7087"" OR ""00b30xv10"" OR ""043mz5j54"" OR ""00py81415"" OR ""00jmfr291"" OR ""00f54p054"" OR ""01ej9dk98"" OR ""0384j8v12"" OR ""036rp1748"")) AND publication_type:""journal article"" AND date_published>=now-10y AND field_of_study: ((""Medicine"" OR ""Internal medicine"" OR ""Pharmacology"") AND (""Psychiatry"" OR ""Psychology"" OR ""Psychological intervention"" OR ""Dementia"" OR ""Clinical psychology"" OR ""Anxiety"" OR ""Major depressive disorder"" OR ""Schizophrenia"" OR ""Alzheimer's disease""))",AND date_published>=now-10y,"AND field_of_study: ((""Medicine"" OR ""Internal medicine"" OR ""Pharmacology"") AND (""Psychiatry"" OR ""Psychology"" OR ""Psychological intervention"" OR ""Dementia"" OR ""Clinical psychology"" OR ""Anxiety"" OR ""Major depressive disorder"" OR ""Schizophrenia"" OR ""Alzheimer's disease""))",NA,oa_therapy_area,Uni,Psychiatry,2018,9408,2640,2434,777,549,99,6499,2909
psychiatry (primary search + psychiatry tags) - uni,"(author.affiliation.name:(""university of cape town"" OR ""south african college"" OR ""shanghai jiao tong university"" OR ""shanghai communications university"" OR ""fudan university"" OR ""sun yat-sen university"" OR ""zhejiang university"" OR ""chekiang university"" OR ""peking university"" OR ""imperial university of peking"" OR ""capital medical university"" OR ""cmu"" OR ""seoul national university"" OR ""seoul daehakgyo"" OR ""peking union medical college"" OR ""beijing xiehe hospital"" OR ""sichuan university"" OR ""sìchuān dàxué"" OR ""nanjing medical university"" OR ""national jiangsu medical college"" OR ""huazhong university of science and technology"" OR ""huázhōng kējì dàxué"" OR ""university college london"" OR ""london university"" OR ""karolinska institutet"" OR ""royal caroline institute"" OR ""university of oxford"" OR ""oxford university"" OR ""university of copenhagen"" OR ""universität kopenhagen"" OR ""université de paris"" OR ""university of paris"" OR ""king's college london"" OR ""kcl"" OR ""university of amsterdam"" OR ""universiteit van amsterdam"" OR ""imperial college london"" OR ""coleg imperial llundain"" OR ""utrecht university"" OR ""universiteit utrecht"" OR ""heidelberg university"" OR ""ruprecht-karls-universität heidelberg"" OR ""university of milan"" OR ""université de milan"" OR ""erasmus university rotterdam"" OR ""erasmus universiteit rotterdam"" OR ""freie universität berlin"" OR ""free university of berlin"" OR ""university of cambridge"" OR ""cambridge university"" OR ""humboldt-universität zu berlin"" OR ""humboldt university of berlin"" OR ""university of zurich"" OR ""universität zürich"" OR ""tel aviv university"" OR ""harvard university"" OR ""universidad de harvard"" OR ""johns hopkins university"" OR ""jhu"" OR ""university of toronto"" OR ""université de toronto"" OR ""university of pennsylvania"" Or ""upenn"" OR ""university of california, san francisco"" OR ""ucsf"" OR ""duke university"" OR ""Universidad de Duke"" OR ""university of michigan"" OR ""umich"" OR ""stanford university"" OR ""leland stanford junior university"" OR ""university of melbourne"" OR ""melbourne university"" OR ""university of sydney"" OR ""sydney university"" OR ""university of são paulo"" OR ""universidade de são paulo"") OR author.affiliation.ror_id_lineage:(""03p74gp79"" OR ""0220qvk04"" OR ""013q1eq08"" OR ""0064kty71"" OR ""00a2xv884"" OR ""02v51f717"" OR ""013xs5b60"" OR ""04h9pn542"" OR ""04jztag35"" OR ""011ashp19"" OR ""059gcgy73"" OR ""00p991c53"" OR ""02jx3x895"" OR ""056d84691"" OR ""052gg0110"" OR ""035b05819"" OR ""05f82e368"" OR ""0220mzb33"" OR ""04dkp9463"" OR ""041kmwe10"" OR ""04pp8hn57"" OR ""038t36y30"" OR ""00wjc7c48"" OR ""057w15z03"" OR ""046ak2485"" OR ""013meh722"" OR ""01hcx6992"" OR ""02crff812"" OR ""04mhzgx49"" OR ""03vek6s52"" OR ""00za53h95"" OR ""03dbr7087"" OR ""00b30xv10"" OR ""043mz5j54"" OR ""00py81415"" OR ""00jmfr291"" OR ""00f54p054"" OR ""01ej9dk98"" OR ""0384j8v12"" OR ""036rp1748"")) AND publication_type:""journal article"" AND date_published>=now-10y AND field_of_study: ((""Medicine"" OR ""Internal medicine"" OR ""Pharmacology"") AND (""Psychiatry"" OR ""Psychology"" OR ""Psychological intervention"" OR ""Dementia"" OR ""Clinical psychology"" OR ""Anxiety"" OR ""Major depressive disorder"" OR ""Schizophrenia"" OR ""Alzheimer's disease""))",AND date_published>=now-10y,"AND field_of_study: ((""Medicine"" OR ""Internal medicine"" OR ""Pharmacology"") AND (""Psychiatry"" OR ""Psychology"" OR ""Psychological intervention"" OR ""Dementia"" OR ""Clinical psychology"" OR ""Anxiety"" OR ""Major depressive disorder"" OR ""Schizophrenia"" OR ""Alzheimer's disease""))",NA,oa_therapy_area,Uni,Psychiatry,2019,10559,3200,2602,866,695,106,7469,3090
psychiatry (primary search + psychiatry tags) - uni,"(author.affiliation.name:(""university of cape town"" OR ""south african college"" OR ""shanghai jiao tong university"" OR ""shanghai communications university"" OR ""fudan university"" OR ""sun yat-sen university"" OR ""zhejiang university"" OR ""chekiang university"" OR ""peking university"" OR ""imperial university of peking"" OR ""capital medical university"" OR ""cmu"" OR ""seoul national university"" OR ""seoul daehakgyo"" OR ""peking union medical college"" OR ""beijing xiehe hospital"" OR ""sichuan university"" OR ""sìchuān dàxué"" OR ""nanjing medical university"" OR ""national jiangsu medical college"" OR ""huazhong university of science and technology"" OR ""huázhōng kējì dàxué"" OR ""university college london"" OR ""london university"" OR ""karolinska institutet"" OR ""royal caroline institute"" OR ""university of oxford"" OR ""oxford university"" OR ""university of copenhagen"" OR ""universität kopenhagen"" OR ""université de paris"" OR ""university of paris"" OR ""king's college london"" OR ""kcl"" OR ""university of amsterdam"" OR ""universiteit van amsterdam"" OR ""imperial college london"" OR ""coleg imperial llundain"" OR ""utrecht university"" OR ""universiteit utrecht"" OR ""heidelberg university"" OR ""ruprecht-karls-universität heidelberg"" OR ""university of milan"" OR ""université de milan"" OR ""erasmus university rotterdam"" OR ""erasmus universiteit rotterdam"" OR ""freie universität berlin"" OR ""free university of berlin"" OR ""university of cambridge"" OR ""cambridge university"" OR ""humboldt-universität zu berlin"" OR ""humboldt university of berlin"" OR ""university of zurich"" OR ""universität zürich"" OR ""tel aviv university"" OR ""harvard university"" OR ""universidad de harvard"" OR ""johns hopkins university"" OR ""jhu"" OR ""university of toronto"" OR ""université de toronto"" OR ""university of pennsylvania"" Or ""upenn"" OR ""university of california, san francisco"" OR ""ucsf"" OR ""duke university"" OR ""Universidad de Duke"" OR ""university of michigan"" OR ""umich"" OR ""stanford university"" OR ""leland stanford junior university"" OR ""university of melbourne"" OR ""melbourne university"" OR ""university of sydney"" OR ""sydney university"" OR ""university of são paulo"" OR ""universidade de são paulo"") OR author.affiliation.ror_id_lineage:(""03p74gp79"" OR ""0220qvk04"" OR ""013q1eq08"" OR ""0064kty71"" OR ""00a2xv884"" OR ""02v51f717"" OR ""013xs5b60"" OR ""04h9pn542"" OR ""04jztag35"" OR ""011ashp19"" OR ""059gcgy73"" OR ""00p991c53"" OR ""02jx3x895"" OR ""056d84691"" OR ""052gg0110"" OR ""035b05819"" OR ""05f82e368"" OR ""0220mzb33"" OR ""04dkp9463"" OR ""041kmwe10"" OR ""04pp8hn57"" OR ""038t36y30"" OR ""00wjc7c48"" OR ""057w15z03"" OR ""046ak2485"" OR ""013meh722"" OR ""01hcx6992"" OR ""02crff812"" OR ""04mhzgx49"" OR ""03vek6s52"" OR ""00za53h95"" OR ""03dbr7087"" OR ""00b30xv10"" OR ""043mz5j54"" OR ""00py81415"" OR ""00jmfr291"" OR ""00f54p054"" OR ""01ej9dk98"" OR ""0384j8v12"" OR ""036rp1748"")) AND publication_type:""journal article"" AND date_published>=now-10y AND field_of_study: ((""Medicine"" OR ""Internal medicine"" OR ""Pharmacology"") AND (""Psychiatry"" OR ""Psychology"" OR ""Psychological intervention"" OR ""Dementia"" OR ""Clinical psychology"" OR ""Anxiety"" OR ""Major depressive disorder"" OR ""Schizophrenia"" OR ""Alzheimer's disease""))",AND date_published>=now-10y,"AND field_of_study: ((""Medicine"" OR ""Internal medicine"" OR ""Pharmacology"") AND (""Psychiatry"" OR ""Psychology"" OR ""Psychological intervention"" OR ""Dementia"" OR ""Clinical psychology"" OR ""Anxiety"" OR ""Major depressive disorder"" OR ""Schizophrenia"" OR ""Alzheimer's disease""))",NA,oa_therapy_area,Uni,Psychiatry,2020,12889,4123,2644,1380,895,288,9330,3559
psychiatry (primary search + psychiatry tags) - uni,"(author.affiliation.name:(""university of cape town"" OR ""south african college"" OR ""shanghai jiao tong university"" OR ""shanghai communications university"" OR ""fudan university"" OR ""sun yat-sen university"" OR ""zhejiang university"" OR ""chekiang university"" OR ""peking university"" OR ""imperial university of peking"" OR ""capital medical university"" OR ""cmu"" OR ""seoul national university"" OR ""seoul daehakgyo"" OR ""peking union medical college"" OR ""beijing xiehe hospital"" OR ""sichuan university"" OR ""sìchuān dàxué"" OR ""nanjing medical university"" OR ""national jiangsu medical college"" OR ""huazhong university of science and technology"" OR ""huázhōng kējì dàxué"" OR ""university college london"" OR ""london university"" OR ""karolinska institutet"" OR ""royal caroline institute"" OR ""university of oxford"" OR ""oxford university"" OR ""university of copenhagen"" OR ""universität kopenhagen"" OR ""université de paris"" OR ""university of paris"" OR ""king's college london"" OR ""kcl"" OR ""university of amsterdam"" OR ""universiteit van amsterdam"" OR ""imperial college london"" OR ""coleg imperial llundain"" OR ""utrecht university"" OR ""universiteit utrecht"" OR ""heidelberg university"" OR ""ruprecht-karls-universität heidelberg"" OR ""university of milan"" OR ""université de milan"" OR ""erasmus university rotterdam"" OR ""erasmus universiteit rotterdam"" OR ""freie universität berlin"" OR ""free university of berlin"" OR ""university of cambridge"" OR ""cambridge university"" OR ""humboldt-universität zu berlin"" OR ""humboldt university of berlin"" OR ""university of zurich"" OR ""universität zürich"" OR ""tel aviv university"" OR ""harvard university"" OR ""universidad de harvard"" OR ""johns hopkins university"" OR ""jhu"" OR ""university of toronto"" OR ""université de toronto"" OR ""university of pennsylvania"" Or ""upenn"" OR ""university of california, san francisco"" OR ""ucsf"" OR ""duke university"" OR ""Universidad de Duke"" OR ""university of michigan"" OR ""umich"" OR ""stanford university"" OR ""leland stanford junior university"" OR ""university of melbourne"" OR ""melbourne university"" OR ""university of sydney"" OR ""sydney university"" OR ""university of são paulo"" OR ""universidade de são paulo"") OR author.affiliation.ror_id_lineage:(""03p74gp79"" OR ""0220qvk04"" OR ""013q1eq08"" OR ""0064kty71"" OR ""00a2xv884"" OR ""02v51f717"" OR ""013xs5b60"" OR ""04h9pn542"" OR ""04jztag35"" OR ""011ashp19"" OR ""059gcgy73"" OR ""00p991c53"" OR ""02jx3x895"" OR ""056d84691"" OR ""052gg0110"" OR ""035b05819"" OR ""05f82e368"" OR ""0220mzb33"" OR ""04dkp9463"" OR ""041kmwe10"" OR ""04pp8hn57"" OR ""038t36y30"" OR ""00wjc7c48"" OR ""057w15z03"" OR ""046ak2485"" OR ""013meh722"" OR ""01hcx6992"" OR ""02crff812"" OR ""04mhzgx49"" OR ""03vek6s52"" OR ""00za53h95"" OR ""03dbr7087"" OR ""00b30xv10"" OR ""043mz5j54"" OR ""00py81415"" OR ""00jmfr291"" OR ""00f54p054"" OR ""01ej9dk98"" OR ""0384j8v12"" OR ""036rp1748"")) AND publication_type:""journal article"" AND date_published>=now-10y AND field_of_study: ((""Medicine"" OR ""Internal medicine"" OR ""Pharmacology"") AND (""Psychiatry"" OR ""Psychology"" OR ""Psychological intervention"" OR ""Dementia"" OR ""Clinical psychology"" OR ""Anxiety"" OR ""Major depressive disorder"" OR ""Schizophrenia"" OR ""Alzheimer's disease""))",AND date_published>=now-10y,"AND field_of_study: ((""Medicine"" OR ""Internal medicine"" OR ""Pharmacology"") AND (""Psychiatry"" OR ""Psychology"" OR ""Psychological intervention"" OR ""Dementia"" OR ""Clinical psychology"" OR ""Anxiety"" OR ""Major depressive disorder"" OR ""Schizophrenia"" OR ""Alzheimer's disease""))",NA,oa_therapy_area,Uni,Psychiatry,2021,17380,6481,1715,2042,1260,1179,12677,4703
psychiatry (primary search + psychiatry tags) - uni,"(author.affiliation.name:(""university of cape town"" OR ""south african college"" OR ""shanghai jiao tong university"" OR ""shanghai communications university"" OR ""fudan university"" OR ""sun yat-sen university"" OR ""zhejiang university"" OR ""chekiang university"" OR ""peking university"" OR ""imperial university of peking"" OR ""capital medical university"" OR ""cmu"" OR ""seoul national university"" OR ""seoul daehakgyo"" OR ""peking union medical college"" OR ""beijing xiehe hospital"" OR ""sichuan university"" OR ""sìchuān dàxué"" OR ""nanjing medical university"" OR ""national jiangsu medical college"" OR ""huazhong university of science and technology"" OR ""huázhōng kējì dàxué"" OR ""university college london"" OR ""london university"" OR ""karolinska institutet"" OR ""royal caroline institute"" OR ""university of oxford"" OR ""oxford university"" OR ""university of copenhagen"" OR ""universität kopenhagen"" OR ""université de paris"" OR ""university of paris"" OR ""king's college london"" OR ""kcl"" OR ""university of amsterdam"" OR ""universiteit van amsterdam"" OR ""imperial college london"" OR ""coleg imperial llundain"" OR ""utrecht university"" OR ""universiteit utrecht"" OR ""heidelberg university"" OR ""ruprecht-karls-universität heidelberg"" OR ""university of milan"" OR ""université de milan"" OR ""erasmus university rotterdam"" OR ""erasmus universiteit rotterdam"" OR ""freie universität berlin"" OR ""free university of berlin"" OR ""university of cambridge"" OR ""cambridge university"" OR ""humboldt-universität zu berlin"" OR ""humboldt university of berlin"" OR ""university of zurich"" OR ""universität zürich"" OR ""tel aviv university"" OR ""harvard university"" OR ""universidad de harvard"" OR ""johns hopkins university"" OR ""jhu"" OR ""university of toronto"" OR ""université de toronto"" OR ""university of pennsylvania"" Or ""upenn"" OR ""university of california, san francisco"" OR ""ucsf"" OR ""duke university"" OR ""Universidad de Duke"" OR ""university of michigan"" OR ""umich"" OR ""stanford university"" OR ""leland stanford junior university"" OR ""university of melbourne"" OR ""melbourne university"" OR ""university of sydney"" OR ""sydney university"" OR ""university of são paulo"" OR ""universidade de são paulo"") OR author.affiliation.ror_id_lineage:(""03p74gp79"" OR ""0220qvk04"" OR ""013q1eq08"" OR ""0064kty71"" OR ""00a2xv884"" OR ""02v51f717"" OR ""013xs5b60"" OR ""04h9pn542"" OR ""04jztag35"" OR ""011ashp19"" OR ""059gcgy73"" OR ""00p991c53"" OR ""02jx3x895"" OR ""056d84691"" OR ""052gg0110"" OR ""035b05819"" OR ""05f82e368"" OR ""0220mzb33"" OR ""04dkp9463"" OR ""041kmwe10"" OR ""04pp8hn57"" OR ""038t36y30"" OR ""00wjc7c48"" OR ""057w15z03"" OR ""046ak2485"" OR ""013meh722"" OR ""01hcx6992"" OR ""02crff812"" OR ""04mhzgx49"" OR ""03vek6s52"" OR ""00za53h95"" OR ""03dbr7087"" OR ""00b30xv10"" OR ""043mz5j54"" OR ""00py81415"" OR ""00jmfr291"" OR ""00f54p054"" OR ""01ej9dk98"" OR ""0384j8v12"" OR ""036rp1748"")) AND publication_type:""journal article"" AND date_published>=now-10y AND field_of_study: ((""Medicine"" OR ""Internal medicine"" OR ""Pharmacology"") AND (""Psychiatry"" OR ""Psychology"" OR ""Psychological intervention"" OR ""Dementia"" OR ""Clinical psychology"" OR ""Anxiety"" OR ""Major depressive disorder"" OR ""Schizophrenia"" OR ""Alzheimer's disease""))",AND date_published>=now-10y,"AND field_of_study: ((""Medicine"" OR ""Internal medicine"" OR ""Pharmacology"") AND (""Psychiatry"" OR ""Psychology"" OR ""Psychological intervention"" OR ""Dementia"" OR ""Clinical psychology"" OR ""Anxiety"" OR ""Major depressive disorder"" OR ""Schizophrenia"" OR ""Alzheimer's disease""))",NA,oa_therapy_area,Uni,Psychiatry,2022,50238,21158,3814,6441,2393,1457,35263,14975
psychiatry (primary search + psychiatry tags) - uni,"(author.affiliation.name:(""university of cape town"" OR ""south african college"" OR ""shanghai jiao tong university"" OR ""shanghai communications university"" OR ""fudan university"" OR ""sun yat-sen university"" OR ""zhejiang university"" OR ""chekiang university"" OR ""peking university"" OR ""imperial university of peking"" OR ""capital medical university"" OR ""cmu"" OR ""seoul national university"" OR ""seoul daehakgyo"" OR ""peking union medical college"" OR ""beijing xiehe hospital"" OR ""sichuan university"" OR ""sìchuān dàxué"" OR ""nanjing medical university"" OR ""national jiangsu medical college"" OR ""huazhong university of science and technology"" OR ""huázhōng kējì dàxué"" OR ""university college london"" OR ""london university"" OR ""karolinska institutet"" OR ""royal caroline institute"" OR ""university of oxford"" OR ""oxford university"" OR ""university of copenhagen"" OR ""universität kopenhagen"" OR ""université de paris"" OR ""university of paris"" OR ""king's college london"" OR ""kcl"" OR ""university of amsterdam"" OR ""universiteit van amsterdam"" OR ""imperial college london"" OR ""coleg imperial llundain"" OR ""utrecht university"" OR ""universiteit utrecht"" OR ""heidelberg university"" OR ""ruprecht-karls-universität heidelberg"" OR ""university of milan"" OR ""université de milan"" OR ""erasmus university rotterdam"" OR ""erasmus universiteit rotterdam"" OR ""freie universität berlin"" OR ""free university of berlin"" OR ""university of cambridge"" OR ""cambridge university"" OR ""humboldt-universität zu berlin"" OR ""humboldt university of berlin"" OR ""university of zurich"" OR ""universität zürich"" OR ""tel aviv university"" OR ""harvard university"" OR ""universidad de harvard"" OR ""johns hopkins university"" OR ""jhu"" OR ""university of toronto"" OR ""université de toronto"" OR ""university of pennsylvania"" Or ""upenn"" OR ""university of california, san francisco"" OR ""ucsf"" OR ""duke university"" OR ""Universidad de Duke"" OR ""university of michigan"" OR ""umich"" OR ""stanford university"" OR ""leland stanford junior university"" OR ""university of melbourne"" OR ""melbourne university"" OR ""university of sydney"" OR ""sydney university"" OR ""university of são paulo"" OR ""universidade de são paulo"") OR author.affiliation.ror_id_lineage:(""03p74gp79"" OR ""0220qvk04"" OR ""013q1eq08"" OR ""0064kty71"" OR ""00a2xv884"" OR ""02v51f717"" OR ""013xs5b60"" OR ""04h9pn542"" OR ""04jztag35"" OR ""011ashp19"" OR ""059gcgy73"" OR ""00p991c53"" OR ""02jx3x895"" OR ""056d84691"" OR ""052gg0110"" OR ""035b05819"" OR ""05f82e368"" OR ""0220mzb33"" OR ""04dkp9463"" OR ""041kmwe10"" OR ""04pp8hn57"" OR ""038t36y30"" OR ""00wjc7c48"" OR ""057w15z03"" OR ""046ak2485"" OR ""013meh722"" OR ""01hcx6992"" OR ""02crff812"" OR ""04mhzgx49"" OR ""03vek6s52"" OR ""00za53h95"" OR ""03dbr7087"" OR ""00b30xv10"" OR ""043mz5j54"" OR ""00py81415"" OR ""00jmfr291"" OR ""00f54p054"" OR ""01ej9dk98"" OR ""0384j8v12"" OR ""036rp1748"")) AND publication_type:""journal article"" AND date_published>=now-10y AND field_of_study: ((""Medicine"" OR ""Internal medicine"" OR ""Pharmacology"") AND (""Psychiatry"" OR ""Psychology"" OR ""Psychological intervention"" OR ""Dementia"" OR ""Clinical psychology"" OR ""Anxiety"" OR ""Major depressive disorder"" OR ""Schizophrenia"" OR ""Alzheimer's disease""))",AND date_published>=now-10y,"AND field_of_study: ((""Medicine"" OR ""Internal medicine"" OR ""Pharmacology"") AND (""Psychiatry"" OR ""Psychology"" OR ""Psychological intervention"" OR ""Dementia"" OR ""Clinical psychology"" OR ""Anxiety"" OR ""Major depressive disorder"" OR ""Schizophrenia"" OR ""Alzheimer's disease""))",NA,oa_therapy_area,Uni,Psychiatry,2023,19531,7691,467,2305,642,1732,12837,6694
respiratory (primary search + respiratory tags) - uni,"(author.affiliation.name:(""university of cape town"" OR ""south african college"" OR ""shanghai jiao tong university"" OR ""shanghai communications university"" OR ""fudan university"" OR ""sun yat-sen university"" OR ""zhejiang university"" OR ""chekiang university"" OR ""peking university"" OR ""imperial university of peking"" OR ""capital medical university"" OR ""cmu"" OR ""seoul national university"" OR ""seoul daehakgyo"" OR ""peking union medical college"" OR ""beijing xiehe hospital"" OR ""sichuan university"" OR ""sìchuān dàxué"" OR ""nanjing medical university"" OR ""national jiangsu medical college"" OR ""huazhong university of science and technology"" OR ""huázhōng kējì dàxué"" OR ""university college london"" OR ""london university"" OR ""karolinska institutet"" OR ""royal caroline institute"" OR ""university of oxford"" OR ""oxford university"" OR ""university of copenhagen"" OR ""universität kopenhagen"" OR ""université de paris"" OR ""university of paris"" OR ""king's college london"" OR ""kcl"" OR ""university of amsterdam"" OR ""universiteit van amsterdam"" OR ""imperial college london"" OR ""coleg imperial llundain"" OR ""utrecht university"" OR ""universiteit utrecht"" OR ""heidelberg university"" OR ""ruprecht-karls-universität heidelberg"" OR ""university of milan"" OR ""université de milan"" OR ""erasmus university rotterdam"" OR ""erasmus universiteit rotterdam"" OR ""freie universität berlin"" OR ""free university of berlin"" OR ""university of cambridge"" OR ""cambridge university"" OR ""humboldt-universität zu berlin"" OR ""humboldt university of berlin"" OR ""university of zurich"" OR ""universität zürich"" OR ""tel aviv university"" OR ""harvard university"" OR ""universidad de harvard"" OR ""johns hopkins university"" OR ""jhu"" OR ""university of toronto"" OR ""université de toronto"" OR ""university of pennsylvania"" Or ""upenn"" OR ""university of california, san francisco"" OR ""ucsf"" OR ""duke university"" OR ""Universidad de Duke"" OR ""university of michigan"" OR ""umich"" OR ""stanford university"" OR ""leland stanford junior university"" OR ""university of melbourne"" OR ""melbourne university"" OR ""university of sydney"" OR ""sydney university"" OR ""university of são paulo"" OR ""universidade de são paulo"") OR author.affiliation.ror_id_lineage:(""03p74gp79"" OR ""0220qvk04"" OR ""013q1eq08"" OR ""0064kty71"" OR ""00a2xv884"" OR ""02v51f717"" OR ""013xs5b60"" OR ""04h9pn542"" OR ""04jztag35"" OR ""011ashp19"" OR ""059gcgy73"" OR ""00p991c53"" OR ""02jx3x895"" OR ""056d84691"" OR ""052gg0110"" OR ""035b05819"" OR ""05f82e368"" OR ""0220mzb33"" OR ""04dkp9463"" OR ""041kmwe10"" OR ""04pp8hn57"" OR ""038t36y30"" OR ""00wjc7c48"" OR ""057w15z03"" OR ""046ak2485"" OR ""013meh722"" OR ""01hcx6992"" OR ""02crff812"" OR ""04mhzgx49"" OR ""03vek6s52"" OR ""00za53h95"" OR ""03dbr7087"" OR ""00b30xv10"" OR ""043mz5j54"" OR ""00py81415"" OR ""00jmfr291"" OR ""00f54p054"" OR ""01ej9dk98"" OR ""0384j8v12"" OR ""036rp1748"")) AND publication_type:""journal article"" AND date_published>=now-10y AND field_of_study: ((""Medicine"" OR ""Internal medicine"" OR ""Pharmacology"") AND (""COPD"" OR ""Asthma"" OR ""Lung"" OR ""Idiopathic pulmonary fibrosis"" OR ""Respiratory system"" OR ""Spirometry"" OR ""Pulmonary disease"" OR ""Respiratory tract infections""))",AND date_published>=now-10y,"AND field_of_study: ((""Medicine"" OR ""Internal medicine"" OR ""Pharmacology"") AND (""COPD"" OR ""Asthma"" OR ""Lung"" OR ""Idiopathic pulmonary fibrosis"" OR ""Respiratory system"" OR ""Spirometry"" OR ""Pulmonary disease"" OR ""Respiratory tract infections""))",NA,oa_therapy_area,Uni,Respiratory,2013,1207,175,235,33,82,31,556,651
respiratory (primary search + respiratory tags) - uni,"(author.affiliation.name:(""university of cape town"" OR ""south african college"" OR ""shanghai jiao tong university"" OR ""shanghai communications university"" OR ""fudan university"" OR ""sun yat-sen university"" OR ""zhejiang university"" OR ""chekiang university"" OR ""peking university"" OR ""imperial university of peking"" OR ""capital medical university"" OR ""cmu"" OR ""seoul national university"" OR ""seoul daehakgyo"" OR ""peking union medical college"" OR ""beijing xiehe hospital"" OR ""sichuan university"" OR ""sìchuān dàxué"" OR ""nanjing medical university"" OR ""national jiangsu medical college"" OR ""huazhong university of science and technology"" OR ""huázhōng kējì dàxué"" OR ""university college london"" OR ""london university"" OR ""karolinska institutet"" OR ""royal caroline institute"" OR ""university of oxford"" OR ""oxford university"" OR ""university of copenhagen"" OR ""universität kopenhagen"" OR ""université de paris"" OR ""university of paris"" OR ""king's college london"" OR ""kcl"" OR ""university of amsterdam"" OR ""universiteit van amsterdam"" OR ""imperial college london"" OR ""coleg imperial llundain"" OR ""utrecht university"" OR ""universiteit utrecht"" OR ""heidelberg university"" OR ""ruprecht-karls-universität heidelberg"" OR ""university of milan"" OR ""université de milan"" OR ""erasmus university rotterdam"" OR ""erasmus universiteit rotterdam"" OR ""freie universität berlin"" OR ""free university of berlin"" OR ""university of cambridge"" OR ""cambridge university"" OR ""humboldt-universität zu berlin"" OR ""humboldt university of berlin"" OR ""university of zurich"" OR ""universität zürich"" OR ""tel aviv university"" OR ""harvard university"" OR ""universidad de harvard"" OR ""johns hopkins university"" OR ""jhu"" OR ""university of toronto"" OR ""université de toronto"" OR ""university of pennsylvania"" Or ""upenn"" OR ""university of california, san francisco"" OR ""ucsf"" OR ""duke university"" OR ""Universidad de Duke"" OR ""university of michigan"" OR ""umich"" OR ""stanford university"" OR ""leland stanford junior university"" OR ""university of melbourne"" OR ""melbourne university"" OR ""university of sydney"" OR ""sydney university"" OR ""university of são paulo"" OR ""universidade de são paulo"") OR author.affiliation.ror_id_lineage:(""03p74gp79"" OR ""0220qvk04"" OR ""013q1eq08"" OR ""0064kty71"" OR ""00a2xv884"" OR ""02v51f717"" OR ""013xs5b60"" OR ""04h9pn542"" OR ""04jztag35"" OR ""011ashp19"" OR ""059gcgy73"" OR ""00p991c53"" OR ""02jx3x895"" OR ""056d84691"" OR ""052gg0110"" OR ""035b05819"" OR ""05f82e368"" OR ""0220mzb33"" OR ""04dkp9463"" OR ""041kmwe10"" OR ""04pp8hn57"" OR ""038t36y30"" OR ""00wjc7c48"" OR ""057w15z03"" OR ""046ak2485"" OR ""013meh722"" OR ""01hcx6992"" OR ""02crff812"" OR ""04mhzgx49"" OR ""03vek6s52"" OR ""00za53h95"" OR ""03dbr7087"" OR ""00b30xv10"" OR ""043mz5j54"" OR ""00py81415"" OR ""00jmfr291"" OR ""00f54p054"" OR ""01ej9dk98"" OR ""0384j8v12"" OR ""036rp1748"")) AND publication_type:""journal article"" AND date_published>=now-10y AND field_of_study: ((""Medicine"" OR ""Internal medicine"" OR ""Pharmacology"") AND (""COPD"" OR ""Asthma"" OR ""Lung"" OR ""Idiopathic pulmonary fibrosis"" OR ""Respiratory system"" OR ""Spirometry"" OR ""Pulmonary disease"" OR ""Respiratory tract infections""))",AND date_published>=now-10y,"AND field_of_study: ((""Medicine"" OR ""Internal medicine"" OR ""Pharmacology"") AND (""COPD"" OR ""Asthma"" OR ""Lung"" OR ""Idiopathic pulmonary fibrosis"" OR ""Respiratory system"" OR ""Spirometry"" OR ""Pulmonary disease"" OR ""Respiratory tract infections""))",NA,oa_therapy_area,Uni,Respiratory,2014,2717,591,573,103,183,70,1520,1197
respiratory (primary search + respiratory tags) - uni,"(author.affiliation.name:(""university of cape town"" OR ""south african college"" OR ""shanghai jiao tong university"" OR ""shanghai communications university"" OR ""fudan university"" OR ""sun yat-sen university"" OR ""zhejiang university"" OR ""chekiang university"" OR ""peking university"" OR ""imperial university of peking"" OR ""capital medical university"" OR ""cmu"" OR ""seoul national university"" OR ""seoul daehakgyo"" OR ""peking union medical college"" OR ""beijing xiehe hospital"" OR ""sichuan university"" OR ""sìchuān dàxué"" OR ""nanjing medical university"" OR ""national jiangsu medical college"" OR ""huazhong university of science and technology"" OR ""huázhōng kējì dàxué"" OR ""university college london"" OR ""london university"" OR ""karolinska institutet"" OR ""royal caroline institute"" OR ""university of oxford"" OR ""oxford university"" OR ""university of copenhagen"" OR ""universität kopenhagen"" OR ""université de paris"" OR ""university of paris"" OR ""king's college london"" OR ""kcl"" OR ""university of amsterdam"" OR ""universiteit van amsterdam"" OR ""imperial college london"" OR ""coleg imperial llundain"" OR ""utrecht university"" OR ""universiteit utrecht"" OR ""heidelberg university"" OR ""ruprecht-karls-universität heidelberg"" OR ""university of milan"" OR ""université de milan"" OR ""erasmus university rotterdam"" OR ""erasmus universiteit rotterdam"" OR ""freie universität berlin"" OR ""free university of berlin"" OR ""university of cambridge"" OR ""cambridge university"" OR ""humboldt-universität zu berlin"" OR ""humboldt university of berlin"" OR ""university of zurich"" OR ""universität zürich"" OR ""tel aviv university"" OR ""harvard university"" OR ""universidad de harvard"" OR ""johns hopkins university"" OR ""jhu"" OR ""university of toronto"" OR ""université de toronto"" OR ""university of pennsylvania"" Or ""upenn"" OR ""university of california, san francisco"" OR ""ucsf"" OR ""duke university"" OR ""Universidad de Duke"" OR ""university of michigan"" OR ""umich"" OR ""stanford university"" OR ""leland stanford junior university"" OR ""university of melbourne"" OR ""melbourne university"" OR ""university of sydney"" OR ""sydney university"" OR ""university of são paulo"" OR ""universidade de são paulo"") OR author.affiliation.ror_id_lineage:(""03p74gp79"" OR ""0220qvk04"" OR ""013q1eq08"" OR ""0064kty71"" OR ""00a2xv884"" OR ""02v51f717"" OR ""013xs5b60"" OR ""04h9pn542"" OR ""04jztag35"" OR ""011ashp19"" OR ""059gcgy73"" OR ""00p991c53"" OR ""02jx3x895"" OR ""056d84691"" OR ""052gg0110"" OR ""035b05819"" OR ""05f82e368"" OR ""0220mzb33"" OR ""04dkp9463"" OR ""041kmwe10"" OR ""04pp8hn57"" OR ""038t36y30"" OR ""00wjc7c48"" OR ""057w15z03"" OR ""046ak2485"" OR ""013meh722"" OR ""01hcx6992"" OR ""02crff812"" OR ""04mhzgx49"" OR ""03vek6s52"" OR ""00za53h95"" OR ""03dbr7087"" OR ""00b30xv10"" OR ""043mz5j54"" OR ""00py81415"" OR ""00jmfr291"" OR ""00f54p054"" OR ""01ej9dk98"" OR ""0384j8v12"" OR ""036rp1748"")) AND publication_type:""journal article"" AND date_published>=now-10y AND field_of_study: ((""Medicine"" OR ""Internal medicine"" OR ""Pharmacology"") AND (""COPD"" OR ""Asthma"" OR ""Lung"" OR ""Idiopathic pulmonary fibrosis"" OR ""Respiratory system"" OR ""Spirometry"" OR ""Pulmonary disease"" OR ""Respiratory tract infections""))",AND date_published>=now-10y,"AND field_of_study: ((""Medicine"" OR ""Internal medicine"" OR ""Pharmacology"") AND (""COPD"" OR ""Asthma"" OR ""Lung"" OR ""Idiopathic pulmonary fibrosis"" OR ""Respiratory system"" OR ""Spirometry"" OR ""Pulmonary disease"" OR ""Respiratory tract infections""))",NA,oa_therapy_area,Uni,Respiratory,2015,2769,687,500,125,262,75,1649,1120
respiratory (primary search + respiratory tags) - uni,"(author.affiliation.name:(""university of cape town"" OR ""south african college"" OR ""shanghai jiao tong university"" OR ""shanghai communications university"" OR ""fudan university"" OR ""sun yat-sen university"" OR ""zhejiang university"" OR ""chekiang university"" OR ""peking university"" OR ""imperial university of peking"" OR ""capital medical university"" OR ""cmu"" OR ""seoul national university"" OR ""seoul daehakgyo"" OR ""peking union medical college"" OR ""beijing xiehe hospital"" OR ""sichuan university"" OR ""sìchuān dàxué"" OR ""nanjing medical university"" OR ""national jiangsu medical college"" OR ""huazhong university of science and technology"" OR ""huázhōng kējì dàxué"" OR ""university college london"" OR ""london university"" OR ""karolinska institutet"" OR ""royal caroline institute"" OR ""university of oxford"" OR ""oxford university"" OR ""university of copenhagen"" OR ""universität kopenhagen"" OR ""université de paris"" OR ""university of paris"" OR ""king's college london"" OR ""kcl"" OR ""university of amsterdam"" OR ""universiteit van amsterdam"" OR ""imperial college london"" OR ""coleg imperial llundain"" OR ""utrecht university"" OR ""universiteit utrecht"" OR ""heidelberg university"" OR ""ruprecht-karls-universität heidelberg"" OR ""university of milan"" OR ""université de milan"" OR ""erasmus university rotterdam"" OR ""erasmus universiteit rotterdam"" OR ""freie universität berlin"" OR ""free university of berlin"" OR ""university of cambridge"" OR ""cambridge university"" OR ""humboldt-universität zu berlin"" OR ""humboldt university of berlin"" OR ""university of zurich"" OR ""universität zürich"" OR ""tel aviv university"" OR ""harvard university"" OR ""universidad de harvard"" OR ""johns hopkins university"" OR ""jhu"" OR ""university of toronto"" OR ""université de toronto"" OR ""university of pennsylvania"" Or ""upenn"" OR ""university of california, san francisco"" OR ""ucsf"" OR ""duke university"" OR ""Universidad de Duke"" OR ""university of michigan"" OR ""umich"" OR ""stanford university"" OR ""leland stanford junior university"" OR ""university of melbourne"" OR ""melbourne university"" OR ""university of sydney"" OR ""sydney university"" OR ""university of são paulo"" OR ""universidade de são paulo"") OR author.affiliation.ror_id_lineage:(""03p74gp79"" OR ""0220qvk04"" OR ""013q1eq08"" OR ""0064kty71"" OR ""00a2xv884"" OR ""02v51f717"" OR ""013xs5b60"" OR ""04h9pn542"" OR ""04jztag35"" OR ""011ashp19"" OR ""059gcgy73"" OR ""00p991c53"" OR ""02jx3x895"" OR ""056d84691"" OR ""052gg0110"" OR ""035b05819"" OR ""05f82e368"" OR ""0220mzb33"" OR ""04dkp9463"" OR ""041kmwe10"" OR ""04pp8hn57"" OR ""038t36y30"" OR ""00wjc7c48"" OR ""057w15z03"" OR ""046ak2485"" OR ""013meh722"" OR ""01hcx6992"" OR ""02crff812"" OR ""04mhzgx49"" OR ""03vek6s52"" OR ""00za53h95"" OR ""03dbr7087"" OR ""00b30xv10"" OR ""043mz5j54"" OR ""00py81415"" OR ""00jmfr291"" OR ""00f54p054"" OR ""01ej9dk98"" OR ""0384j8v12"" OR ""036rp1748"")) AND publication_type:""journal article"" AND date_published>=now-10y AND field_of_study: ((""Medicine"" OR ""Internal medicine"" OR ""Pharmacology"") AND (""COPD"" OR ""Asthma"" OR ""Lung"" OR ""Idiopathic pulmonary fibrosis"" OR ""Respiratory system"" OR ""Spirometry"" OR ""Pulmonary disease"" OR ""Respiratory tract infections""))",AND date_published>=now-10y,"AND field_of_study: ((""Medicine"" OR ""Internal medicine"" OR ""Pharmacology"") AND (""COPD"" OR ""Asthma"" OR ""Lung"" OR ""Idiopathic pulmonary fibrosis"" OR ""Respiratory system"" OR ""Spirometry"" OR ""Pulmonary disease"" OR ""Respiratory tract infections""))",NA,oa_therapy_area,Uni,Respiratory,2016,3066,729,597,135,295,52,1808,1258
respiratory (primary search + respiratory tags) - uni,"(author.affiliation.name:(""university of cape town"" OR ""south african college"" OR ""shanghai jiao tong university"" OR ""shanghai communications university"" OR ""fudan university"" OR ""sun yat-sen university"" OR ""zhejiang university"" OR ""chekiang university"" OR ""peking university"" OR ""imperial university of peking"" OR ""capital medical university"" OR ""cmu"" OR ""seoul national university"" OR ""seoul daehakgyo"" OR ""peking union medical college"" OR ""beijing xiehe hospital"" OR ""sichuan university"" OR ""sìchuān dàxué"" OR ""nanjing medical university"" OR ""national jiangsu medical college"" OR ""huazhong university of science and technology"" OR ""huázhōng kējì dàxué"" OR ""university college london"" OR ""london university"" OR ""karolinska institutet"" OR ""royal caroline institute"" OR ""university of oxford"" OR ""oxford university"" OR ""university of copenhagen"" OR ""universität kopenhagen"" OR ""université de paris"" OR ""university of paris"" OR ""king's college london"" OR ""kcl"" OR ""university of amsterdam"" OR ""universiteit van amsterdam"" OR ""imperial college london"" OR ""coleg imperial llundain"" OR ""utrecht university"" OR ""universiteit utrecht"" OR ""heidelberg university"" OR ""ruprecht-karls-universität heidelberg"" OR ""university of milan"" OR ""université de milan"" OR ""erasmus university rotterdam"" OR ""erasmus universiteit rotterdam"" OR ""freie universität berlin"" OR ""free university of berlin"" OR ""university of cambridge"" OR ""cambridge university"" OR ""humboldt-universität zu berlin"" OR ""humboldt university of berlin"" OR ""university of zurich"" OR ""universität zürich"" OR ""tel aviv university"" OR ""harvard university"" OR ""universidad de harvard"" OR ""johns hopkins university"" OR ""jhu"" OR ""university of toronto"" OR ""université de toronto"" OR ""university of pennsylvania"" Or ""upenn"" OR ""university of california, san francisco"" OR ""ucsf"" OR ""duke university"" OR ""Universidad de Duke"" OR ""university of michigan"" OR ""umich"" OR ""stanford university"" OR ""leland stanford junior university"" OR ""university of melbourne"" OR ""melbourne university"" OR ""university of sydney"" OR ""sydney university"" OR ""university of são paulo"" OR ""universidade de são paulo"") OR author.affiliation.ror_id_lineage:(""03p74gp79"" OR ""0220qvk04"" OR ""013q1eq08"" OR ""0064kty71"" OR ""00a2xv884"" OR ""02v51f717"" OR ""013xs5b60"" OR ""04h9pn542"" OR ""04jztag35"" OR ""011ashp19"" OR ""059gcgy73"" OR ""00p991c53"" OR ""02jx3x895"" OR ""056d84691"" OR ""052gg0110"" OR ""035b05819"" OR ""05f82e368"" OR ""0220mzb33"" OR ""04dkp9463"" OR ""041kmwe10"" OR ""04pp8hn57"" OR ""038t36y30"" OR ""00wjc7c48"" OR ""057w15z03"" OR ""046ak2485"" OR ""013meh722"" OR ""01hcx6992"" OR ""02crff812"" OR ""04mhzgx49"" OR ""03vek6s52"" OR ""00za53h95"" OR ""03dbr7087"" OR ""00b30xv10"" OR ""043mz5j54"" OR ""00py81415"" OR ""00jmfr291"" OR ""00f54p054"" OR ""01ej9dk98"" OR ""0384j8v12"" OR ""036rp1748"")) AND publication_type:""journal article"" AND date_published>=now-10y AND field_of_study: ((""Medicine"" OR ""Internal medicine"" OR ""Pharmacology"") AND (""COPD"" OR ""Asthma"" OR ""Lung"" OR ""Idiopathic pulmonary fibrosis"" OR ""Respiratory system"" OR ""Spirometry"" OR ""Pulmonary disease"" OR ""Respiratory tract infections""))",AND date_published>=now-10y,"AND field_of_study: ((""Medicine"" OR ""Internal medicine"" OR ""Pharmacology"") AND (""COPD"" OR ""Asthma"" OR ""Lung"" OR ""Idiopathic pulmonary fibrosis"" OR ""Respiratory system"" OR ""Spirometry"" OR ""Pulmonary disease"" OR ""Respiratory tract infections""))",NA,oa_therapy_area,Uni,Respiratory,2017,3298,909,668,175,321,74,2147,1151
respiratory (primary search + respiratory tags) - uni,"(author.affiliation.name:(""university of cape town"" OR ""south african college"" OR ""shanghai jiao tong university"" OR ""shanghai communications university"" OR ""fudan university"" OR ""sun yat-sen university"" OR ""zhejiang university"" OR ""chekiang university"" OR ""peking university"" OR ""imperial university of peking"" OR ""capital medical university"" OR ""cmu"" OR ""seoul national university"" OR ""seoul daehakgyo"" OR ""peking union medical college"" OR ""beijing xiehe hospital"" OR ""sichuan university"" OR ""sìchuān dàxué"" OR ""nanjing medical university"" OR ""national jiangsu medical college"" OR ""huazhong university of science and technology"" OR ""huázhōng kējì dàxué"" OR ""university college london"" OR ""london university"" OR ""karolinska institutet"" OR ""royal caroline institute"" OR ""university of oxford"" OR ""oxford university"" OR ""university of copenhagen"" OR ""universität kopenhagen"" OR ""université de paris"" OR ""university of paris"" OR ""king's college london"" OR ""kcl"" OR ""university of amsterdam"" OR ""universiteit van amsterdam"" OR ""imperial college london"" OR ""coleg imperial llundain"" OR ""utrecht university"" OR ""universiteit utrecht"" OR ""heidelberg university"" OR ""ruprecht-karls-universität heidelberg"" OR ""university of milan"" OR ""université de milan"" OR ""erasmus university rotterdam"" OR ""erasmus universiteit rotterdam"" OR ""freie universität berlin"" OR ""free university of berlin"" OR ""university of cambridge"" OR ""cambridge university"" OR ""humboldt-universität zu berlin"" OR ""humboldt university of berlin"" OR ""university of zurich"" OR ""universität zürich"" OR ""tel aviv university"" OR ""harvard university"" OR ""universidad de harvard"" OR ""johns hopkins university"" OR ""jhu"" OR ""university of toronto"" OR ""université de toronto"" OR ""university of pennsylvania"" Or ""upenn"" OR ""university of california, san francisco"" OR ""ucsf"" OR ""duke university"" OR ""Universidad de Duke"" OR ""university of michigan"" OR ""umich"" OR ""stanford university"" OR ""leland stanford junior university"" OR ""university of melbourne"" OR ""melbourne university"" OR ""university of sydney"" OR ""sydney university"" OR ""university of são paulo"" OR ""universidade de são paulo"") OR author.affiliation.ror_id_lineage:(""03p74gp79"" OR ""0220qvk04"" OR ""013q1eq08"" OR ""0064kty71"" OR ""00a2xv884"" OR ""02v51f717"" OR ""013xs5b60"" OR ""04h9pn542"" OR ""04jztag35"" OR ""011ashp19"" OR ""059gcgy73"" OR ""00p991c53"" OR ""02jx3x895"" OR ""056d84691"" OR ""052gg0110"" OR ""035b05819"" OR ""05f82e368"" OR ""0220mzb33"" OR ""04dkp9463"" OR ""041kmwe10"" OR ""04pp8hn57"" OR ""038t36y30"" OR ""00wjc7c48"" OR ""057w15z03"" OR ""046ak2485"" OR ""013meh722"" OR ""01hcx6992"" OR ""02crff812"" OR ""04mhzgx49"" OR ""03vek6s52"" OR ""00za53h95"" OR ""03dbr7087"" OR ""00b30xv10"" OR ""043mz5j54"" OR ""00py81415"" OR ""00jmfr291"" OR ""00f54p054"" OR ""01ej9dk98"" OR ""0384j8v12"" OR ""036rp1748"")) AND publication_type:""journal article"" AND date_published>=now-10y AND field_of_study: ((""Medicine"" OR ""Internal medicine"" OR ""Pharmacology"") AND (""COPD"" OR ""Asthma"" OR ""Lung"" OR ""Idiopathic pulmonary fibrosis"" OR ""Respiratory system"" OR ""Spirometry"" OR ""Pulmonary disease"" OR ""Respiratory tract infections""))",AND date_published>=now-10y,"AND field_of_study: ((""Medicine"" OR ""Internal medicine"" OR ""Pharmacology"") AND (""COPD"" OR ""Asthma"" OR ""Lung"" OR ""Idiopathic pulmonary fibrosis"" OR ""Respiratory system"" OR ""Spirometry"" OR ""Pulmonary disease"" OR ""Respiratory tract infections""))",NA,oa_therapy_area,Uni,Respiratory,2018,3413,1047,654,173,274,89,2237,1176
respiratory (primary search + respiratory tags) - uni,"(author.affiliation.name:(""university of cape town"" OR ""south african college"" OR ""shanghai jiao tong university"" OR ""shanghai communications university"" OR ""fudan university"" OR ""sun yat-sen university"" OR ""zhejiang university"" OR ""chekiang university"" OR ""peking university"" OR ""imperial university of peking"" OR ""capital medical university"" OR ""cmu"" OR ""seoul national university"" OR ""seoul daehakgyo"" OR ""peking union medical college"" OR ""beijing xiehe hospital"" OR ""sichuan university"" OR ""sìchuān dàxué"" OR ""nanjing medical university"" OR ""national jiangsu medical college"" OR ""huazhong university of science and technology"" OR ""huázhōng kējì dàxué"" OR ""university college london"" OR ""london university"" OR ""karolinska institutet"" OR ""royal caroline institute"" OR ""university of oxford"" OR ""oxford university"" OR ""university of copenhagen"" OR ""universität kopenhagen"" OR ""université de paris"" OR ""university of paris"" OR ""king's college london"" OR ""kcl"" OR ""university of amsterdam"" OR ""universiteit van amsterdam"" OR ""imperial college london"" OR ""coleg imperial llundain"" OR ""utrecht university"" OR ""universiteit utrecht"" OR ""heidelberg university"" OR ""ruprecht-karls-universität heidelberg"" OR ""university of milan"" OR ""université de milan"" OR ""erasmus university rotterdam"" OR ""erasmus universiteit rotterdam"" OR ""freie universität berlin"" OR ""free university of berlin"" OR ""university of cambridge"" OR ""cambridge university"" OR ""humboldt-universität zu berlin"" OR ""humboldt university of berlin"" OR ""university of zurich"" OR ""universität zürich"" OR ""tel aviv university"" OR ""harvard university"" OR ""universidad de harvard"" OR ""johns hopkins university"" OR ""jhu"" OR ""university of toronto"" OR ""université de toronto"" OR ""university of pennsylvania"" Or ""upenn"" OR ""university of california, san francisco"" OR ""ucsf"" OR ""duke university"" OR ""Universidad de Duke"" OR ""university of michigan"" OR ""umich"" OR ""stanford university"" OR ""leland stanford junior university"" OR ""university of melbourne"" OR ""melbourne university"" OR ""university of sydney"" OR ""sydney university"" OR ""university of são paulo"" OR ""universidade de são paulo"") OR author.affiliation.ror_id_lineage:(""03p74gp79"" OR ""0220qvk04"" OR ""013q1eq08"" OR ""0064kty71"" OR ""00a2xv884"" OR ""02v51f717"" OR ""013xs5b60"" OR ""04h9pn542"" OR ""04jztag35"" OR ""011ashp19"" OR ""059gcgy73"" OR ""00p991c53"" OR ""02jx3x895"" OR ""056d84691"" OR ""052gg0110"" OR ""035b05819"" OR ""05f82e368"" OR ""0220mzb33"" OR ""04dkp9463"" OR ""041kmwe10"" OR ""04pp8hn57"" OR ""038t36y30"" OR ""00wjc7c48"" OR ""057w15z03"" OR ""046ak2485"" OR ""013meh722"" OR ""01hcx6992"" OR ""02crff812"" OR ""04mhzgx49"" OR ""03vek6s52"" OR ""00za53h95"" OR ""03dbr7087"" OR ""00b30xv10"" OR ""043mz5j54"" OR ""00py81415"" OR ""00jmfr291"" OR ""00f54p054"" OR ""01ej9dk98"" OR ""0384j8v12"" OR ""036rp1748"")) AND publication_type:""journal article"" AND date_published>=now-10y AND field_of_study: ((""Medicine"" OR ""Internal medicine"" OR ""Pharmacology"") AND (""COPD"" OR ""Asthma"" OR ""Lung"" OR ""Idiopathic pulmonary fibrosis"" OR ""Respiratory system"" OR ""Spirometry"" OR ""Pulmonary disease"" OR ""Respiratory tract infections""))",AND date_published>=now-10y,"AND field_of_study: ((""Medicine"" OR ""Internal medicine"" OR ""Pharmacology"") AND (""COPD"" OR ""Asthma"" OR ""Lung"" OR ""Idiopathic pulmonary fibrosis"" OR ""Respiratory system"" OR ""Spirometry"" OR ""Pulmonary disease"" OR ""Respiratory tract infections""))",NA,oa_therapy_area,Uni,Respiratory,2019,3789,1187,650,291,262,69,2459,1330
respiratory (primary search + respiratory tags) - uni,"(author.affiliation.name:(""university of cape town"" OR ""south african college"" OR ""shanghai jiao tong university"" OR ""shanghai communications university"" OR ""fudan university"" OR ""sun yat-sen university"" OR ""zhejiang university"" OR ""chekiang university"" OR ""peking university"" OR ""imperial university of peking"" OR ""capital medical university"" OR ""cmu"" OR ""seoul national university"" OR ""seoul daehakgyo"" OR ""peking union medical college"" OR ""beijing xiehe hospital"" OR ""sichuan university"" OR ""sìchuān dàxué"" OR ""nanjing medical university"" OR ""national jiangsu medical college"" OR ""huazhong university of science and technology"" OR ""huázhōng kējì dàxué"" OR ""university college london"" OR ""london university"" OR ""karolinska institutet"" OR ""royal caroline institute"" OR ""university of oxford"" OR ""oxford university"" OR ""university of copenhagen"" OR ""universität kopenhagen"" OR ""université de paris"" OR ""university of paris"" OR ""king's college london"" OR ""kcl"" OR ""university of amsterdam"" OR ""universiteit van amsterdam"" OR ""imperial college london"" OR ""coleg imperial llundain"" OR ""utrecht university"" OR ""universiteit utrecht"" OR ""heidelberg university"" OR ""ruprecht-karls-universität heidelberg"" OR ""university of milan"" OR ""université de milan"" OR ""erasmus university rotterdam"" OR ""erasmus universiteit rotterdam"" OR ""freie universität berlin"" OR ""free university of berlin"" OR ""university of cambridge"" OR ""cambridge university"" OR ""humboldt-universität zu berlin"" OR ""humboldt university of berlin"" OR ""university of zurich"" OR ""universität zürich"" OR ""tel aviv university"" OR ""harvard university"" OR ""universidad de harvard"" OR ""johns hopkins university"" OR ""jhu"" OR ""university of toronto"" OR ""université de toronto"" OR ""university of pennsylvania"" Or ""upenn"" OR ""university of california, san francisco"" OR ""ucsf"" OR ""duke university"" OR ""Universidad de Duke"" OR ""university of michigan"" OR ""umich"" OR ""stanford university"" OR ""leland stanford junior university"" OR ""university of melbourne"" OR ""melbourne university"" OR ""university of sydney"" OR ""sydney university"" OR ""university of são paulo"" OR ""universidade de são paulo"") OR author.affiliation.ror_id_lineage:(""03p74gp79"" OR ""0220qvk04"" OR ""013q1eq08"" OR ""0064kty71"" OR ""00a2xv884"" OR ""02v51f717"" OR ""013xs5b60"" OR ""04h9pn542"" OR ""04jztag35"" OR ""011ashp19"" OR ""059gcgy73"" OR ""00p991c53"" OR ""02jx3x895"" OR ""056d84691"" OR ""052gg0110"" OR ""035b05819"" OR ""05f82e368"" OR ""0220mzb33"" OR ""04dkp9463"" OR ""041kmwe10"" OR ""04pp8hn57"" OR ""038t36y30"" OR ""00wjc7c48"" OR ""057w15z03"" OR ""046ak2485"" OR ""013meh722"" OR ""01hcx6992"" OR ""02crff812"" OR ""04mhzgx49"" OR ""03vek6s52"" OR ""00za53h95"" OR ""03dbr7087"" OR ""00b30xv10"" OR ""043mz5j54"" OR ""00py81415"" OR ""00jmfr291"" OR ""00f54p054"" OR ""01ej9dk98"" OR ""0384j8v12"" OR ""036rp1748"")) AND publication_type:""journal article"" AND date_published>=now-10y AND field_of_study: ((""Medicine"" OR ""Internal medicine"" OR ""Pharmacology"") AND (""COPD"" OR ""Asthma"" OR ""Lung"" OR ""Idiopathic pulmonary fibrosis"" OR ""Respiratory system"" OR ""Spirometry"" OR ""Pulmonary disease"" OR ""Respiratory tract infections""))",AND date_published>=now-10y,"AND field_of_study: ((""Medicine"" OR ""Internal medicine"" OR ""Pharmacology"") AND (""COPD"" OR ""Asthma"" OR ""Lung"" OR ""Idiopathic pulmonary fibrosis"" OR ""Respiratory system"" OR ""Spirometry"" OR ""Pulmonary disease"" OR ""Respiratory tract infections""))",NA,oa_therapy_area,Uni,Respiratory,2020,4850,1756,883,433,291,73,3436,1414
respiratory (primary search + respiratory tags) - uni,"(author.affiliation.name:(""university of cape town"" OR ""south african college"" OR ""shanghai jiao tong university"" OR ""shanghai communications university"" OR ""fudan university"" OR ""sun yat-sen university"" OR ""zhejiang university"" OR ""chekiang university"" OR ""peking university"" OR ""imperial university of peking"" OR ""capital medical university"" OR ""cmu"" OR ""seoul national university"" OR ""seoul daehakgyo"" OR ""peking union medical college"" OR ""beijing xiehe hospital"" OR ""sichuan university"" OR ""sìchuān dàxué"" OR ""nanjing medical university"" OR ""national jiangsu medical college"" OR ""huazhong university of science and technology"" OR ""huázhōng kējì dàxué"" OR ""university college london"" OR ""london university"" OR ""karolinska institutet"" OR ""royal caroline institute"" OR ""university of oxford"" OR ""oxford university"" OR ""university of copenhagen"" OR ""universität kopenhagen"" OR ""université de paris"" OR ""university of paris"" OR ""king's college london"" OR ""kcl"" OR ""university of amsterdam"" OR ""universiteit van amsterdam"" OR ""imperial college london"" OR ""coleg imperial llundain"" OR ""utrecht university"" OR ""universiteit utrecht"" OR ""heidelberg university"" OR ""ruprecht-karls-universität heidelberg"" OR ""university of milan"" OR ""université de milan"" OR ""erasmus university rotterdam"" OR ""erasmus universiteit rotterdam"" OR ""freie universität berlin"" OR ""free university of berlin"" OR ""university of cambridge"" OR ""cambridge university"" OR ""humboldt-universität zu berlin"" OR ""humboldt university of berlin"" OR ""university of zurich"" OR ""universität zürich"" OR ""tel aviv university"" OR ""harvard university"" OR ""universidad de harvard"" OR ""johns hopkins university"" OR ""jhu"" OR ""university of toronto"" OR ""université de toronto"" OR ""university of pennsylvania"" Or ""upenn"" OR ""university of california, san francisco"" OR ""ucsf"" OR ""duke university"" OR ""Universidad de Duke"" OR ""university of michigan"" OR ""umich"" OR ""stanford university"" OR ""leland stanford junior university"" OR ""university of melbourne"" OR ""melbourne university"" OR ""university of sydney"" OR ""sydney university"" OR ""university of são paulo"" OR ""universidade de são paulo"") OR author.affiliation.ror_id_lineage:(""03p74gp79"" OR ""0220qvk04"" OR ""013q1eq08"" OR ""0064kty71"" OR ""00a2xv884"" OR ""02v51f717"" OR ""013xs5b60"" OR ""04h9pn542"" OR ""04jztag35"" OR ""011ashp19"" OR ""059gcgy73"" OR ""00p991c53"" OR ""02jx3x895"" OR ""056d84691"" OR ""052gg0110"" OR ""035b05819"" OR ""05f82e368"" OR ""0220mzb33"" OR ""04dkp9463"" OR ""041kmwe10"" OR ""04pp8hn57"" OR ""038t36y30"" OR ""00wjc7c48"" OR ""057w15z03"" OR ""046ak2485"" OR ""013meh722"" OR ""01hcx6992"" OR ""02crff812"" OR ""04mhzgx49"" OR ""03vek6s52"" OR ""00za53h95"" OR ""03dbr7087"" OR ""00b30xv10"" OR ""043mz5j54"" OR ""00py81415"" OR ""00jmfr291"" OR ""00f54p054"" OR ""01ej9dk98"" OR ""0384j8v12"" OR ""036rp1748"")) AND publication_type:""journal article"" AND date_published>=now-10y AND field_of_study: ((""Medicine"" OR ""Internal medicine"" OR ""Pharmacology"") AND (""COPD"" OR ""Asthma"" OR ""Lung"" OR ""Idiopathic pulmonary fibrosis"" OR ""Respiratory system"" OR ""Spirometry"" OR ""Pulmonary disease"" OR ""Respiratory tract infections""))",AND date_published>=now-10y,"AND field_of_study: ((""Medicine"" OR ""Internal medicine"" OR ""Pharmacology"") AND (""COPD"" OR ""Asthma"" OR ""Lung"" OR ""Idiopathic pulmonary fibrosis"" OR ""Respiratory system"" OR ""Spirometry"" OR ""Pulmonary disease"" OR ""Respiratory tract infections""))",NA,oa_therapy_area,Uni,Respiratory,2021,4988,2130,511,542,200,291,3674,1314
respiratory (primary search + respiratory tags) - uni,"(author.affiliation.name:(""university of cape town"" OR ""south african college"" OR ""shanghai jiao tong university"" OR ""shanghai communications university"" OR ""fudan university"" OR ""sun yat-sen university"" OR ""zhejiang university"" OR ""chekiang university"" OR ""peking university"" OR ""imperial university of peking"" OR ""capital medical university"" OR ""cmu"" OR ""seoul national university"" OR ""seoul daehakgyo"" OR ""peking union medical college"" OR ""beijing xiehe hospital"" OR ""sichuan university"" OR ""sìchuān dàxué"" OR ""nanjing medical university"" OR ""national jiangsu medical college"" OR ""huazhong university of science and technology"" OR ""huázhōng kējì dàxué"" OR ""university college london"" OR ""london university"" OR ""karolinska institutet"" OR ""royal caroline institute"" OR ""university of oxford"" OR ""oxford university"" OR ""university of copenhagen"" OR ""universität kopenhagen"" OR ""université de paris"" OR ""university of paris"" OR ""king's college london"" OR ""kcl"" OR ""university of amsterdam"" OR ""universiteit van amsterdam"" OR ""imperial college london"" OR ""coleg imperial llundain"" OR ""utrecht university"" OR ""universiteit utrecht"" OR ""heidelberg university"" OR ""ruprecht-karls-universität heidelberg"" OR ""university of milan"" OR ""université de milan"" OR ""erasmus university rotterdam"" OR ""erasmus universiteit rotterdam"" OR ""freie universität berlin"" OR ""free university of berlin"" OR ""university of cambridge"" OR ""cambridge university"" OR ""humboldt-universität zu berlin"" OR ""humboldt university of berlin"" OR ""university of zurich"" OR ""universität zürich"" OR ""tel aviv university"" OR ""harvard university"" OR ""universidad de harvard"" OR ""johns hopkins university"" OR ""jhu"" OR ""university of toronto"" OR ""université de toronto"" OR ""university of pennsylvania"" Or ""upenn"" OR ""university of california, san francisco"" OR ""ucsf"" OR ""duke university"" OR ""Universidad de Duke"" OR ""university of michigan"" OR ""umich"" OR ""stanford university"" OR ""leland stanford junior university"" OR ""university of melbourne"" OR ""melbourne university"" OR ""university of sydney"" OR ""sydney university"" OR ""university of são paulo"" OR ""universidade de são paulo"") OR author.affiliation.ror_id_lineage:(""03p74gp79"" OR ""0220qvk04"" OR ""013q1eq08"" OR ""0064kty71"" OR ""00a2xv884"" OR ""02v51f717"" OR ""013xs5b60"" OR ""04h9pn542"" OR ""04jztag35"" OR ""011ashp19"" OR ""059gcgy73"" OR ""00p991c53"" OR ""02jx3x895"" OR ""056d84691"" OR ""052gg0110"" OR ""035b05819"" OR ""05f82e368"" OR ""0220mzb33"" OR ""04dkp9463"" OR ""041kmwe10"" OR ""04pp8hn57"" OR ""038t36y30"" OR ""00wjc7c48"" OR ""057w15z03"" OR ""046ak2485"" OR ""013meh722"" OR ""01hcx6992"" OR ""02crff812"" OR ""04mhzgx49"" OR ""03vek6s52"" OR ""00za53h95"" OR ""03dbr7087"" OR ""00b30xv10"" OR ""043mz5j54"" OR ""00py81415"" OR ""00jmfr291"" OR ""00f54p054"" OR ""01ej9dk98"" OR ""0384j8v12"" OR ""036rp1748"")) AND publication_type:""journal article"" AND date_published>=now-10y AND field_of_study: ((""Medicine"" OR ""Internal medicine"" OR ""Pharmacology"") AND (""COPD"" OR ""Asthma"" OR ""Lung"" OR ""Idiopathic pulmonary fibrosis"" OR ""Respiratory system"" OR ""Spirometry"" OR ""Pulmonary disease"" OR ""Respiratory tract infections""))",AND date_published>=now-10y,"AND field_of_study: ((""Medicine"" OR ""Internal medicine"" OR ""Pharmacology"") AND (""COPD"" OR ""Asthma"" OR ""Lung"" OR ""Idiopathic pulmonary fibrosis"" OR ""Respiratory system"" OR ""Spirometry"" OR ""Pulmonary disease"" OR ""Respiratory tract infections""))",NA,oa_therapy_area,Uni,Respiratory,2022,5176,2459,394,534,273,126,3786,1390
respiratory (primary search + respiratory tags) - uni,"(author.affiliation.name:(""university of cape town"" OR ""south african college"" OR ""shanghai jiao tong university"" OR ""shanghai communications university"" OR ""fudan university"" OR ""sun yat-sen university"" OR ""zhejiang university"" OR ""chekiang university"" OR ""peking university"" OR ""imperial university of peking"" OR ""capital medical university"" OR ""cmu"" OR ""seoul national university"" OR ""seoul daehakgyo"" OR ""peking union medical college"" OR ""beijing xiehe hospital"" OR ""sichuan university"" OR ""sìchuān dàxué"" OR ""nanjing medical university"" OR ""national jiangsu medical college"" OR ""huazhong university of science and technology"" OR ""huázhōng kējì dàxué"" OR ""university college london"" OR ""london university"" OR ""karolinska institutet"" OR ""royal caroline institute"" OR ""university of oxford"" OR ""oxford university"" OR ""university of copenhagen"" OR ""universität kopenhagen"" OR ""université de paris"" OR ""university of paris"" OR ""king's college london"" OR ""kcl"" OR ""university of amsterdam"" OR ""universiteit van amsterdam"" OR ""imperial college london"" OR ""coleg imperial llundain"" OR ""utrecht university"" OR ""universiteit utrecht"" OR ""heidelberg university"" OR ""ruprecht-karls-universität heidelberg"" OR ""university of milan"" OR ""université de milan"" OR ""erasmus university rotterdam"" OR ""erasmus universiteit rotterdam"" OR ""freie universität berlin"" OR ""free university of berlin"" OR ""university of cambridge"" OR ""cambridge university"" OR ""humboldt-universität zu berlin"" OR ""humboldt university of berlin"" OR ""university of zurich"" OR ""universität zürich"" OR ""tel aviv university"" OR ""harvard university"" OR ""universidad de harvard"" OR ""johns hopkins university"" OR ""jhu"" OR ""university of toronto"" OR ""université de toronto"" OR ""university of pennsylvania"" Or ""upenn"" OR ""university of california, san francisco"" OR ""ucsf"" OR ""duke university"" OR ""Universidad de Duke"" OR ""university of michigan"" OR ""umich"" OR ""stanford university"" OR ""leland stanford junior university"" OR ""university of melbourne"" OR ""melbourne university"" OR ""university of sydney"" OR ""sydney university"" OR ""university of são paulo"" OR ""universidade de são paulo"") OR author.affiliation.ror_id_lineage:(""03p74gp79"" OR ""0220qvk04"" OR ""013q1eq08"" OR ""0064kty71"" OR ""00a2xv884"" OR ""02v51f717"" OR ""013xs5b60"" OR ""04h9pn542"" OR ""04jztag35"" OR ""011ashp19"" OR ""059gcgy73"" OR ""00p991c53"" OR ""02jx3x895"" OR ""056d84691"" OR ""052gg0110"" OR ""035b05819"" OR ""05f82e368"" OR ""0220mzb33"" OR ""04dkp9463"" OR ""041kmwe10"" OR ""04pp8hn57"" OR ""038t36y30"" OR ""00wjc7c48"" OR ""057w15z03"" OR ""046ak2485"" OR ""013meh722"" OR ""01hcx6992"" OR ""02crff812"" OR ""04mhzgx49"" OR ""03vek6s52"" OR ""00za53h95"" OR ""03dbr7087"" OR ""00b30xv10"" OR ""043mz5j54"" OR ""00py81415"" OR ""00jmfr291"" OR ""00f54p054"" OR ""01ej9dk98"" OR ""0384j8v12"" OR ""036rp1748"")) AND publication_type:""journal article"" AND date_published>=now-10y AND field_of_study: ((""Medicine"" OR ""Internal medicine"" OR ""Pharmacology"") AND (""COPD"" OR ""Asthma"" OR ""Lung"" OR ""Idiopathic pulmonary fibrosis"" OR ""Respiratory system"" OR ""Spirometry"" OR ""Pulmonary disease"" OR ""Respiratory tract infections""))",AND date_published>=now-10y,"AND field_of_study: ((""Medicine"" OR ""Internal medicine"" OR ""Pharmacology"") AND (""COPD"" OR ""Asthma"" OR ""Lung"" OR ""Idiopathic pulmonary fibrosis"" OR ""Respiratory system"" OR ""Spirometry"" OR ""Pulmonary disease"" OR ""Respiratory tract infections""))",NA,oa_therapy_area,Uni,Respiratory,2023,1998,941,53,179,47,149,1369,629
genitourinary disorders (including nephrology)  (primary search + genitourinary tags) - uni,"(author.affiliation.name:(""university of cape town"" OR ""south african college"" OR ""shanghai jiao tong university"" OR ""shanghai communications university"" OR ""fudan university"" OR ""sun yat-sen university"" OR ""zhejiang university"" OR ""chekiang university"" OR ""peking university"" OR ""imperial university of peking"" OR ""capital medical university"" OR ""cmu"" OR ""seoul national university"" OR ""seoul daehakgyo"" OR ""peking union medical college"" OR ""beijing xiehe hospital"" OR ""sichuan university"" OR ""sìchuān dàxué"" OR ""nanjing medical university"" OR ""national jiangsu medical college"" OR ""huazhong university of science and technology"" OR ""huázhōng kējì dàxué"" OR ""university college london"" OR ""london university"" OR ""karolinska institutet"" OR ""royal caroline institute"" OR ""university of oxford"" OR ""oxford university"" OR ""university of copenhagen"" OR ""universität kopenhagen"" OR ""université de paris"" OR ""university of paris"" OR ""king's college london"" OR ""kcl"" OR ""university of amsterdam"" OR ""universiteit van amsterdam"" OR ""imperial college london"" OR ""coleg imperial llundain"" OR ""utrecht university"" OR ""universiteit utrecht"" OR ""heidelberg university"" OR ""ruprecht-karls-universität heidelberg"" OR ""university of milan"" OR ""université de milan"" OR ""erasmus university rotterdam"" OR ""erasmus universiteit rotterdam"" OR ""freie universität berlin"" OR ""free university of berlin"" OR ""university of cambridge"" OR ""cambridge university"" OR ""humboldt-universität zu berlin"" OR ""humboldt university of berlin"" OR ""university of zurich"" OR ""universität zürich"" OR ""tel aviv university"" OR ""harvard university"" OR ""universidad de harvard"" OR ""johns hopkins university"" OR ""jhu"" OR ""university of toronto"" OR ""université de toronto"" OR ""university of pennsylvania"" Or ""upenn"" OR ""university of california, san francisco"" OR ""ucsf"" OR ""duke university"" OR ""Universidad de Duke"" OR ""university of michigan"" OR ""umich"" OR ""stanford university"" OR ""leland stanford junior university"" OR ""university of melbourne"" OR ""melbourne university"" OR ""university of sydney"" OR ""sydney university"" OR ""university of são paulo"" OR ""universidade de são paulo"") OR author.affiliation.ror_id_lineage:(""03p74gp79"" OR ""0220qvk04"" OR ""013q1eq08"" OR ""0064kty71"" OR ""00a2xv884"" OR ""02v51f717"" OR ""013xs5b60"" OR ""04h9pn542"" OR ""04jztag35"" OR ""011ashp19"" OR ""059gcgy73"" OR ""00p991c53"" OR ""02jx3x895"" OR ""056d84691"" OR ""052gg0110"" OR ""035b05819"" OR ""05f82e368"" OR ""0220mzb33"" OR ""04dkp9463"" OR ""041kmwe10"" OR ""04pp8hn57"" OR ""038t36y30"" OR ""00wjc7c48"" OR ""057w15z03"" OR ""046ak2485"" OR ""013meh722"" OR ""01hcx6992"" OR ""02crff812"" OR ""04mhzgx49"" OR ""03vek6s52"" OR ""00za53h95"" OR ""03dbr7087"" OR ""00b30xv10"" OR ""043mz5j54"" OR ""00py81415"" OR ""00jmfr291"" OR ""00f54p054"" OR ""01ej9dk98"" OR ""0384j8v12"" OR ""036rp1748"")) AND publication_type:""journal article"" AND date_published>=now-10y AND field_of_study: ((""Medicine"" OR ""Internal medicine"" OR ""Pharmacology"") AND (""Urology"" OR ""Renal function"" OR ""Kidney disease"" OR ""Kidney"" OR ""Urinary system"" OR ""Urine"" OR ""End stage renal disease"" OR ""Acute kidney injury""))",AND date_published>=now-10y,"AND field_of_study: ((""Medicine"" OR ""Internal medicine"" OR ""Pharmacology"") AND (""Urology"" OR ""Renal function"" OR ""Kidney disease"" OR ""Kidney"" OR ""Urinary system"" OR ""Urine"" OR ""End stage renal disease"" OR ""Acute kidney injury""))",NA,oa_therapy_area,Uni,Genitourinary disorders,2013,1139,211,232,43,92,22,600,539
genitourinary disorders (including nephrology)  (primary search + genitourinary tags) - uni,"(author.affiliation.name:(""university of cape town"" OR ""south african college"" OR ""shanghai jiao tong university"" OR ""shanghai communications university"" OR ""fudan university"" OR ""sun yat-sen university"" OR ""zhejiang university"" OR ""chekiang university"" OR ""peking university"" OR ""imperial university of peking"" OR ""capital medical university"" OR ""cmu"" OR ""seoul national university"" OR ""seoul daehakgyo"" OR ""peking union medical college"" OR ""beijing xiehe hospital"" OR ""sichuan university"" OR ""sìchuān dàxué"" OR ""nanjing medical university"" OR ""national jiangsu medical college"" OR ""huazhong university of science and technology"" OR ""huázhōng kējì dàxué"" OR ""university college london"" OR ""london university"" OR ""karolinska institutet"" OR ""royal caroline institute"" OR ""university of oxford"" OR ""oxford university"" OR ""university of copenhagen"" OR ""universität kopenhagen"" OR ""université de paris"" OR ""university of paris"" OR ""king's college london"" OR ""kcl"" OR ""university of amsterdam"" OR ""universiteit van amsterdam"" OR ""imperial college london"" OR ""coleg imperial llundain"" OR ""utrecht university"" OR ""universiteit utrecht"" OR ""heidelberg university"" OR ""ruprecht-karls-universität heidelberg"" OR ""university of milan"" OR ""université de milan"" OR ""erasmus university rotterdam"" OR ""erasmus universiteit rotterdam"" OR ""freie universität berlin"" OR ""free university of berlin"" OR ""university of cambridge"" OR ""cambridge university"" OR ""humboldt-universität zu berlin"" OR ""humboldt university of berlin"" OR ""university of zurich"" OR ""universität zürich"" OR ""tel aviv university"" OR ""harvard university"" OR ""universidad de harvard"" OR ""johns hopkins university"" OR ""jhu"" OR ""university of toronto"" OR ""université de toronto"" OR ""university of pennsylvania"" Or ""upenn"" OR ""university of california, san francisco"" OR ""ucsf"" OR ""duke university"" OR ""Universidad de Duke"" OR ""university of michigan"" OR ""umich"" OR ""stanford university"" OR ""leland stanford junior university"" OR ""university of melbourne"" OR ""melbourne university"" OR ""university of sydney"" OR ""sydney university"" OR ""university of são paulo"" OR ""universidade de são paulo"") OR author.affiliation.ror_id_lineage:(""03p74gp79"" OR ""0220qvk04"" OR ""013q1eq08"" OR ""0064kty71"" OR ""00a2xv884"" OR ""02v51f717"" OR ""013xs5b60"" OR ""04h9pn542"" OR ""04jztag35"" OR ""011ashp19"" OR ""059gcgy73"" OR ""00p991c53"" OR ""02jx3x895"" OR ""056d84691"" OR ""052gg0110"" OR ""035b05819"" OR ""05f82e368"" OR ""0220mzb33"" OR ""04dkp9463"" OR ""041kmwe10"" OR ""04pp8hn57"" OR ""038t36y30"" OR ""00wjc7c48"" OR ""057w15z03"" OR ""046ak2485"" OR ""013meh722"" OR ""01hcx6992"" OR ""02crff812"" OR ""04mhzgx49"" OR ""03vek6s52"" OR ""00za53h95"" OR ""03dbr7087"" OR ""00b30xv10"" OR ""043mz5j54"" OR ""00py81415"" OR ""00jmfr291"" OR ""00f54p054"" OR ""01ej9dk98"" OR ""0384j8v12"" OR ""036rp1748"")) AND publication_type:""journal article"" AND date_published>=now-10y AND field_of_study: ((""Medicine"" OR ""Internal medicine"" OR ""Pharmacology"") AND (""Urology"" OR ""Renal function"" OR ""Kidney disease"" OR ""Kidney"" OR ""Urinary system"" OR ""Urine"" OR ""End stage renal disease"" OR ""Acute kidney injury""))",AND date_published>=now-10y,"AND field_of_study: ((""Medicine"" OR ""Internal medicine"" OR ""Pharmacology"") AND (""Urology"" OR ""Renal function"" OR ""Kidney disease"" OR ""Kidney"" OR ""Urinary system"" OR ""Urine"" OR ""End stage renal disease"" OR ""Acute kidney injury""))",NA,oa_therapy_area,Uni,Genitourinary disorders,2014,3059,653,596,126,225,76,1676,1383
genitourinary disorders (including nephrology)  (primary search + genitourinary tags) - uni,"(author.affiliation.name:(""university of cape town"" OR ""south african college"" OR ""shanghai jiao tong university"" OR ""shanghai communications university"" OR ""fudan university"" OR ""sun yat-sen university"" OR ""zhejiang university"" OR ""chekiang university"" OR ""peking university"" OR ""imperial university of peking"" OR ""capital medical university"" OR ""cmu"" OR ""seoul national university"" OR ""seoul daehakgyo"" OR ""peking union medical college"" OR ""beijing xiehe hospital"" OR ""sichuan university"" OR ""sìchuān dàxué"" OR ""nanjing medical university"" OR ""national jiangsu medical college"" OR ""huazhong university of science and technology"" OR ""huázhōng kējì dàxué"" OR ""university college london"" OR ""london university"" OR ""karolinska institutet"" OR ""royal caroline institute"" OR ""university of oxford"" OR ""oxford university"" OR ""university of copenhagen"" OR ""universität kopenhagen"" OR ""université de paris"" OR ""university of paris"" OR ""king's college london"" OR ""kcl"" OR ""university of amsterdam"" OR ""universiteit van amsterdam"" OR ""imperial college london"" OR ""coleg imperial llundain"" OR ""utrecht university"" OR ""universiteit utrecht"" OR ""heidelberg university"" OR ""ruprecht-karls-universität heidelberg"" OR ""university of milan"" OR ""université de milan"" OR ""erasmus university rotterdam"" OR ""erasmus universiteit rotterdam"" OR ""freie universität berlin"" OR ""free university of berlin"" OR ""university of cambridge"" OR ""cambridge university"" OR ""humboldt-universität zu berlin"" OR ""humboldt university of berlin"" OR ""university of zurich"" OR ""universität zürich"" OR ""tel aviv university"" OR ""harvard university"" OR ""universidad de harvard"" OR ""johns hopkins university"" OR ""jhu"" OR ""university of toronto"" OR ""université de toronto"" OR ""university of pennsylvania"" Or ""upenn"" OR ""university of california, san francisco"" OR ""ucsf"" OR ""duke university"" OR ""Universidad de Duke"" OR ""university of michigan"" OR ""umich"" OR ""stanford university"" OR ""leland stanford junior university"" OR ""university of melbourne"" OR ""melbourne university"" OR ""university of sydney"" OR ""sydney university"" OR ""university of são paulo"" OR ""universidade de são paulo"") OR author.affiliation.ror_id_lineage:(""03p74gp79"" OR ""0220qvk04"" OR ""013q1eq08"" OR ""0064kty71"" OR ""00a2xv884"" OR ""02v51f717"" OR ""013xs5b60"" OR ""04h9pn542"" OR ""04jztag35"" OR ""011ashp19"" OR ""059gcgy73"" OR ""00p991c53"" OR ""02jx3x895"" OR ""056d84691"" OR ""052gg0110"" OR ""035b05819"" OR ""05f82e368"" OR ""0220mzb33"" OR ""04dkp9463"" OR ""041kmwe10"" OR ""04pp8hn57"" OR ""038t36y30"" OR ""00wjc7c48"" OR ""057w15z03"" OR ""046ak2485"" OR ""013meh722"" OR ""01hcx6992"" OR ""02crff812"" OR ""04mhzgx49"" OR ""03vek6s52"" OR ""00za53h95"" OR ""03dbr7087"" OR ""00b30xv10"" OR ""043mz5j54"" OR ""00py81415"" OR ""00jmfr291"" OR ""00f54p054"" OR ""01ej9dk98"" OR ""0384j8v12"" OR ""036rp1748"")) AND publication_type:""journal article"" AND date_published>=now-10y AND field_of_study: ((""Medicine"" OR ""Internal medicine"" OR ""Pharmacology"") AND (""Urology"" OR ""Renal function"" OR ""Kidney disease"" OR ""Kidney"" OR ""Urinary system"" OR ""Urine"" OR ""End stage renal disease"" OR ""Acute kidney injury""))",AND date_published>=now-10y,"AND field_of_study: ((""Medicine"" OR ""Internal medicine"" OR ""Pharmacology"") AND (""Urology"" OR ""Renal function"" OR ""Kidney disease"" OR ""Kidney"" OR ""Urinary system"" OR ""Urine"" OR ""End stage renal disease"" OR ""Acute kidney injury""))",NA,oa_therapy_area,Uni,Genitourinary disorders,2015,3400,825,660,130,293,97,2005,1395
genitourinary disorders (including nephrology)  (primary search + genitourinary tags) - uni,"(author.affiliation.name:(""university of cape town"" OR ""south african college"" OR ""shanghai jiao tong university"" OR ""shanghai communications university"" OR ""fudan university"" OR ""sun yat-sen university"" OR ""zhejiang university"" OR ""chekiang university"" OR ""peking university"" OR ""imperial university of peking"" OR ""capital medical university"" OR ""cmu"" OR ""seoul national university"" OR ""seoul daehakgyo"" OR ""peking union medical college"" OR ""beijing xiehe hospital"" OR ""sichuan university"" OR ""sìchuān dàxué"" OR ""nanjing medical university"" OR ""national jiangsu medical college"" OR ""huazhong university of science and technology"" OR ""huázhōng kējì dàxué"" OR ""university college london"" OR ""london university"" OR ""karolinska institutet"" OR ""royal caroline institute"" OR ""university of oxford"" OR ""oxford university"" OR ""university of copenhagen"" OR ""universität kopenhagen"" OR ""université de paris"" OR ""university of paris"" OR ""king's college london"" OR ""kcl"" OR ""university of amsterdam"" OR ""universiteit van amsterdam"" OR ""imperial college london"" OR ""coleg imperial llundain"" OR ""utrecht university"" OR ""universiteit utrecht"" OR ""heidelberg university"" OR ""ruprecht-karls-universität heidelberg"" OR ""university of milan"" OR ""université de milan"" OR ""erasmus university rotterdam"" OR ""erasmus universiteit rotterdam"" OR ""freie universität berlin"" OR ""free university of berlin"" OR ""university of cambridge"" OR ""cambridge university"" OR ""humboldt-universität zu berlin"" OR ""humboldt university of berlin"" OR ""university of zurich"" OR ""universität zürich"" OR ""tel aviv university"" OR ""harvard university"" OR ""universidad de harvard"" OR ""johns hopkins university"" OR ""jhu"" OR ""university of toronto"" OR ""université de toronto"" OR ""university of pennsylvania"" Or ""upenn"" OR ""university of california, san francisco"" OR ""ucsf"" OR ""duke university"" OR ""Universidad de Duke"" OR ""university of michigan"" OR ""umich"" OR ""stanford university"" OR ""leland stanford junior university"" OR ""university of melbourne"" OR ""melbourne university"" OR ""university of sydney"" OR ""sydney university"" OR ""university of são paulo"" OR ""universidade de são paulo"") OR author.affiliation.ror_id_lineage:(""03p74gp79"" OR ""0220qvk04"" OR ""013q1eq08"" OR ""0064kty71"" OR ""00a2xv884"" OR ""02v51f717"" OR ""013xs5b60"" OR ""04h9pn542"" OR ""04jztag35"" OR ""011ashp19"" OR ""059gcgy73"" OR ""00p991c53"" OR ""02jx3x895"" OR ""056d84691"" OR ""052gg0110"" OR ""035b05819"" OR ""05f82e368"" OR ""0220mzb33"" OR ""04dkp9463"" OR ""041kmwe10"" OR ""04pp8hn57"" OR ""038t36y30"" OR ""00wjc7c48"" OR ""057w15z03"" OR ""046ak2485"" OR ""013meh722"" OR ""01hcx6992"" OR ""02crff812"" OR ""04mhzgx49"" OR ""03vek6s52"" OR ""00za53h95"" OR ""03dbr7087"" OR ""00b30xv10"" OR ""043mz5j54"" OR ""00py81415"" OR ""00jmfr291"" OR ""00f54p054"" OR ""01ej9dk98"" OR ""0384j8v12"" OR ""036rp1748"")) AND publication_type:""journal article"" AND date_published>=now-10y AND field_of_study: ((""Medicine"" OR ""Internal medicine"" OR ""Pharmacology"") AND (""Urology"" OR ""Renal function"" OR ""Kidney disease"" OR ""Kidney"" OR ""Urinary system"" OR ""Urine"" OR ""End stage renal disease"" OR ""Acute kidney injury""))",AND date_published>=now-10y,"AND field_of_study: ((""Medicine"" OR ""Internal medicine"" OR ""Pharmacology"") AND (""Urology"" OR ""Renal function"" OR ""Kidney disease"" OR ""Kidney"" OR ""Urinary system"" OR ""Urine"" OR ""End stage renal disease"" OR ""Acute kidney injury""))",NA,oa_therapy_area,Uni,Genitourinary disorders,2016,3645,843,769,162,239,63,2076,1569
genitourinary disorders (including nephrology)  (primary search + genitourinary tags) - uni,"(author.affiliation.name:(""university of cape town"" OR ""south african college"" OR ""shanghai jiao tong university"" OR ""shanghai communications university"" OR ""fudan university"" OR ""sun yat-sen university"" OR ""zhejiang university"" OR ""chekiang university"" OR ""peking university"" OR ""imperial university of peking"" OR ""capital medical university"" OR ""cmu"" OR ""seoul national university"" OR ""seoul daehakgyo"" OR ""peking union medical college"" OR ""beijing xiehe hospital"" OR ""sichuan university"" OR ""sìchuān dàxué"" OR ""nanjing medical university"" OR ""national jiangsu medical college"" OR ""huazhong university of science and technology"" OR ""huázhōng kējì dàxué"" OR ""university college london"" OR ""london university"" OR ""karolinska institutet"" OR ""royal caroline institute"" OR ""university of oxford"" OR ""oxford university"" OR ""university of copenhagen"" OR ""universität kopenhagen"" OR ""université de paris"" OR ""university of paris"" OR ""king's college london"" OR ""kcl"" OR ""university of amsterdam"" OR ""universiteit van amsterdam"" OR ""imperial college london"" OR ""coleg imperial llundain"" OR ""utrecht university"" OR ""universiteit utrecht"" OR ""heidelberg university"" OR ""ruprecht-karls-universität heidelberg"" OR ""university of milan"" OR ""université de milan"" OR ""erasmus university rotterdam"" OR ""erasmus universiteit rotterdam"" OR ""freie universität berlin"" OR ""free university of berlin"" OR ""university of cambridge"" OR ""cambridge university"" OR ""humboldt-universität zu berlin"" OR ""humboldt university of berlin"" OR ""university of zurich"" OR ""universität zürich"" OR ""tel aviv university"" OR ""harvard university"" OR ""universidad de harvard"" OR ""johns hopkins university"" OR ""jhu"" OR ""university of toronto"" OR ""université de toronto"" OR ""university of pennsylvania"" Or ""upenn"" OR ""university of california, san francisco"" OR ""ucsf"" OR ""duke university"" OR ""Universidad de Duke"" OR ""university of michigan"" OR ""umich"" OR ""stanford university"" OR ""leland stanford junior university"" OR ""university of melbourne"" OR ""melbourne university"" OR ""university of sydney"" OR ""sydney university"" OR ""university of são paulo"" OR ""universidade de são paulo"") OR author.affiliation.ror_id_lineage:(""03p74gp79"" OR ""0220qvk04"" OR ""013q1eq08"" OR ""0064kty71"" OR ""00a2xv884"" OR ""02v51f717"" OR ""013xs5b60"" OR ""04h9pn542"" OR ""04jztag35"" OR ""011ashp19"" OR ""059gcgy73"" OR ""00p991c53"" OR ""02jx3x895"" OR ""056d84691"" OR ""052gg0110"" OR ""035b05819"" OR ""05f82e368"" OR ""0220mzb33"" OR ""04dkp9463"" OR ""041kmwe10"" OR ""04pp8hn57"" OR ""038t36y30"" OR ""00wjc7c48"" OR ""057w15z03"" OR ""046ak2485"" OR ""013meh722"" OR ""01hcx6992"" OR ""02crff812"" OR ""04mhzgx49"" OR ""03vek6s52"" OR ""00za53h95"" OR ""03dbr7087"" OR ""00b30xv10"" OR ""043mz5j54"" OR ""00py81415"" OR ""00jmfr291"" OR ""00f54p054"" OR ""01ej9dk98"" OR ""0384j8v12"" OR ""036rp1748"")) AND publication_type:""journal article"" AND date_published>=now-10y AND field_of_study: ((""Medicine"" OR ""Internal medicine"" OR ""Pharmacology"") AND (""Urology"" OR ""Renal function"" OR ""Kidney disease"" OR ""Kidney"" OR ""Urinary system"" OR ""Urine"" OR ""End stage renal disease"" OR ""Acute kidney injury""))",AND date_published>=now-10y,"AND field_of_study: ((""Medicine"" OR ""Internal medicine"" OR ""Pharmacology"") AND (""Urology"" OR ""Renal function"" OR ""Kidney disease"" OR ""Kidney"" OR ""Urinary system"" OR ""Urine"" OR ""End stage renal disease"" OR ""Acute kidney injury""))",NA,oa_therapy_area,Uni,Genitourinary disorders,2017,3974,1068,819,185,327,60,2459,1515
genitourinary disorders (including nephrology)  (primary search + genitourinary tags) - uni,"(author.affiliation.name:(""university of cape town"" OR ""south african college"" OR ""shanghai jiao tong university"" OR ""shanghai communications university"" OR ""fudan university"" OR ""sun yat-sen university"" OR ""zhejiang university"" OR ""chekiang university"" OR ""peking university"" OR ""imperial university of peking"" OR ""capital medical university"" OR ""cmu"" OR ""seoul national university"" OR ""seoul daehakgyo"" OR ""peking union medical college"" OR ""beijing xiehe hospital"" OR ""sichuan university"" OR ""sìchuān dàxué"" OR ""nanjing medical university"" OR ""national jiangsu medical college"" OR ""huazhong university of science and technology"" OR ""huázhōng kējì dàxué"" OR ""university college london"" OR ""london university"" OR ""karolinska institutet"" OR ""royal caroline institute"" OR ""university of oxford"" OR ""oxford university"" OR ""university of copenhagen"" OR ""universität kopenhagen"" OR ""université de paris"" OR ""university of paris"" OR ""king's college london"" OR ""kcl"" OR ""university of amsterdam"" OR ""universiteit van amsterdam"" OR ""imperial college london"" OR ""coleg imperial llundain"" OR ""utrecht university"" OR ""universiteit utrecht"" OR ""heidelberg university"" OR ""ruprecht-karls-universität heidelberg"" OR ""university of milan"" OR ""université de milan"" OR ""erasmus university rotterdam"" OR ""erasmus universiteit rotterdam"" OR ""freie universität berlin"" OR ""free university of berlin"" OR ""university of cambridge"" OR ""cambridge university"" OR ""humboldt-universität zu berlin"" OR ""humboldt university of berlin"" OR ""university of zurich"" OR ""universität zürich"" OR ""tel aviv university"" OR ""harvard university"" OR ""universidad de harvard"" OR ""johns hopkins university"" OR ""jhu"" OR ""university of toronto"" OR ""université de toronto"" OR ""university of pennsylvania"" Or ""upenn"" OR ""university of california, san francisco"" OR ""ucsf"" OR ""duke university"" OR ""Universidad de Duke"" OR ""university of michigan"" OR ""umich"" OR ""stanford university"" OR ""leland stanford junior university"" OR ""university of melbourne"" OR ""melbourne university"" OR ""university of sydney"" OR ""sydney university"" OR ""university of são paulo"" OR ""universidade de são paulo"") OR author.affiliation.ror_id_lineage:(""03p74gp79"" OR ""0220qvk04"" OR ""013q1eq08"" OR ""0064kty71"" OR ""00a2xv884"" OR ""02v51f717"" OR ""013xs5b60"" OR ""04h9pn542"" OR ""04jztag35"" OR ""011ashp19"" OR ""059gcgy73"" OR ""00p991c53"" OR ""02jx3x895"" OR ""056d84691"" OR ""052gg0110"" OR ""035b05819"" OR ""05f82e368"" OR ""0220mzb33"" OR ""04dkp9463"" OR ""041kmwe10"" OR ""04pp8hn57"" OR ""038t36y30"" OR ""00wjc7c48"" OR ""057w15z03"" OR ""046ak2485"" OR ""013meh722"" OR ""01hcx6992"" OR ""02crff812"" OR ""04mhzgx49"" OR ""03vek6s52"" OR ""00za53h95"" OR ""03dbr7087"" OR ""00b30xv10"" OR ""043mz5j54"" OR ""00py81415"" OR ""00jmfr291"" OR ""00f54p054"" OR ""01ej9dk98"" OR ""0384j8v12"" OR ""036rp1748"")) AND publication_type:""journal article"" AND date_published>=now-10y AND field_of_study: ((""Medicine"" OR ""Internal medicine"" OR ""Pharmacology"") AND (""Urology"" OR ""Renal function"" OR ""Kidney disease"" OR ""Kidney"" OR ""Urinary system"" OR ""Urine"" OR ""End stage renal disease"" OR ""Acute kidney injury""))",AND date_published>=now-10y,"AND field_of_study: ((""Medicine"" OR ""Internal medicine"" OR ""Pharmacology"") AND (""Urology"" OR ""Renal function"" OR ""Kidney disease"" OR ""Kidney"" OR ""Urinary system"" OR ""Urine"" OR ""End stage renal disease"" OR ""Acute kidney injury""))",NA,oa_therapy_area,Uni,Genitourinary disorders,2018,4176,1183,834,269,337,58,2681,1495
genitourinary disorders (including nephrology)  (primary search + genitourinary tags) - uni,"(author.affiliation.name:(""university of cape town"" OR ""south african college"" OR ""shanghai jiao tong university"" OR ""shanghai communications university"" OR ""fudan university"" OR ""sun yat-sen university"" OR ""zhejiang university"" OR ""chekiang university"" OR ""peking university"" OR ""imperial university of peking"" OR ""capital medical university"" OR ""cmu"" OR ""seoul national university"" OR ""seoul daehakgyo"" OR ""peking union medical college"" OR ""beijing xiehe hospital"" OR ""sichuan university"" OR ""sìchuān dàxué"" OR ""nanjing medical university"" OR ""national jiangsu medical college"" OR ""huazhong university of science and technology"" OR ""huázhōng kējì dàxué"" OR ""university college london"" OR ""london university"" OR ""karolinska institutet"" OR ""royal caroline institute"" OR ""university of oxford"" OR ""oxford university"" OR ""university of copenhagen"" OR ""universität kopenhagen"" OR ""université de paris"" OR ""university of paris"" OR ""king's college london"" OR ""kcl"" OR ""university of amsterdam"" OR ""universiteit van amsterdam"" OR ""imperial college london"" OR ""coleg imperial llundain"" OR ""utrecht university"" OR ""universiteit utrecht"" OR ""heidelberg university"" OR ""ruprecht-karls-universität heidelberg"" OR ""university of milan"" OR ""université de milan"" OR ""erasmus university rotterdam"" OR ""erasmus universiteit rotterdam"" OR ""freie universität berlin"" OR ""free university of berlin"" OR ""university of cambridge"" OR ""cambridge university"" OR ""humboldt-universität zu berlin"" OR ""humboldt university of berlin"" OR ""university of zurich"" OR ""universität zürich"" OR ""tel aviv university"" OR ""harvard university"" OR ""universidad de harvard"" OR ""johns hopkins university"" OR ""jhu"" OR ""university of toronto"" OR ""université de toronto"" OR ""university of pennsylvania"" Or ""upenn"" OR ""university of california, san francisco"" OR ""ucsf"" OR ""duke university"" OR ""Universidad de Duke"" OR ""university of michigan"" OR ""umich"" OR ""stanford university"" OR ""leland stanford junior university"" OR ""university of melbourne"" OR ""melbourne university"" OR ""university of sydney"" OR ""sydney university"" OR ""university of são paulo"" OR ""universidade de são paulo"") OR author.affiliation.ror_id_lineage:(""03p74gp79"" OR ""0220qvk04"" OR ""013q1eq08"" OR ""0064kty71"" OR ""00a2xv884"" OR ""02v51f717"" OR ""013xs5b60"" OR ""04h9pn542"" OR ""04jztag35"" OR ""011ashp19"" OR ""059gcgy73"" OR ""00p991c53"" OR ""02jx3x895"" OR ""056d84691"" OR ""052gg0110"" OR ""035b05819"" OR ""05f82e368"" OR ""0220mzb33"" OR ""04dkp9463"" OR ""041kmwe10"" OR ""04pp8hn57"" OR ""038t36y30"" OR ""00wjc7c48"" OR ""057w15z03"" OR ""046ak2485"" OR ""013meh722"" OR ""01hcx6992"" OR ""02crff812"" OR ""04mhzgx49"" OR ""03vek6s52"" OR ""00za53h95"" OR ""03dbr7087"" OR ""00b30xv10"" OR ""043mz5j54"" OR ""00py81415"" OR ""00jmfr291"" OR ""00f54p054"" OR ""01ej9dk98"" OR ""0384j8v12"" OR ""036rp1748"")) AND publication_type:""journal article"" AND date_published>=now-10y AND field_of_study: ((""Medicine"" OR ""Internal medicine"" OR ""Pharmacology"") AND (""Urology"" OR ""Renal function"" OR ""Kidney disease"" OR ""Kidney"" OR ""Urinary system"" OR ""Urine"" OR ""End stage renal disease"" OR ""Acute kidney injury""))",AND date_published>=now-10y,"AND field_of_study: ((""Medicine"" OR ""Internal medicine"" OR ""Pharmacology"") AND (""Urology"" OR ""Renal function"" OR ""Kidney disease"" OR ""Kidney"" OR ""Urinary system"" OR ""Urine"" OR ""End stage renal disease"" OR ""Acute kidney injury""))",NA,oa_therapy_area,Uni,Genitourinary disorders,2019,4814,1499,865,318,287,78,3047,1767
genitourinary disorders (including nephrology)  (primary search + genitourinary tags) - uni,"(author.affiliation.name:(""university of cape town"" OR ""south african college"" OR ""shanghai jiao tong university"" OR ""shanghai communications university"" OR ""fudan university"" OR ""sun yat-sen university"" OR ""zhejiang university"" OR ""chekiang university"" OR ""peking university"" OR ""imperial university of peking"" OR ""capital medical university"" OR ""cmu"" OR ""seoul national university"" OR ""seoul daehakgyo"" OR ""peking union medical college"" OR ""beijing xiehe hospital"" OR ""sichuan university"" OR ""sìchuān dàxué"" OR ""nanjing medical university"" OR ""national jiangsu medical college"" OR ""huazhong university of science and technology"" OR ""huázhōng kējì dàxué"" OR ""university college london"" OR ""london university"" OR ""karolinska institutet"" OR ""royal caroline institute"" OR ""university of oxford"" OR ""oxford university"" OR ""university of copenhagen"" OR ""universität kopenhagen"" OR ""université de paris"" OR ""university of paris"" OR ""king's college london"" OR ""kcl"" OR ""university of amsterdam"" OR ""universiteit van amsterdam"" OR ""imperial college london"" OR ""coleg imperial llundain"" OR ""utrecht university"" OR ""universiteit utrecht"" OR ""heidelberg university"" OR ""ruprecht-karls-universität heidelberg"" OR ""university of milan"" OR ""université de milan"" OR ""erasmus university rotterdam"" OR ""erasmus universiteit rotterdam"" OR ""freie universität berlin"" OR ""free university of berlin"" OR ""university of cambridge"" OR ""cambridge university"" OR ""humboldt-universität zu berlin"" OR ""humboldt university of berlin"" OR ""university of zurich"" OR ""universität zürich"" OR ""tel aviv university"" OR ""harvard university"" OR ""universidad de harvard"" OR ""johns hopkins university"" OR ""jhu"" OR ""university of toronto"" OR ""université de toronto"" OR ""university of pennsylvania"" Or ""upenn"" OR ""university of california, san francisco"" OR ""ucsf"" OR ""duke university"" OR ""Universidad de Duke"" OR ""university of michigan"" OR ""umich"" OR ""stanford university"" OR ""leland stanford junior university"" OR ""university of melbourne"" OR ""melbourne university"" OR ""university of sydney"" OR ""sydney university"" OR ""university of são paulo"" OR ""universidade de são paulo"") OR author.affiliation.ror_id_lineage:(""03p74gp79"" OR ""0220qvk04"" OR ""013q1eq08"" OR ""0064kty71"" OR ""00a2xv884"" OR ""02v51f717"" OR ""013xs5b60"" OR ""04h9pn542"" OR ""04jztag35"" OR ""011ashp19"" OR ""059gcgy73"" OR ""00p991c53"" OR ""02jx3x895"" OR ""056d84691"" OR ""052gg0110"" OR ""035b05819"" OR ""05f82e368"" OR ""0220mzb33"" OR ""04dkp9463"" OR ""041kmwe10"" OR ""04pp8hn57"" OR ""038t36y30"" OR ""00wjc7c48"" OR ""057w15z03"" OR ""046ak2485"" OR ""013meh722"" OR ""01hcx6992"" OR ""02crff812"" OR ""04mhzgx49"" OR ""03vek6s52"" OR ""00za53h95"" OR ""03dbr7087"" OR ""00b30xv10"" OR ""043mz5j54"" OR ""00py81415"" OR ""00jmfr291"" OR ""00f54p054"" OR ""01ej9dk98"" OR ""0384j8v12"" OR ""036rp1748"")) AND publication_type:""journal article"" AND date_published>=now-10y AND field_of_study: ((""Medicine"" OR ""Internal medicine"" OR ""Pharmacology"") AND (""Urology"" OR ""Renal function"" OR ""Kidney disease"" OR ""Kidney"" OR ""Urinary system"" OR ""Urine"" OR ""End stage renal disease"" OR ""Acute kidney injury""))",AND date_published>=now-10y,"AND field_of_study: ((""Medicine"" OR ""Internal medicine"" OR ""Pharmacology"") AND (""Urology"" OR ""Renal function"" OR ""Kidney disease"" OR ""Kidney"" OR ""Urinary system"" OR ""Urine"" OR ""End stage renal disease"" OR ""Acute kidney injury""))",NA,oa_therapy_area,Uni,Genitourinary disorders,2020,5812,2001,908,516,347,95,3867,1945
genitourinary disorders (including nephrology)  (primary search + genitourinary tags) - uni,"(author.affiliation.name:(""university of cape town"" OR ""south african college"" OR ""shanghai jiao tong university"" OR ""shanghai communications university"" OR ""fudan university"" OR ""sun yat-sen university"" OR ""zhejiang university"" OR ""chekiang university"" OR ""peking university"" OR ""imperial university of peking"" OR ""capital medical university"" OR ""cmu"" OR ""seoul national university"" OR ""seoul daehakgyo"" OR ""peking union medical college"" OR ""beijing xiehe hospital"" OR ""sichuan university"" OR ""sìchuān dàxué"" OR ""nanjing medical university"" OR ""national jiangsu medical college"" OR ""huazhong university of science and technology"" OR ""huázhōng kējì dàxué"" OR ""university college london"" OR ""london university"" OR ""karolinska institutet"" OR ""royal caroline institute"" OR ""university of oxford"" OR ""oxford university"" OR ""university of copenhagen"" OR ""universität kopenhagen"" OR ""université de paris"" OR ""university of paris"" OR ""king's college london"" OR ""kcl"" OR ""university of amsterdam"" OR ""universiteit van amsterdam"" OR ""imperial college london"" OR ""coleg imperial llundain"" OR ""utrecht university"" OR ""universiteit utrecht"" OR ""heidelberg university"" OR ""ruprecht-karls-universität heidelberg"" OR ""university of milan"" OR ""université de milan"" OR ""erasmus university rotterdam"" OR ""erasmus universiteit rotterdam"" OR ""freie universität berlin"" OR ""free university of berlin"" OR ""university of cambridge"" OR ""cambridge university"" OR ""humboldt-universität zu berlin"" OR ""humboldt university of berlin"" OR ""university of zurich"" OR ""universität zürich"" OR ""tel aviv university"" OR ""harvard university"" OR ""universidad de harvard"" OR ""johns hopkins university"" OR ""jhu"" OR ""university of toronto"" OR ""université de toronto"" OR ""university of pennsylvania"" Or ""upenn"" OR ""university of california, san francisco"" OR ""ucsf"" OR ""duke university"" OR ""Universidad de Duke"" OR ""university of michigan"" OR ""umich"" OR ""stanford university"" OR ""leland stanford junior university"" OR ""university of melbourne"" OR ""melbourne university"" OR ""university of sydney"" OR ""sydney university"" OR ""university of são paulo"" OR ""universidade de são paulo"") OR author.affiliation.ror_id_lineage:(""03p74gp79"" OR ""0220qvk04"" OR ""013q1eq08"" OR ""0064kty71"" OR ""00a2xv884"" OR ""02v51f717"" OR ""013xs5b60"" OR ""04h9pn542"" OR ""04jztag35"" OR ""011ashp19"" OR ""059gcgy73"" OR ""00p991c53"" OR ""02jx3x895"" OR ""056d84691"" OR ""052gg0110"" OR ""035b05819"" OR ""05f82e368"" OR ""0220mzb33"" OR ""04dkp9463"" OR ""041kmwe10"" OR ""04pp8hn57"" OR ""038t36y30"" OR ""00wjc7c48"" OR ""057w15z03"" OR ""046ak2485"" OR ""013meh722"" OR ""01hcx6992"" OR ""02crff812"" OR ""04mhzgx49"" OR ""03vek6s52"" OR ""00za53h95"" OR ""03dbr7087"" OR ""00b30xv10"" OR ""043mz5j54"" OR ""00py81415"" OR ""00jmfr291"" OR ""00f54p054"" OR ""01ej9dk98"" OR ""0384j8v12"" OR ""036rp1748"")) AND publication_type:""journal article"" AND date_published>=now-10y AND field_of_study: ((""Medicine"" OR ""Internal medicine"" OR ""Pharmacology"") AND (""Urology"" OR ""Renal function"" OR ""Kidney disease"" OR ""Kidney"" OR ""Urinary system"" OR ""Urine"" OR ""End stage renal disease"" OR ""Acute kidney injury""))",AND date_published>=now-10y,"AND field_of_study: ((""Medicine"" OR ""Internal medicine"" OR ""Pharmacology"") AND (""Urology"" OR ""Renal function"" OR ""Kidney disease"" OR ""Kidney"" OR ""Urinary system"" OR ""Urine"" OR ""End stage renal disease"" OR ""Acute kidney injury""))",NA,oa_therapy_area,Uni,Genitourinary disorders,2021,6086,2498,403,612,284,349,4146,1940
genitourinary disorders (including nephrology)  (primary search + genitourinary tags) - uni,"(author.affiliation.name:(""university of cape town"" OR ""south african college"" OR ""shanghai jiao tong university"" OR ""shanghai communications university"" OR ""fudan university"" OR ""sun yat-sen university"" OR ""zhejiang university"" OR ""chekiang university"" OR ""peking university"" OR ""imperial university of peking"" OR ""capital medical university"" OR ""cmu"" OR ""seoul national university"" OR ""seoul daehakgyo"" OR ""peking union medical college"" OR ""beijing xiehe hospital"" OR ""sichuan university"" OR ""sìchuān dàxué"" OR ""nanjing medical university"" OR ""national jiangsu medical college"" OR ""huazhong university of science and technology"" OR ""huázhōng kējì dàxué"" OR ""university college london"" OR ""london university"" OR ""karolinska institutet"" OR ""royal caroline institute"" OR ""university of oxford"" OR ""oxford university"" OR ""university of copenhagen"" OR ""universität kopenhagen"" OR ""université de paris"" OR ""university of paris"" OR ""king's college london"" OR ""kcl"" OR ""university of amsterdam"" OR ""universiteit van amsterdam"" OR ""imperial college london"" OR ""coleg imperial llundain"" OR ""utrecht university"" OR ""universiteit utrecht"" OR ""heidelberg university"" OR ""ruprecht-karls-universität heidelberg"" OR ""university of milan"" OR ""université de milan"" OR ""erasmus university rotterdam"" OR ""erasmus universiteit rotterdam"" OR ""freie universität berlin"" OR ""free university of berlin"" OR ""university of cambridge"" OR ""cambridge university"" OR ""humboldt-universität zu berlin"" OR ""humboldt university of berlin"" OR ""university of zurich"" OR ""universität zürich"" OR ""tel aviv university"" OR ""harvard university"" OR ""universidad de harvard"" OR ""johns hopkins university"" OR ""jhu"" OR ""university of toronto"" OR ""université de toronto"" OR ""university of pennsylvania"" Or ""upenn"" OR ""university of california, san francisco"" OR ""ucsf"" OR ""duke university"" OR ""Universidad de Duke"" OR ""university of michigan"" OR ""umich"" OR ""stanford university"" OR ""leland stanford junior university"" OR ""university of melbourne"" OR ""melbourne university"" OR ""university of sydney"" OR ""sydney university"" OR ""university of são paulo"" OR ""universidade de são paulo"") OR author.affiliation.ror_id_lineage:(""03p74gp79"" OR ""0220qvk04"" OR ""013q1eq08"" OR ""0064kty71"" OR ""00a2xv884"" OR ""02v51f717"" OR ""013xs5b60"" OR ""04h9pn542"" OR ""04jztag35"" OR ""011ashp19"" OR ""059gcgy73"" OR ""00p991c53"" OR ""02jx3x895"" OR ""056d84691"" OR ""052gg0110"" OR ""035b05819"" OR ""05f82e368"" OR ""0220mzb33"" OR ""04dkp9463"" OR ""041kmwe10"" OR ""04pp8hn57"" OR ""038t36y30"" OR ""00wjc7c48"" OR ""057w15z03"" OR ""046ak2485"" OR ""013meh722"" OR ""01hcx6992"" OR ""02crff812"" OR ""04mhzgx49"" OR ""03vek6s52"" OR ""00za53h95"" OR ""03dbr7087"" OR ""00b30xv10"" OR ""043mz5j54"" OR ""00py81415"" OR ""00jmfr291"" OR ""00f54p054"" OR ""01ej9dk98"" OR ""0384j8v12"" OR ""036rp1748"")) AND publication_type:""journal article"" AND date_published>=now-10y AND field_of_study: ((""Medicine"" OR ""Internal medicine"" OR ""Pharmacology"") AND (""Urology"" OR ""Renal function"" OR ""Kidney disease"" OR ""Kidney"" OR ""Urinary system"" OR ""Urine"" OR ""End stage renal disease"" OR ""Acute kidney injury""))",AND date_published>=now-10y,"AND field_of_study: ((""Medicine"" OR ""Internal medicine"" OR ""Pharmacology"") AND (""Urology"" OR ""Renal function"" OR ""Kidney disease"" OR ""Kidney"" OR ""Urinary system"" OR ""Urine"" OR ""End stage renal disease"" OR ""Acute kidney injury""))",NA,oa_therapy_area,Uni,Genitourinary disorders,2022,6470,2719,341,613,297,193,4163,2307
genitourinary disorders (including nephrology)  (primary search + genitourinary tags) - uni,"(author.affiliation.name:(""university of cape town"" OR ""south african college"" OR ""shanghai jiao tong university"" OR ""shanghai communications university"" OR ""fudan university"" OR ""sun yat-sen university"" OR ""zhejiang university"" OR ""chekiang university"" OR ""peking university"" OR ""imperial university of peking"" OR ""capital medical university"" OR ""cmu"" OR ""seoul national university"" OR ""seoul daehakgyo"" OR ""peking union medical college"" OR ""beijing xiehe hospital"" OR ""sichuan university"" OR ""sìchuān dàxué"" OR ""nanjing medical university"" OR ""national jiangsu medical college"" OR ""huazhong university of science and technology"" OR ""huázhōng kējì dàxué"" OR ""university college london"" OR ""london university"" OR ""karolinska institutet"" OR ""royal caroline institute"" OR ""university of oxford"" OR ""oxford university"" OR ""university of copenhagen"" OR ""universität kopenhagen"" OR ""université de paris"" OR ""university of paris"" OR ""king's college london"" OR ""kcl"" OR ""university of amsterdam"" OR ""universiteit van amsterdam"" OR ""imperial college london"" OR ""coleg imperial llundain"" OR ""utrecht university"" OR ""universiteit utrecht"" OR ""heidelberg university"" OR ""ruprecht-karls-universität heidelberg"" OR ""university of milan"" OR ""université de milan"" OR ""erasmus university rotterdam"" OR ""erasmus universiteit rotterdam"" OR ""freie universität berlin"" OR ""free university of berlin"" OR ""university of cambridge"" OR ""cambridge university"" OR ""humboldt-universität zu berlin"" OR ""humboldt university of berlin"" OR ""university of zurich"" OR ""universität zürich"" OR ""tel aviv university"" OR ""harvard university"" OR ""universidad de harvard"" OR ""johns hopkins university"" OR ""jhu"" OR ""university of toronto"" OR ""université de toronto"" OR ""university of pennsylvania"" Or ""upenn"" OR ""university of california, san francisco"" OR ""ucsf"" OR ""duke university"" OR ""Universidad de Duke"" OR ""university of michigan"" OR ""umich"" OR ""stanford university"" OR ""leland stanford junior university"" OR ""university of melbourne"" OR ""melbourne university"" OR ""university of sydney"" OR ""sydney university"" OR ""university of são paulo"" OR ""universidade de são paulo"") OR author.affiliation.ror_id_lineage:(""03p74gp79"" OR ""0220qvk04"" OR ""013q1eq08"" OR ""0064kty71"" OR ""00a2xv884"" OR ""02v51f717"" OR ""013xs5b60"" OR ""04h9pn542"" OR ""04jztag35"" OR ""011ashp19"" OR ""059gcgy73"" OR ""00p991c53"" OR ""02jx3x895"" OR ""056d84691"" OR ""052gg0110"" OR ""035b05819"" OR ""05f82e368"" OR ""0220mzb33"" OR ""04dkp9463"" OR ""041kmwe10"" OR ""04pp8hn57"" OR ""038t36y30"" OR ""00wjc7c48"" OR ""057w15z03"" OR ""046ak2485"" OR ""013meh722"" OR ""01hcx6992"" OR ""02crff812"" OR ""04mhzgx49"" OR ""03vek6s52"" OR ""00za53h95"" OR ""03dbr7087"" OR ""00b30xv10"" OR ""043mz5j54"" OR ""00py81415"" OR ""00jmfr291"" OR ""00f54p054"" OR ""01ej9dk98"" OR ""0384j8v12"" OR ""036rp1748"")) AND publication_type:""journal article"" AND date_published>=now-10y AND field_of_study: ((""Medicine"" OR ""Internal medicine"" OR ""Pharmacology"") AND (""Urology"" OR ""Renal function"" OR ""Kidney disease"" OR ""Kidney"" OR ""Urinary system"" OR ""Urine"" OR ""End stage renal disease"" OR ""Acute kidney injury""))",AND date_published>=now-10y,"AND field_of_study: ((""Medicine"" OR ""Internal medicine"" OR ""Pharmacology"") AND (""Urology"" OR ""Renal function"" OR ""Kidney disease"" OR ""Kidney"" OR ""Urinary system"" OR ""Urine"" OR ""End stage renal disease"" OR ""Acute kidney injury""))",NA,oa_therapy_area,Uni,Genitourinary disorders,2023,2490,1006,36,221,64,142,1469,1021
